Commit,HWD,GS,ED,LDV,Total
dbcd4d00391395b795de423b876f5805aaee8e89,9,2221,750,3,2983
e1ebdd379f0ff43ddf1ed818720ee4f57f3ec77a,30,951,177,7,1165
66ffd3f1d1089cee07ed451492f3c615097f60e1,22,1153,221,10,1406
57976f7804ba138a6549c82bc4050f6a906dfb9a,12,1166,497,3,1678
3bd9be7b597aa6d27751503a34c4dbf148aeb037,15,933,119,7,1074
a650a21efe608fda75c682a29db8e1ab0caa9b0c,13,623,112,7,755
a4df87c2443f582513ee90cadeff53f6beb2c879,22,1158,222,10,1412
9935d4dabcd643a577a17830e51b171ca178156f,12,567,97,3,679
f02b44a2f49eb3ce141693acc341dddd341cca81,22,1349,192,9,1572
e0c148b9dcb24e392dddbc5d51bc4d202092fc4d,13,638,111,7,769
9fc27d01fd4c834496e82594267f1fdc4687344d,7,1231,364,0,1602
2546ef28efc4ae30d3e73d60e92ba18591fdcc96,12,2144,790,5,2951
3cec4ee1033f04953dbaab7e80f26ec23f0403a4,31,1060,149,9,1249
ac5a1ccabdab0724ba9e06d93d12293e625fbe73,27,1059,143,9,1238
b7ce5c0ed72f35b3c7f249d26a77410c9c69fd22,22,1349,193,9,1573
20d8143369760c3d2d647e50662ae3a4c640dd89,12,2069,757,5,2843
07bde929a2a3a8c7c3e36dca254acad3f27c55e3,31,1060,149,9,1249
de54339568a3526db88b5faca89563be0da863a8,9,2221,751,3,2984
5688a84a021c27dcdb793df61a16095cb5edea66,9,2221,752,3,2985
ced7ed1298f98f8a3884e152c4dcee1d58d261e0,7,1139,381,0,1527
d9ad9452573a2b9f7916f7ea3e86d8f70167dce6,7,1363,433,1,1804
91a36d951e9e44f0bfb30cfe44549b66ea464996,13,622,115,6,756
093a9f0214cdee0db42cc7af2058afe838cde127,6,434,60,0,500
16879622d29c6dd332d58cc9ca362763368e717f,9,2200,841,3,3053
5f0021e180436d4b7a7510916132b5c566141784,18,857,126,7,1008
dfc6ba22e6b4b3e00eacdccab306de6ba7b81657,7,1929,586,1,2523
5ca4fa817ef9d7fb0bbe60f61df5467bdf9ab3d4,12,988,360,3,1363
27f2497dcdc2586f097d3199005e2eba983bb7c6,7,2040,764,1,2812
ee072e07b43ab361a07aebad07fbf45e5afde9f5,7,517,71,0,595
ca4827ffe8e4071b88c7d6e6a1df9aafcd47fcbe,32,1350,184,8,1574
648806f1d833cab27490785be52ce2d1d85cca93,23,1164,228,10,1425
72d69bed5460c0764beecdfdbe65ca5265335e07,31,1118,162,7,1318
2466bdad77350c45e5bb2a1ffd37fa5a6139e734,32,1354,183,9,1578
8b8d590cd6103eef0204945b940713ad7d8ba3eb,22,1164,223,10,1419
50d46790169ed4809aefe0cbcec6b000a193996d,9,2221,752,3,2985
36e9e6115b7f2fe535ca04d85fc56d83cd64cff8,33,939,173,7,1152
1f3c87162d83c8f0aa9b5b3b1da3d984e272c7c2,27,988,135,7,1157
9961c4fdb5bbedf849ffbc4a077dec0ce56e26d8,30,1078,178,8,1294
b644106f04fcb70bb3627850ed75621eb8b3efaa,12,661,112,7,792
e95dce59d95a3bfce0fa6370b545abfcba5dbeff,33,1352,191,9,1585
2158aa922d33bdfab5fe8b799db37eeb25b01979,18,857,126,7,1008
4463c57d7871d7a8d4ecab53709139179dc5797e,7,1150,196,0,1353
320baff01a5358402bb84ab93309c7ffc9d9a249,22,1159,218,10,1409
557217d7b77c623ed1cd0667f6ced18151d4b777,12,2252,828,5,3097
a8c74fc5b55d431a794571d5314d2510befbc148,12,712,114,7,845
e19c3bf96e07cc966cf87af2506821155f7eb3eb,12,1356,637,3,2008
974b2a32d8fbf61fd58fb972fbf7e4b9844d5f4f,6,415,60,0,481
158013d661f6802c0bdd855008b76a4b5ed3696c,11,1775,730,2,2518
4cf08c9860c76cb7230ac1025b00f8e460ea112d,32,1350,206,8,1596
6918160ef768de803352c561c7a674bb10f2a76d,32,1104,194,8,1338
cefa241fbcbf394e0b51af823b36cbda4931530a,31,1060,149,9,1249
d1decc87cee066af453e75fd07a74f24a13561a5,29,1035,171,8,1243
01c9d1e0ba325890206e41260ba157f41ee4ed0c,31,1060,149,9,1249
fab0a36fafb208a922f9a8fd3cd95f95366cffdd,31,1060,146,9,1246
5ac03de50f37ed80fa1078fdc1ffe7ce7c394331,31,1101,194,8,1334
49b770ae57ba09fa5f71ffc1c2055f4fbf3e68e8,11,1775,700,2,2488
d740deb6ba352e7b70483bb47b33ba61d3473b1b,7,1214,358,0,1579
38fb79ad0934bd1a654becf24a26974a6310721d,12,673,112,7,804
1c79a6dcce174726789f3becdcc6a184986e2d79,7,1495,474,1,1977
96e73c9aeef9db245ffb05a67fa40792ab422e58,31,1060,149,9,1249
c441ead2d881f4322c36b4378847674209ac8761,30,953,176,7,1166
c80429538a2025a6218d686da9b96b64c6847a0c,22,1141,206,10,1379
31f542017090f754f8e63716fbc777e52cb9b868,16,731,113,7,867
df7596b9085549e5ec9db122de97433ab0c18f63,7,1454,459,1,1921
7fc3e28580a79d6a31fbb89612708b94a02047fe,22,1145,208,10,1385
aef74af8caa02dac7f40350da3c9c1a3785ad32b,30,953,176,7,1166
c1b881f8309aa9a8b207ee021875756ae1bed798,31,1060,149,9,1249
2a90f5f28534550475c70dbbb4448601d3ff2870,31,1060,147,9,1247
7f6daca4f23bbceaa93722903edc3f1e561fc7a6,22,1346,191,9,1568
8faba795dc37950a74ed2816d1e59879c846a9a3,11,1775,696,2,2484
992f35c43ca3d974b8b938a45a1af2fa29555ba2,9,2221,736,3,2969
117a267f9767f70e4d6d4cc61f282f52bd4a7e19,29,1063,169,8,1269
37b5bb7d83e4724ad8deeb6a74367e01769f5dad,12,1692,696,2,2402
3efad5eebb32643ecfb348e37ce855e0cc1c2b15,7,2379,797,1,3184
2e997a7b3a4c19199f321ced6594f8ed9b806647,9,2221,760,3,2993
b90d9e8321b7cc4a5cad6ef83e560bed4bc00ede,0,0,0,0,0
fb49da0ec7535e0aa306f61c14cd2a9b4e996d0a,23,1349,191,9,1572
129535e15f0bd5aad59b22aa5fe73cbf701c72b7,13,724,114,7,858
6ae792b230e2dad62e43258a97218c8684ccde61,0,0,0,0,0
c787b744f49d588450a4f3d8eaaa70595f199ac5,12,1043,405,3,1463
d8e9b31598e9e236eda3b3297e0b5d523127da29,7,1299,408,0,1714
18719684ede2dc6740d7295bdb362b00b6176975,12,712,114,7,845
40992c0e1aa925d370f46c8761a5f08038e1d4d0,10,2072,737,2,2821
fe5e6f7b1c49b24715e53f66db7a05a2eccc34db,11,1775,696,2,2484
428e562a4c704861aed7c7c9b8be0d492c358db3,28,1001,137,7,1173
4af60a9341077200ee8f356f2ffc18ba556859c2,7,1089,182,0,1278
4f534f9f3e255cdef4ab0f1edadc24476bdcc9db,7,1214,384,0,1605
2626e60828ab3d5a6b392b9fa751ce32589ebf14,9,1984,754,3,2750
ea389fe5b4d4f93722e93b3de5ac7c0bb8e3f338,7,2166,786,1,2960
d283abe4aac74ddb048735d46ef576b79a926a27,33,951,174,7,1165
351dac0d2d42c5326e04742560f50c42ebeb2f67,0,0,0,0,0
93821737f4ff652c8d0330590e087a9031024612,12,657,110,7,786
1f9fa469c9768fc88ccb804aacdad34247299444,27,982,132,7,1148
60898d8f49a82cc0efe5326248c57a3830174995,30,926,170,8,1134
dbc749880ba5e42e099a0be1c6bc37824cf5cdf0,0,0,0,0,0
22430b6caafc006c41b06276aff3aa612512bb87,31,1394,187,9,1621
dc7168f44d10b4e3d84f5dfa27e19efbcad0585e,32,1350,184,8,1574
1b072974f9ab5f80e858634858f22f30b30ee1ed,7,1310,410,0,1727
4563606118b9f0dc2250763bb1d0e2784e13cc51,6,438,61,0,505
fd237b5621abcebcda24630f2a1db0a2fc04f139,13,620,113,6,752
cbffdbf2da0fd1a17c995487b1d5d31e524a6f8f,16,731,114,7,868
ba2ca7751cff13ded142783da2bd80029cea292d,12,731,117,7,867
60533ec514bc249d29d83758752d6f9837ddbbc6,12,567,97,3,679
24b4a295f0e98d5ca225f6ca04d842ef834d0aeb,6,490,70,0,566
7f5ab47da4e17add3483e2a1d01be1cb31f84d7e,7,499,71,0,577
68b221d064fa3ac80eb112748aec929d8bfc2586,33,1091,192,8,1324
7e16dfbfc4980a2c6f8f1754a756af819949fd41,0,0,0,0,0
b6739cb4efde26d5c1d30768cc3801509258c12c,30,953,174,7,1164
e5bd77a90993de80ea16fd1f6562027ee57001eb,7,1689,545,1,2242
5bbddd1b416afbb72a85c6b6809eb227510d9f9b,7,1089,182,0,1278
047a5a87785bc7f911791ab6112d98c0dccb53d9,33,1095,191,8,1327
81321375819f8b8c5849a3b980cd28b35dd89284,31,1069,151,9,1260
5a051397412cbb6e0e38b378ea6190dabb88f077,30,925,170,8,1133
3c9a300bee91c8b5103bb33d48d4fd065a245b8d,9,2221,736,3,2969
e5821cddbe1101029d4057462297f187f3476e61,31,1060,149,9,1249
71d8b330d7f54f69cbb4a0c99617f7572eaad5b1,12,569,99,3,683
ad859665890d9720e02d111ffeaeaab75b14c645,33,1115,195,8,1351
d2d473c82e2a1b8c2ab73fc80e9a35a148ed9eb5,31,1125,160,7,1323
eeb1b4eee46f0bd2492466610dee247716628c03,6,411,59,0,476
878e85b572cbb2628f47c421479cbfc22dc34358,12,609,109,6,736
f43ae57a679e45192d7803451d23876522cdbef4,32,1352,191,9,1584
085016cf9a5dd283d6878b1f37b36669cb8f39fb,22,1137,206,10,1375
e590718e5ba10da83cdc6c712b44a5b5667728e9,30,1097,184,8,1319
a44bcf5f44b8999b2d207453743b692a4991cd56,10,2065,733,2,2810
e91200afde52ca0faf3acda435becbf9166ee552,12,2141,769,5,2927
4e8c0bc19c48acff8fc8b4c56ce4887ef2530b1a,9,2198,782,3,2992
204c74b66611bf463570502abeb532f02a385ce4,9,2217,842,3,3071
872e36799af0ca655f6350ba4b052210b8804e4e,0,0,0,0,0
3e888a8bc93138e495d215234e8f1da6cfd77b89,12,831,242,3,1088
0bdc347483423c08d6a99b45a01df22dbf1c8a43,12,1303,602,3,1920
8e7d104fe7a81baede7f122c5b5c2de31984348a,12,1470,671,3,2156
f9094cb3d675803bd32b7fa0e74243f1799a1a0d,12,1523,686,3,2224
23463186dd7092107c820316ca8915d501ea3da8,33,1352,191,9,1585
845c06e12e1555104f353f6aec9910ca18729a34,31,1061,150,9,1251
7664c0217177ba5019852cc4bd7d849ef8e4c29d,6,414,59,0,479
939de1eb65ecdd51c50484c84a48553d06d99ae2,0,0,0,0,0
c338e8623b502fb0e38ccfb5224f60e69980c1d1,12,644,110,7,773
a19bffe2d732795567b3d282879ac26c162bbf4e,7,1239,367,0,1613
f12af04991d333257e818fb38578722fc69d6adc,0,0,0,0,0
2a301ab2cc2faf3772c83414b8976b6ce5167497,7,2087,644,1,2739
d0b14c71c188518e31746dc47b17704639c5bf54,33,1352,191,9,1585
02732bc7a6fcf666a3d9b5337af338e404abcd0b,12,642,110,7,771
7355d0463217391457ee96b2d4a88c2d5dc18ea4,12,2206,805,5,3028
32b42567ccf62f08b5df64a8ed2b54f78c0fa72f,12,609,109,6,736
6572be00a836258afa41488984875d1fb5fc2150,30,953,174,7,1164
56f6a407351689f82107c13d8120e996485f3917,31,1073,149,9,1262
9612d0b6b2407230c72522b37581b8d38fca6834,12,866,266,3,1147
cf1fc831e0f52749d4b4c11b0f728d99bf8c6820,18,856,127,7,1008
0c4f39889821a0e1b190a02d9207c4874d50ff04,12,2118,764,5,2899
b60cdf0cb5c78243dc5b95e2c1f0234dd769dff9,10,2170,732,2,2914
113f6b1303896d12d616f7c179cc2531af69dd31,7,1240,367,0,1614
f986fd7dc85421aca13cc257334fab095cbd9a72,12,567,97,3,679
f21bf1de5318746ae83188caae6093018bcfa326,6,435,61,0,502
6a93b8af66d39140565d8d547b896764ccb02633,7,527,72,0,606
56a3c4e06871776d5950680558f49017a1b3e14e,31,1101,193,8,1333
3e6306f640a48903d04b9196debcbbab937026d9,12,609,109,6,736
f8d350969a30647a9a9325ba0696743cc0533dbb,20,880,127,7,1034
6f69e6f0e32998cbf479b590040d7ad2e9565811,12,1775,697,2,2486
1a980cba3ef2bb61afda1b706a7ee57d0b853898,31,971,170,7,1179
95736803222c57b20ebdd0e28cedd0dac4d2100e,30,1097,178,8,1313
79bd534df60f1fd90ddd695f6ac1ecd38894a712,32,1346,188,9,1575
22997049cb293a9d6e51132d01d3fb02722dc4b3,30,956,173,8,1167
74dec3d9d81311414b8b567f43b3660ff205cc95,31,1060,150,9,1250
92cc10ed76fbeed0dc669eb709febc6ce78fead8,6,451,67,0,524
a24d80a000156786889c0967c40529967d0e98ff,32,1368,189,9,1598
183d1a0c97ba53336acf0d52af49d2271b15c9d9,6,448,62,0,516
63b1c448de3409d3b910bbe235b5ee377e8d243c,7,2193,695,1,2896
3d452432d592b47a6c26914bdf64d486514ad926,12,1166,510,3,1691
3167e551d1d5bdce6d214a79e7a3aa55d71476eb,25,944,131,7,1107
9e9d7eb9a86fd56f745e096b1e194387de938943,7,506,71,0,584
4965fdc33fa3c96a6e06cbf99e01c54ebc8f2fd2,11,1850,736,2,2599
d99c3c1aa502203f769388988117cc0735903054,18,857,126,7,1008
7852b2462d94dd16f0274be3abd073d978b17622,32,1334,189,9,1564
4a6dad1216202e09e2788dd59466ffbee9ae5555,13,623,115,6,757
4dba318487027a0c1413eeb5ea6d9b88722d1d4d,31,1121,163,7,1322
148cee56f84562a6cf830c2d0d9a8c18e4e0a8b2,18,857,126,7,1008
5361191d4dd39a0a9619f89558ffefb5b512829e,27,1031,138,9,1205
0ada62b6cdcd2cc4340f433410ac0338b1ca824a,7,1249,393,0,1649
5b03db020780388ed3bbd753c1502c2d5254f1c0,7,1231,391,0,1629
9cb686b80d51259f1f1d5371275e709b3ba3a508,7,525,72,0,604
504506763dbfda497cb6e11043c8514f53647df0,7,1089,182,0,1278
db7a709678b4bd919f0c448e6251c16769eda496,30,951,176,7,1164
d8d2fd4bacbdee233a43498780d10cbd1044e2fa,12,1190,528,3,1733
56c39bb0854bb3c60cab22d9d4721ab6cb215424,12,701,114,7,834
f7a7666e273d0c4884c65758090c417d7588084b,28,1064,172,8,1272
2c822bd3ea30fea1c9dd13027cbe5e6822c4a6f6,12,1101,447,3,1563
a382bfb2d918ace6ea9b5ea848ff34425913ce38,32,1350,184,8,1574
40cc5a3ea2dd0ac0c9cb18c7cd53137d7ac46330,23,1164,228,10,1425
9abf60d72636e92247d14457dc407e0db9e18a6b,0,0,0,0,0
d572a37c8fa9c31fa904afdfebe8d79276f3de98,30,953,174,7,1164
077e5412a3cf899175fda446bbf43f010ece53d9,7,1940,763,1,2711
7d9c98f0db3dd6271621154cb4eb5fa6456573c7,12,1412,656,3,2083
9cd9aae53d60a9c8ebcbac92ae1a57ce88bb0941,9,2221,735,3,2968
5c8b023f336c0bf8b2ac4af2ceaf65d6e8da2ac2,13,626,112,7,758
76c097b50575ba3e65c54062bdb92388034cf3fc,33,1344,188,9,1574
0a0aa808f031bdce2e9ccd5185e4230d87a78579,13,622,115,6,756
881620916328504778db07c2bef71824cf8386f0,9,2198,798,3,3008
d2d145f879670a604383570d3ed5de99cecac8ed,22,1349,200,10,1581
814cc440b6a1af3d58ccca6f784429ce1b811ae1,11,1794,730,2,2537
0786d58d9433a4ae8912e26790046f36e1b05efd,13,630,109,7,759
696077ffbea775875a78857dc4e152f958690720,6,473,71,0,550
3f011947bb4d5e15eeadd71f9e1eb34a76ba8678,6,479,69,0,554
864f24b04e16ce2da875c82171961c470a6e2ac5,13,724,114,7,858
ec78cdce7f23c94acecbbdacb032e770b6983d8a,12,792,217,3,1024
aaf866a37baf15284290b35a3606dee6d066bdd2,12,665,147,3,827
5450e3bd582148104566a2b93300b79880d21f4b,6,430,60,0,496
9dc20b5b33ab2dae1b0c65d4822b7039f9df0a06,32,1337,206,8,1583
b8fe02a43ef02d6391ef9d627043b4d535765132,7,1214,383,0,1604
3cd880c6b547cc96ef760b7f397bab42cb09d36c,30,953,176,7,1166
884f15acb5b1e15d0e7cdcb54180a37cad2011b4,12,2118,781,5,2916
11f8ddf422288addeac197dd41e5691e985e718a,31,1066,150,9,1256
d2f700bbf8d5e3a924d8e9a57a0265419b66df53,7,1152,392,0,1551
d209b92137ac562b75facc78532b6d5ed355e609,12,2175,802,5,2994
ce1552565910080fdd42b171151b2e0fb8ce0ce2,0,0,0,0,0
87eb42584f225dcb70560bab8dcef080e2989c97,31,929,169,7,1136
03b97f8252182783a2aeda9c278e58447488ee5f,11,1775,730,2,2518
11525d4549b1f919e5ed402d72a5a461f70ac3c2,7,1089,182,0,1278
1002461f741cc8593b842a534bb62e64d4a844e1,20,913,129,7,1069
936a7ccbb51678788fa0dd350db2e8eaf4f6a116,0,0,0,0,0
8bc6a9d293e67fd62e15a1d8b005f1e723031510,7,1201,405,0,1613
994d287197bb62095d07d107ec007e784359c587,32,1351,206,8,1597
49ed3b5b656173ec0f5aca3b985161ff64991caf,12,750,196,3,961
30d52b185266e317acb85013223612cbe8c6bf7c,7,488,70,0,565
0a9e317179aa5d6ca2c67f8f0d6aa51235be65ec,7,1261,377,0,1645
7c7804c18dead160d812d582966a9e9dbeb724f6,15,852,122,7,996
e1297b7c96a961254d4dbf1c3806ee0fc0466451,7,504,71,0,582
d08f7c6a2fa629be2e68f63766b7e39be9533c1a,9,2221,735,3,2968
69bffeabd5c0b00111e575ac8e34ec0b25337379,18,857,126,7,1008
db8b05cec47d1d21688eeb58cce0e2763da37549,7,523,72,0,602
561cf11c04d499204182e506e9be0ceb7f480319,0,0,0,0,0
4bfa1f9f7b6c2c2769d49f752d4f8c8e580dd434,0,0,0,0,0
7a2192128660d472cd98bc784f5101b3186ab8e3,12,1167,510,3,1692
da5cdd2714693e999ab45c43f17f90877d49cb03,0,0,0,0,0
3b1d2b95c809d621cda5b8b74ad423997a746e81,9,2152,732,3,2896
2fec8ba07896922ff5722604f03ab760af700771,0,0,0,0,0
a9c7b81e38b9245c925ef2b3a08ba33ba7c714ae,7,1797,568,1,2373
6c79aa97454715cfa7bae80ebca4997fa112fd63,7,1420,449,1,1877
d68aae5534c7aeac567c6291dd32b9af779b3b9c,13,645,110,7,775
7c27258fd709f3ea92d73658601187d2955dc6fc,32,1259,203,8,1502
fa058a0ed42bec94576b7f3a541cc2e4e8c74aa6,9,2181,732,3,2925
3bfa412301760a9b9f311eaba3db2da8b406d7ad,7,499,71,0,577
201018db2a1512dde609aff9afde332158072f3f,29,1055,168,8,1260
970115f1a8bd53302f1cf05bb0f91a6289bcd71e,23,1164,226,10,1423
e16eeb88828c3ac17b95edc911f61854ba5a1548,32,1111,156,9,1308
a0b16697890fb63a213b3fe427265e6df63292b4,30,927,170,8,1135
8d105845e57897c86f0192cd372276e9a092cfbf,13,725,114,7,859
9998fef72c676858da65b1bd1aca8ec195bedb11,29,1044,171,8,1252
5c6d8f7af7b3a91576ec61160c074bea0e2fcfa5,32,1351,185,8,1576
8662ef25648962cadb56165e1ef45046ba4cd679,32,1350,184,8,1574
81d0562f0f11161a4c21036a4e4fd9b62201bcc5,22,1161,223,10,1416
4891bfb36eb54cb71a6a68fb6cc1a0941b113374,7,1214,384,0,1605
aec8b324377a3c29ee9d9d258e23998523fab315,31,1060,146,9,1246
25ac501b3c4e99efcdc821996588a2b26c7d74f4,11,1774,730,2,2517
d5f245aecd9731dff0aa00d77e7fdf5880d8e56f,31,1118,156,7,1312
d63929a401baa04894f7247fa7dd87dee9abd380,33,1098,190,8,1329
3159937b327727c4721c16fd1727d8a3e828b6c8,0,0,0,0,0
d9206fee8749431a58bdb68f2f153b92747fd0b2,6,475,70,0,551
774babed7eaae62e7c35b226c3179becadbb16e7,0,0,0,0,0
3787f0914b1eab6949f8e93b588ebc0da0962ea3,16,853,123,7,999
bb085406bb2cec679f60196d646760de424ddca5,12,580,100,5,697
b301ffded53a05e18fa7f516e4717d0658b5f43c,12,712,114,7,845
33d825f6f6b907b0456d791f1c419059c9db52f9,30,953,176,7,1166
6fa795f76edcd2a8234dd06085a783488b96636e,33,1352,191,9,1585
95c5f0e0bb8fc50b0a5abdd9fd1d919f2d9d3d66,13,733,118,7,871
14caf76ee9a75e829140e89ed952ed099218c528,31,1060,149,9,1249
3653def3570e9cbd493a613c7f136b00bdbb9826,7,1184,397,0,1588
2733516cb9cdad7ac4cef98b819d4d01846e5c66,23,1164,227,10,1424
dcb791dd6e22bc2a5cd8a28f4ea8ca70bbf5d873,18,857,126,7,1008
a904506adf2cebb8b048bd456064498297dd5e51,12,572,100,5,689
d7faf1cc6eea3dfe36dce9858e95e59cd1286061,22,1141,204,10,1377
4d8a061212953fdcbd94098749d14f85add00ab4,23,1164,226,10,1423
fabf0d5579fd98ae59df8113eac27ef74d0ad224,32,1346,206,8,1592
ccf357479695139e49a775eecfbd5a4beee0e53b,32,1350,187,8,1577
3b856f160b7594219b4bd95cbfa7d97f8aa25bc3,12,703,172,3,890
40034f36c381339a701868295dd24950b6204abf,12,958,338,3,1311
72cc13fdf8e64b803106759799761f4b2827588d,32,1105,194,8,1339
3859ef4250fc49e20181852628d9ce5433a1308a,32,1366,183,9,1590
b00460660173dd8865db5eeb852faf05b3289e83,12,1587,692,3,2294
97435ce9f7931cb67788217d913332b8112ad103,15,852,121,7,995
cd383c7ec84f610de33049210b7098b0452b31a0,7,517,71,0,595
ae53ae7df4b9ae4ba21845ca1305b610a541feba,12,1166,497,3,1678
b13cd3cc5cb496a2a0c64ded300d54420973bb4d,33,949,174,7,1163
793b698aa355284729866d99ddb8fb0b891de958,12,1166,504,3,1685
