Commit,HWD,GS,ED,LDV,Total
7340859e5f5a87fabd6b699cf57da9a954abc14d,6,841,523,33,1403
89ba93b540abbe6f33e84699a9ef4dd0aedf3723,8,327,170,11,516
764611455d1ef91e529ff37c83d3405709bb0fd7,4,101,20,0,125
019b4ecdeeeb7e1016b9809b7b7739d3c3f8bf71,6,404,223,13,646
1b34c1e1579bdc8d0dcd840c6e47687df844e6fa,6,117,30,0,153
291c4db43b1fe0cedb627fba15ca03cf506234d6,4,100,21,0,125
fe9f6752af97ed8e99ec11401820e9ebebae4f0f,150,159,107,1629,2045
538257f640ce1a293549c42705ae5a3c35f69d9b,144,141,88,1190,1563
4ea793c73ecebdc136cf741010acb0dbf403ff69,5,71,45,0,121
aaa384457b68a2a1b33a6565ec4f3c57d14414d8,5,639,328,26,998
146ae04a964b4bc41649e5a54f8a019a34f8e4db,4,591,257,28,880
702c6d22ae70a575b7c8753547522593334a3365,150,183,127,1684,2144
b179a4579c0b734a7e011d1ec3cb4b80e211bf86,3,401,169,15,588
736f888236b7ac49a216398a94466c545fa9ad27,148,165,111,1660,2084
ecefdd9fff22abaf20f6d3b02d3d38c7026bd6c1,152,220,140,1933,2445
53b031786f7872796e4308b6ab8b628841ec7637,8,335,174,11,528
45cc8a5ad2947849e0cd159fbb5b4d4a2059e334,5,353,176,11,545
b9a4453f663ea5cfe728659da8dc449c9f232d4f,6,849,498,33,1386
4690df580f858e73c887b8976dc377fba7459593,4,372,178,13,567
5ef19bd95d45921a6f9ef3fb3c7e088dd5bffc7f,5,63,31,0,99
486e6eec436f398aef6cf84bf89f9f0d64afc6ed,177,264,157,1996,2594
1767cedc1489b1d410ee20a67b9802fc880fa514,4,447,200,17,668
d2a1a59150865be4722f9148281cf04df816309f,4,101,22,0,127
bc58b075bfb643c41f5b604ce73e5a317c34fd73,4,497,213,27,741
db53f3ac3cf08212ba93edc5c6e6ed65b4645751,3,373,176,13,565
082a2d69d135b1bd343039c66758251a589981be,5,121,31,0,157
0bfb8e9daf6c7cb0367f4f2a87c3cb4d75ce84e0,4,771,445,30,1250
d3411bff8921c10aa67e32f63ff36bd4abb14bd0,4,390,210,13,617
653cee4d079026063e3f370541cbda1206c0c52b,4,511,234,26,775
fb02444553c2aa41fbe0a4bf7695efad42fe2f56,5,116,32,0,153
1fdcfdd612b044725439051a58a045346b626698,0,60,5,0,65
6b6351a45d20008d56a5b899b4df52a2d63469f5,150,183,127,1684,2144
c9b3adaf7a11c098e9a2ef796287cc4aa1fadbb5,4,482,212,26,724
42ba58f4f8b608ca0010d6d83058bce6b8b520c8,4,121,27,0,152
7d8581bfa6a62eacbcd609b2de8f2c01b0f360de,5,518,228,26,777
297cfac0e52fe288a619f3a6c50a589c402b782a,3,369,189,13,574
511c74a7ce8c62c992e7799423b143e86861bec3,6,122,31,0,159
ca6bb60344ab995ada5c70bcad7ce880a94de92c,3,382,182,13,580
d23b6f68a854d764a09551d2177eb46dce5fa730,6,648,298,27,979
e363dbf4f46a0c63f0e93c7cfca67c030059e277,5,768,435,29,1237
03f4f88fe8fd464b4657c898bb3e291fee2611a3,6,128,31,0,165
28cbe1709d4e21ca6b34d23c0cf9b75c229efeda,179,268,166,2039,2652
7b439c64da0622462e30d8a1183f4a7525007768,3,159,93,1,256
3662f5d3515fb6a3fa42f7fb3586bb379c3a3cd6,5,71,45,0,121
3e2b68df70f0be8f8323a7d55ecdff5c36dd70f0,5,662,338,26,1031
914744f4fcd0687a18a628edd9ace9f10155fcd9,3,363,171,13,550
6225b05808d902f27d8358a1a24a2af5c976d763,4,590,267,26,887
0c63bb922b0fae6327c33ca81f692749464669f1,163,197,136,1887,2383
c755bc51a175be8509eda5757cab719026c4fdce,3,371,180,13,567
7fa1758f412861d6fc824196d2d772f1c9198a55,7,358,189,11,565
cd611d1b993600e7a79d5b968d1d9704d0c2c446,5,116,33,0,154
38e5132239fe5cc276e4ee86297a34be24e1f03b,5,637,312,26,980
afe38fae48a38f35a8c8f66a690cfe43d7899bdd,5,808,453,30,1296
94c337acb8394335e1b82b515bd8fdd2196f7ded,6,437,189,20,652
cfc68f21717bd31e9a5eef2ae3a803bf427ad7cc,6,1063,713,44,1826
9f51a5c2d146e04bc687d4b4912f1bc488128117,3,121,24,0,148
347203f26d34cd3029a079145ebf98d409551550,143,153,96,1528,1920
d9463741646bed920eb3d9c88f85ef79c4696f2b,145,144,94,1210,1593
99a2a4cfe53dd3012f9fabf2d276ddb0466da1f5,4,369,178,13,564
13ff3568b39a9472d52dabd10c062547115b34d3,5,508,231,26,770
0ed8bede70c6302cfe7867c35f1cf18cfdbe2aaf,5,638,307,26,976
822a187009e94a97caeacc44648839641978de7a,149,184,127,1724,2184
3c37984081067633550a5bc5a7892840ef389616,3,368,197,13,581
1832966e7a9461ac5a62ba865afb35e322e865e0,6,864,527,33,1430
d2b11562fb2cb6ef608412784609d12b7fa2c113,4,74,47,0,125
e26c09810d8fdb49f5ba4fbc7daf551067a08aa0,8,335,169,11,523
f734cf9a02656a7df44282325de74747223ec13b,3,121,26,0,150
26f735e6b10b1beec18d9bd9beba31494d130153,5,119,60,2,186
2000d918206f9a0afc717d0f01f0c3e0aa741ee4,0,0,0,0,0
d7532423ddcf5f72db4486ee7f3032178ca7989c,145,150,98,1457,1850
9a44a97dec893d2378c3570fafa0b70e93b1fbb3,4,132,75,3,214
e6e971abb8551d397aa5d1b0a6814a5fee60d69c,6,876,541,39,1462
6097427f3e6b97e2709467f6581ca1b37eb94f0b,4,550,235,27,816
dc244265fb2aeee4128f8ef835c77a6a3fd41d64,4,381,176,13,574
c0d9063f3b028a4810676d24fed974853e45370f,6,121,33,0,160
7c38bf032e7d38cd54e6476c733ee3013615a55f,5,663,339,26,1033
1c8aadd3687682789e43ccad1a0977f1ec96634b,0,0,0,0,0
b173141c0975529514228a0b473f60610e761d21,3,400,174,15,592
e081e29c1538ed8c63e1479bbd904d92669e7510,188,279,178,2191,2836
a3e8e7bd8e92e2e8ec2a99f3a1927b1130cc79e0,3,393,189,13,598
ecb590848543dd33504a94d555ec7067172d7dac,9,1259,835,56,2159
e44cb8be8a186d4a8d7a3573a1f8a6d51488f3c9,0,0,0,0,0
bdcf5d84977b676ee9fa0548c2ea8189b8644845,4,85,46,0,135
b8c8d4019ae5f321be88e7832a05c95cc014d062,182,269,166,2040,2657
ff64c73c29c682637ce693f40c86e5d0ab5883b3,8,328,168,11,515
b67c6c8549cfafe9656b79594386fe505dac8791,3,383,182,13,581
b8cded4c431243fcc1da5d6f42b3be1d2401a998,6,127,31,0,164
9878f5c8bc0bdf4ba2b4d2e6916786d8ad7a47d2,5,119,61,2,187
38ad9f100cce4d934459b7a5e107eed2f74c4ff3,4,359,176,13,552
770a79d732b56230f39f3872fa96618c03158d41,5,693,362,26,1086
f2076dff7cbf59cc1fdabd87ca8702f48ddebc37,4,375,182,13,574
ecdb4cce6a2d94f48133a250dd5912b08a18c338,207,299,181,2276,2963
0cb9f55c9d10f374526532d247c912b7a7bf3c19,4,103,22,0,129
49878fedc2bd3c7632795107f8ec19ba06618f51,196,286,180,2238,2900
18af5a4e0698565bd4c762cfb029750619a71fde,144,153,98,1537,1932
e4def5922d8e02c5e3d3cfcb56ec997660f22eb5,4,459,207,17,687
f5b3a2b713ce90c4154009454e34a916a07d2bb9,4,748,418,28,1198
4f5c4eed913d714236e2972de40d3c62848cc076,3,396,192,13,604
91f6233a56a72b93927c2d861b5b58a025264a8a,177,264,159,1996,2596
79aeede37f472b18b611f5103e37fae6e768998f,6,127,34,0,167
4c8ef3f5429c8ad9669273048fe274caa91a0a85,149,184,127,1723,2183
09d612efacacb2109e7dd6fb7a44f61365b8631a,5,127,36,0,168
8331c8b9a9da0e134b842b6cefe5894318dd9e53,5,124,63,2,194
3216d082d1c992359cbc71f5078cbf03cd0e2b7e,2,96,13,0,111
35778081df239f09ce335d06d87d5515f219c906,184,301,179,2229,2893
8016d30b7295992a80b215d3ec922d8e30054e98,3,394,164,15,576
91876efe4c3da198dc5da8277f9ed769f47a443b,3,102,24,0,129
8918deb58b8ddeefdcaee3ebf3b613ccc774c654,4,591,257,28,880
9f72e96cbeafee79063b1004bb707bfe545ce9be,165,249,145,1972,2531
8d6c2e414862818ff7e879b531a30289bd267a77,3,360,161,13,537
1266eca4bd05cefee85ed21eab2b23762d779a7d,8,1246,786,57,2097
c47b43339fb9e0e138806d6205b8fb80bffa4af6,8,320,167,11,506
0bb88841906900533fdeb53faebdafa1a3b54c67,6,401,203,13,623
64b8e4aa48c2805ae1a007b1098e4ed1b7e89993,6,121,29,0,156
baefccd39c2b600ad43a20d5a546d8344d60b51e,3,383,182,13,581
65ae0261d5d28ed3b87fc5d9fa9f4928552127a5,6,439,192,20,657
f57d5864c52e4d850cd0fc238df12b48a156cac6,3,398,152,15,568
5bac35849af761384bdbb8de3be024d8435a88c4,5,63,31,0,99
85658c19445ab9e99f0d972eabb56c838d43fcd0,5,719,375,28,1127
a4b755df89f049056c884eca7a1fd0bcf4cb4c6f,149,184,127,1724,2184
4e78557b5af6ad8d83fa359cad0bcd81f6bbcbc4,192,285,180,2240,2897
28baf7f38bc4394bb87a2fad81cb55b374c3354a,148,168,111,1673,2100
d90e0befbb8eee2633570cda3bfbe7bf65c747bb,148,182,126,1707,2163
e4e178f33e8ecf2b4b74f8258f9a808564758245,5,780,448,30,1263
d5f41b7e2a6ecce36e8ec7a7cedc8f3c4ca3a8e6,5,124,63,2,194
a275846f229551ce0f0393bd8712e192b12efb43,4,505,234,26,769
f3d516d9ee6318b40dd10cbc2d533cd6abcf1260,149,184,127,1724,2184
0cb0291b8fc5082384bb4628b219f637ff5fa4d3,3,367,190,13,573
f9a4f1f7bca2d33a13e6ffdd5ca1453fa73a5fa4,2,94,13,0,109
81ed14787a632654223e79136baab1388ce02ff8,4,386,204,14,608
8e171ea1e9f0fbabb38954b0415c937a12205931,149,187,127,1726,2189
5fbabe29dba0e2da9b89d4a4da96062ee9e871db,5,100,50,0,155
5db4d6dd3e2e3168121aad7eee823ac2b329e297,0,0,0,0,0
c641f3a18ac496958edc99f078c68758f3d3c275,0,70,6,0,76
a6af86946a0f9f022b03a4ed55233a8871072874,7,927,566,41,1541
2562a880f818481eef87c59b4bf20c2f2e818bb1,8,1267,817,57,2149
64b855b3d21e89c34606c5715d8a3a6cb02b5229,4,523,236,26,789
16410c031ce162d631c3e6dc7b1798902bc3a1d5,4,591,257,28,880
39738af8fcb8691e3994d973163f1c3ad18fc86a,0,70,6,0,76
8b482a68801b46f3598c53769b7702a09802e972,10,1295,858,56,2219
808c44faac8e1f348dcb95896d8f537a89156414,8,1214,783,55,2060
84c72ca90c7180ab5ca3857063084a128504c304,3,400,168,15,586
4ef7e3fb5a36ee7571d7a2577f4b73b3fd5ea392,6,1182,768,51,2007
4976dd6bca27c8ec5b1adaa6d6a6c7a0a633ce95,4,382,179,14,579
7f475ca53056f545654b09266f90b65ba2b6161a,6,842,527,33,1408
6aa4a5f034badaccbe273724a658982eb50bb94e,5,747,420,28,1200
850b8f2b858105cd38da9c6a8cd2c4ed0b37651c,183,273,166,2045,2667
4287bce90928aeef601cbace11d1431e698f6f45,5,116,33,0,154
4568f89726e17c72fe83774def675727c9b56653,151,168,125,1701,2145
1a1790f81e2e037ae3e62eb3aa5d292501bec64c,4,591,257,28,880
87f794d43954ae3016953acc992aabd3ac7e80d4,190,307,184,2301,2982
72b7f15056842d6ad1065ae0be86ccef5a1801a9,4,382,179,14,579
c51f0689fea3e74c039ba783fb19433f8f642a4d,4,64,36,0,104
17d368df0a50ac12607cac27b5562b5462eac9f4,4,496,212,27,739
3aad37db853e13f2939abe6f173fc464efa14485,145,164,120,1675,2104
6f8f2d551c8f1503c32f3c117edba9b8ef980e1c,5,359,179,11,554
a36a8373ed7c81c92e118fd690ef9b5cd48950db,7,309,174,11,501
be90e3443b6f6a4efc5a26153e075d480baf356e,5,119,60,2,186
1b7b385cb8907c7b57ecf3187075d03973e834b0,4,101,23,0,128
7a9e5143e3022d376c277ed19c4dcb4ec15cda0d,189,303,180,2261,2933
15dbf7fa4cf093d22eb818bb0b73238078ce0f0a,4,380,179,13,576
2c80efab94dcc681dcefc6b9f621382925c27d51,0,0,0,0,0
28ea85482b9332de21e78d035142e09b2b29f8d5,0,70,7,0,77
79bf1d54d698b0e5c636aea2fc0280714a28c3bf,2,95,11,0,108
a79bfe7c7c788f15e11028adf26c691b39ebaec7,5,637,311,26,979
1eb2212d098a6559417fac8162c681ca8f2aae02,4,418,168,18,608
740295be23ef44932a25a21456d46799749f77dc,0,42,5,0,47
f69be111ef302822f397294825694f281c81f706,11,1273,802,57,2143
b860a99ada3d54b9e642d520d1dd573385969bcb,3,393,156,15,567
16cff29153eff22ecbba258075bf854d7868311f,190,307,184,2304,2985
934ddf58e49943d7f37ce2176b518db52168580b,5,121,31,0,157
14f4224b3b6a6a63cab7e1cd6099d6f9a4a12202,4,100,21,0,125
3ae811e32ffa76ea86740c202b6aceb7b667d84a,6,1066,693,45,1810
7f732fe8ea040704a888706af2233c6b80398788,6,1195,767,52,2020
ab941321653acda7e2d6493872181306864ab803,4,368,176,13,561
b763be1732e5a3e83d46c3012830d363de9a464d,5,479,206,21,711
64499c8bcb65d8d6f24949e7b83211c147e97153,3,298,154,13,468
d5ba7aec6bf7df78cff316ed9215a5412cd6f15e,6,121,33,0,160
3f247d4f1f4c610e0d6d3cf9794867d2c370a30c,4,121,27,0,152
f6c003a8c05e420251d64f74bcaec7e25fdc97ab,3,355,172,13,543
5f03115bf55bf5cd8cf82c7269cfd2c24a76f983,7,671,303,26,1007
7d365755c186edb92e3ef563327154c259be02aa,162,219,140,1951,2472
c48fed735c489d754f6b8d99e2e9619ba0228851,3,340,154,13,510
977a11dbc29d40b4f2746272d571355530779d6b,5,127,34,0,166
a8c35650650fb59e9c98b767ec6380324a743614,5,75,48,0,128
7b36e3e4101e39a03e71cfea90a5593f22efd185,149,174,127,1710,2160
e5ce2ad4aad48017f4d1fdae6ec8b6b641ef6d76,4,590,267,26,887
10d20fa687e5d4a8d4d4dbe789260e4f9457451b,143,170,117,1657,2087
0a2d9b1393843770a5092de4484d5e631eece71d,4,101,23,0,128
0a0cf41b96963cea08b1bfc4404f0e9fdcf7a82b,6,121,35,0,162
96117496c3f6ff47d675e571d024f6b3368ccafb,4,103,22,0,129
19f134809d4c705eba7f1a7eae8a25b2e1a668d6,5,794,468,32,1299
c271b90417b2b3a68f0a652aaf758d6f4c6bfe9e,5,127,34,0,166
a782e611cc42b8457c4e245c02c1a830a7026f5d,3,400,152,15,570
a5325489f25188be28b8b0ec5c6d9dd842f8f167,6,876,550,33,1465
1c5047a58c3dd52ebbd6b3571b11d9667b769582,182,269,166,2040,2657
5e54dbb1627399926152e1a038cecb800090b845,148,168,115,1686,2117
cb8f3b5d5bb3cbf6589c904a49bf7a2f47d2983a,179,268,166,2039,2652
88ebf4baec315dfa979381deabb9ad409531a189,0,0,0,0,0
2255eb28fbaf65f05ae2abf967db37dd63715556,145,150,98,1457,1850
75ffa73af7493b13fe23d528c28d7855c2428410,3,390,174,15,582
f4920da4ecb9a0429c03327ed6bbfc215031188f,177,264,157,1996,2594
d0c9629639049b6fded839236b2dd5017b79d7b2,5,71,43,0,119
05090c5f2ee6c4c3d021bdb856d780e4a3ae7785,4,101,22,0,127
d99dae1770ecc33bb91dec7ba7aaef2ecea33b91,148,168,117,1686,2119
5863cefcbf996d8bda0b43320be04ff2b032b2c5,6,125,32,0,163
45c3a4224042204a9ec0e17039ed079fd724c465,4,121,27,0,152
9014de9451c2ed18b27612aaf04beaa59bf2bdbb,4,553,236,27,820
2dab50198566ff8802947cb4ff145b896f0ed460,4,549,230,27,810
33132b10b4d5c73f07dd9f1aece49ddd783c9055,0,69,6,0,75
bb3fb0229754b37086dd5291c9563ecebb0cfe2b,177,264,157,1996,2594
d20826f27289d93c8e79fdc203c67d9407fb5a2c,182,269,166,2040,2657
b2351e31f0e77df19796dbc1f920794bc5d102ae,4,591,256,28,879
60e2112d68b67356a05c1407533224e7d7dab988,5,69,42,0,116
f14c355422dcf6472856ad865e61d4aad9d051fb,2,95,9,0,106
c1ca97646227bacb8d86d086a608090695138b28,0,0,0,0,0
22c25e3e8f203f853e7aaeee51baeb537dfa31f9,6,410,209,13,638
783be8300685c7ef58c248283e6e4639b1a92535,5,519,230,26,780
cba1648c8efc6c29b6cdb290e0253978e70a482d,3,368,196,13,580
2ecf5e12d7f13fb25da70df3e1b4ad3364cae326,182,269,166,2040,2657
219d4f1555bdc44f0b17687cb341c623c171d59f,5,119,60,2,186
0a4c6580b23347c513a8dea1763a1d03c606225c,8,1259,831,56,2154
ac8298ca3034a6ff9f06b1ec1bff6741e3395d29,5,119,60,2,186
15b4f12fa24a272d5e945729b140803a2ddcc606,3,391,188,13,595
498e8e69d8f89a90aa6d4b9fb6485c8276ade4e0,5,84,47,0,136
6de214b80d155b2805f17aad23480e097dde8ced,148,168,113,1677,2106
47c660fd34a45ac7f7b29245a1df3fb7a8547783,3,393,189,13,598
4f174a1804d97539e0a9a75a3829804fedb2aa90,3,392,190,13,598
48e8e7c4cfc1c580562981a6be9755b667660d94,151,220,140,1936,2447
dc84e364057c1c4265c40314826dfe9824f96149,6,874,540,39,1459
eee3558e0f5eab3ebd9f411d30ad10e77320e142,6,1148,752,50,1956
f6fa003d681ae1b97bccbbb72fc5f0f1c70d0528,5,269,150,6,430
27c4be365c9d23744391ce2bea7027b83a405b8a,6,843,485,33,1367
91170bf16f354199c8d83549c27fed08e2170c65,5,364,171,11,551
09de4054b45ff6da5cff6035026c19fae7dc5318,8,320,167,11,506
6d3e0e640fd19260f07e241c0d91b75d6aaf0e1b,6,127,34,0,167
3f2df72aeaae3eb8e3907bc0ebcc62dc2be16189,0,70,6,0,76
9a4c18769e2fe1f872613a989f167536188d4abe,164,210,136,1898,2408
b87b7bf16efed94bc614c8168789ee657a9d26e9,3,390,174,15,582
8b9101d0c5615c57a86428e3aa7bc0e436f728aa,186,275,172,2100,2733
23c785ff0b7b0b0e5ad7c3987d988fd248aef0ae,3,377,181,13,574
b3f8bca1108b50d8471dcc5538ca4ac4aaa2ba17,153,230,144,1941,2468
90ac47453fd9cdefa2c1dbff57005e217e666a04,6,850,513,33,1402
e85c9fc8385b3d0a07bb13d910b19da1602d8468,183,301,177,2226,2887
837d17b94beb6b8d6c325395e6baf8686ce706ee,6,115,30,0,151
f153ddf4d6d1ef4156dc62f184c9a8da64343250,2,94,13,0,109
8b783c2ad781567723356d6432ce943d6f55ac55,5,127,34,0,166
cc7f645933028f76abfd00706ee14aa046062a91,4,522,238,26,790
953d554bed1f3748a2509d78cf059f535798e56f,5,84,47,0,136
cbf80b0e2d1af7ba74cf00396b8da3c8978f866b,3,369,180,13,565
efa172514a61e4f613e3d99e5b0dd2339e245be6,5,637,310,26,978
9026660487abfca6dc5c4dd89d9a9a6f39d3a150,5,127,34,0,166
23946add8fd7662ef6c3d10ee290b99462a3e3e0,4,386,206,13,609
fdf6523d27cd897d72a306e8e74f3ffd386d0bf9,6,646,298,27,977
82d961483306fb0e9c7df1ceaa920f976f561d43,142,150,96,1539,1927
f7204bdcafaa6282ff9e8a730885cf530aab175a,6,842,527,33,1408
d630e0b8d03e606d4ca6f135c385dc492af2d5f6,5,66,39,0,110
d6abed27e44786825d89c9e3aff7396517faf4f8,177,264,157,1996,2594
b5f8ae414c13b3b4336e8b4c526dcb926ae498d7,150,183,127,1684,2144
2d29e5444ba9c88d8816437125b0dd451f048288,139,150,96,1531,1916
f0daba22295c7aa45077f1e6d1737a23b92d5578,4,591,261,28,884
c1cc9e56126027e57ec2157434bccbb0b3cc3870,5,63,35,0,103
9fd609234bb426081bfb5ea7203aa9d30d163ae4,6,408,212,13,639
7d5d9fc3b88d7cbfb46d6a1de5a7a226b513f957,3,358,156,13,530
26348877ebfed71a7745377dec83284547bca8a6,3,391,156,15,565
489a986507c49c7f1eb22f1afd2d194cd4fb4983,3,298,149,13,463
ea226813adabc183649129573eefa55522833eff,4,748,418,28,1198
196923a118abd73d0a317f1a5c7048fcf5b4eba1,4,374,174,13,565
1122352e81010a96fcabe13c6c4e8dc18f4c3b58,4,121,30,0,155
13b509b70de84e24e1a11d1ffbd74ef0535e39b5,188,279,178,2191,2836
56fb1a0aa2c49c0924ee8356b4b04864f2fc09e8,2,95,11,0,108
b82fe54415e0eb1d31778306a983a18e77f5fc82,193,283,181,2217,2874
f7264b2e34f4159b3328165bb5e48423ab1b8920,6,117,30,0,153
6bbbe845c6fe5921d2d2c68a306368fa46abb031,151,220,140,1936,2447
f6f589b8b014cb568d3932cd14449bb173b9e384,5,475,204,21,705
469d1d2729cd1713f1c20909045c8110784ad7bc,5,116,33,0,154
00c635e0b095d096c784044f694ccd2eefc4809e,5,522,235,26,788
8ce22facee89a94949e4f79cbe7cd234d0ba37d0,6,439,195,19,659
fdd032a5a861ecba5c3bb10b79d914cb15d71f25,6,121,30,0,157
238375b63cf43a945871dfc76c0cfc5131f2baed,5,665,337,26,1033
510dee181132e4f8374e346afe899e1a09bf67ea,150,162,107,1630,2049
378f190650be10871d703a8a74991ec65a4ef7be,145,150,99,1459,1853
18fcd3237049884d4e23c5deea6e292007a9e778,0,42,5,0,47
cd79decbe7419e44128e1efa89d4ca00fdef5fc8,4,585,261,27,877
7a8a2701f8c8792947c6c4c89c6d88ec64fdb56c,7,348,179,11,545
e2b4e05f07704e8d171d6c38be4649fd88ce1f61,6,411,220,13,650
372d70bd3056b0ba961f317acc05f2cba121a3e2,0,0,0,0,0
54ee3cbb3cf11fef4d8a0b5860dd0c895879ce2b,0,0,0,0,0
5d74e83849df3b2ec8ded37287c38f00989bca64,5,637,318,26,986
679bdbfff57d00bad7e86af8e0e7b1fc5f0dae3f,3,298,148,13,462
2f64ad85dda704d596270bdfb2f7cf2f198f7f2c,182,273,166,2040,2661
3568b3b2706c904297b8edb32f1ba32fb6980da0,6,117,30,0,153
5cefd4a1fbde287097b9fdb6f5aacb9491b88580,3,344,163,13,523
34ba6fccd3ca33806c061bf99150b00bdc5483a9,0,70,6,0,76
10eb04dfb66bc4572a8f961b9974dac1f1dd24f7,5,795,469,32,1301
c9b7f2266fef3fcb70b3030a1ecc94b8a3418a28,5,663,339,26,1033
42a8de9d5fc5381bf3f0ef37d555175357781d44,4,103,22,0,129
24dbda0a93a4f01720ac452d43b6057828bc8633,4,100,21,0,125
6d989cfffad12038576cd6a1f07dc3683c7f792a,2,95,9,0,106
3bcbff82f7f3d6e45b59f7d86e91720d23b83ffd,5,670,334,26,1035
4c31679571d098927726b7a6bd967c2574c9c444,5,119,61,2,187
64fb6c2681d971dfecf734ec929f5bd02fa1b324,6,439,199,19,663
7fdbad2406861dd2925ceda157fbb7b572069c5d,6,1047,672,44,1769
73e006d4aa114999afa3cc8633b6fb88c7b8ba35,4,457,206,20,687
bfbdd2d2b8d60e63a5835665eddd292cb70dab0d,3,383,182,13,581
95cb7a1631dad1a41e2aabba827049ea96d5561a,196,286,180,2238,2900
fa1740c8e219f4ef2994bdf906a2d5a9e7f6fab5,5,127,35,0,167
cd162c3f6d5cd2567e82875c6aa2c23a7c272ca7,5,116,33,0,154
da4b1b1d4fdf2760db9d43739f571fb2522bbde1,144,137,88,1190,1559
eea1ea20dd65b1afc982f4c0f38e3d1f39bd80a8,10,1273,796,57,2136
f88af6565d515614f8383ea8d1e31e65b152e1b8,5,71,43,0,119
b92c61faeaff577eb8ac051b4ab349f423dff7e3,4,591,258,30,883
265f5c76f6d44e06fc492f4b020bd2811441fe2a,5,647,307,27,986
411c89d442a03a62ea100456c3e1c1cd5611e206,0,0,1,0,1
53e899e4b57213b595ef4dc9831cd9fc6028050d,5,637,310,26,978
0785a9271db6bd34e1923065ec3951a1b7be6e13,4,469,209,18,700
9ab31f62229e601af070fc90bc2fb2eb77ecf158,5,127,37,0,169
8c98033b185bd65de7b2348ef430a065e34b4e7f,2,96,11,0,109
a8ec52200a91832e13744f925c395a0423f5901f,150,159,107,1629,2045
5717bbd729a922ba067315441a94b6d0ce970401,5,116,33,0,154
876693d05d482321ade6fc7cf85f48564cf41f7a,3,370,199,13,585
e7a397e3ecc47aa4231160f741506da1ef28ddc8,6,117,30,0,153
8086462f7c16da45b117ab3afb1c9c0da9612d02,6,438,193,18,655
e99b92951a8c0f2c1cf4f6811223c344dd528307,5,84,47,0,136
75eded93aceafc3257848e9b50bbd59814baf012,4,591,257,28,880
576c7386661933562f216d24d92196e5ab86c816,187,279,179,2188,2833
0a3acbac8faa36105592189222f68920d4d0e116,5,711,372,27,1115
72ba7dc36f92ac68000b38918cbd72cf1c97f81c,6,394,210,13,623
0b816567b41466eb0a12b6e3e1b837c1672059ca,5,477,204,21,707
3260bc55bd48b60186f1d65172e7d778b3ab523a,4,591,258,30,883
70658eb00a1b465b40230ab2588926a4a7747f52,5,775,448,31,1259
6f16370052d849514ba526d15358cd48c76c33f3,182,273,166,2040,2661
719861b6382c436cf572b0e6e84b8e51ef4de5de,5,66,42,0,113
64d7dd2b62d5eef9c52851a1bb0448588eb468df,182,269,166,2040,2657
ce28507a5278dfa08d5303958e911f7bf291bd79,4,74,46,0,124
462b791471de3f8741c07ab6cd19700cafdada13,160,193,133,1811,2297
9b002b50fe101f24f9f36b261229af552e2003b8,4,137,78,3,222
bc5a37a16b8599f48e480310b29d3823be2ef93e,4,747,418,28,1197
cfe442e88a549292e35d178f0f3d32dafb4caf5c,4,511,234,26,775
3f372ae368e5b3ff6ed9036c0c218cfea996514f,4,101,23,0,128
86a7e7bbac949b5b15034f9f7b67fd5a96da7966,7,928,578,43,1556
520485e038ec8376430cdb28ec165fc15228fd8e,152,150,96,1543,1941
e352e82dd4b1df5a6e3aa3d8ab411121ff631675,5,663,339,26,1033
a1adbd23d00ce83bb53625312a665e2c647917c4,3,393,189,13,598
bc32fbbbffb932f9084f97c7a2fcba472a3d451f,147,159,105,1608,2019
aa8db9b36da093dd128d551a210ff276bf0dafb7,6,877,550,33,1466
eb3a67de77e4a5cf0351ac396c9915e7f798220b,0,0,0,0,0
6430ba31759c77c020a48964f9718d8e195a115a,4,121,30,0,155
7eb36085f8f42580f91d75093f06ef7e1877f28e,8,327,171,11,517
17b78ee469f9ab4678c9aa823663f0cd4871b1fc,0,42,5,0,47
28aed01558b8c8b6e9a183e90fdd3e1406f57a67,3,393,189,13,598
cc91aac9c4fcde5e40b120251acbd3b45b9ff875,5,116,33,0,154
9ca6e88a52cae9b4a497ff99b2ff2513af443fd9,177,264,156,1996,2593
4c2e8b42f6cfef0fac6e45ef3df2cec3bb1cac2a,3,296,152,13,464
06d7d2be30ff580a17f5e7c6b989274835686d61,6,1194,767,52,2019
883c2239fb1e1966e816b74182c109b2b8f9be97,7,651,300,26,984
ad56164ee6740b3f282c26cc9092281460e60fce,0,42,5,0,47
ad65faf7fff693853cd0b659a5d9ae00ba73750c,4,132,78,3,217
1cd290053e98b507c9918504ab0e20a452aad046,5,747,418,28,1198
3d9e69accc7a50ffe5e739bbe365b5f3e2af9006,150,162,107,1629,2048
ad5af4cd2ddb3cc679b532cb11f9aa8036f0f089,6,438,194,18,656
0fe43c76555d70a6e7847988aab7017856963418,6,117,30,0,153
6e196f6e8995406992af8a388640457f85b31763,3,402,170,15,590
0652dda968c002012566fadd6a4e45c15a9d14d8,4,591,257,28,880
2580abec74f927c46046f7e79b46874eb597e387,182,269,166,2040,2657
9e6b42158180790c62027c53458864f9ba3305fc,6,842,527,33,1408
e1fabf37c3541ee374216eb8a31f9fd56f7cd90f,8,308,164,11,491
a36b692ac65006a572c6e11176c541f4e9e1b4a6,149,183,127,1722,2181
619f61a5067faa5ebf4c737df40e698324f4dc25,3,366,188,13,570
40dea149458a763ca6642c8081d46c72ca1acbd2,5,479,206,21,711
07deaf2e72f37585251e7e8ede12ecb0eb3d0682,0,0,0,0,0
26c8783f8f344c77b6acec0d9256d4d5149a37f5,4,85,48,0,137
e427b09bfaf84a0d2e0e0b6d3d77e37d5e20e8fe,3,311,158,13,485
a085da5f0ac7316dbde562f0182b79f96617da15,6,402,201,13,622
177244775c5ac9f6e455fe8f736f85f2109d9bfb,4,101,20,0,125
d5fb6c71e2864277c6535274122496cad44f0ef4,4,363,176,13,556
745aca6b6d636d45edeaecfdcd7512f2cffee08c,3,383,182,13,581
ac874a3cc7ed7b003234399492d6c7410aea5823,8,327,170,11,516
40c320ad076d96e6f9caa75f40b30d16da185f84,4,84,47,0,135
a4b829d8530fcc79af5db0fa5249842b2d8bc2dc,5,84,47,0,136
0a858f3599a4571f109c0464ccbc9221e232f106,0,0,1,0,1
2f905662ad8c7e9f40d0245c40afac1fa4f7b254,156,197,134,1881,2368
d974191852c8d4796d34823a6f922efe87241d0d,6,128,31,0,165
a5e5f44d32662a0db04b7845cfac8429b8ea8ba5,6,401,195,13,615
b52b9acf782e2ec61a3a9f751dc96749ed868ccf,148,163,107,1650,2068
b3c42c4d3bf29f75fa74fa3301a66550012bcb05,4,504,227,27,762
afeff4d4250dcb84749e958a1fc6218b1d7abf2d,4,520,223,27,774
79562f6e8710283814331b3f7817bbb1836daedf,177,264,157,1996,2594
f30f63cbe1f75a56a41c197530b86db58869592d,149,184,127,1723,2183
4f925916d846a0689f385d4de8268807735d5dba,3,392,187,15,597
86a217f9c2676af8f0e34d1adf128bbf0bfbdcd3,6,403,222,13,644
5dd61fa5da63724117eef14eba40b16b8a70f2c4,5,747,418,28,1198
943ccd771a85cbf28b6091c8f6d282beb068a60d,6,439,192,20,657
c56ac454d27c2af26dfb37f68799494f4982ddc7,6,439,192,20,657
6f74b73ad2267844c4209eee31efa9e2fbb380ac,6,1128,738,46,1918
6538b2d03e3cd5d92af70e438162c2c802441b08,154,221,140,1933,2448
d895ddfd3e88fb0ddf136e85a3149d51c7e0da60,4,522,223,27,776
2afba02adcefdeb81042890e92afe2ea2163c40a,3,401,168,15,587
8ca9776b509ac81f3c6871b02cbc9a840816c7a5,0,60,6,0,66
61a1ac4152205cad2453e962297750d9a4238deb,160,194,135,1839,2328
14a077428f594b692da85f066bd4795e2060ce36,183,273,166,2051,2673
f86f9a318e8d72d020a065c36a707555eed81afa,6,121,33,0,160
61e9240df5a9032c524f157eddeb614582973e93,5,647,307,27,986
fc447b1b873a734b5fe7acbdfe4c95497178087a,4,121,30,0,155
368f553ade18cdc230fe5c2ac0402d71fe850092,7,980,640,43,1670
28c6107406896e695daff36ec5c636c4371a62f3,0,42,5,0,47
af1523f845f08870bcadd8a6dfd36395502a16dd,5,71,45,0,121
53f99b5b32ecb944fd61bd02276591cd19224c81,4,71,47,0,122
f9929119d7a5d4b3a7b3fa09ee4f0e7b7157e8b9,6,465,201,21,693
e25d4468b038763aeca7e76676f0f05b4021f293,0,0,0,0,0
875057ef745eb5c7fb82f8c4c33069b0fb023a67,4,70,45,0,119
5bd32810885e589a47d394d0900a7659938dae1f,4,121,27,0,152
006c8f7b22a59a2a9888a85504fdeb91691b2308,3,363,173,13,552
72f9636b1f04e2cd38613727d77a8282ecd18b5b,4,386,204,13,607
006ede4b3620faef428af93416d7d683cf615ad8,4,585,257,27,873
3f7123e5b8ff9219e5c49070c0e85592445f1941,5,724,387,28,1144
7b79fc0a689d087ebea1e89beafa6821179a17bb,0,0,0,0,0
ee3a14aa2b012c89c7099fdf98f2620224f64f5d,4,130,72,3,209
698fe2cb77c89c1ef8225831e5dbd9efcdb2755c,3,324,157,13,497
b58bbbd645171e2729d27d49949949deae638a92,183,273,166,2051,2673
e4c0c4685bb8aae9147650ed7ba15949841a8354,5,127,35,0,167
f19b2057ca8d3f75d492385c0abf9fe0ec07f2e3,145,157,105,1604,2011
783c2dc1373d80abfde426317e4bc62f4b82fb9f,5,510,230,26,771
f80db629383686803be3ef2a9a2482c1f233aaf8,5,800,466,32,1303
d998b409407c38f4317ef3ff9e5b15fee94ff352,177,264,157,1996,2594
60864d40547953ed254d86ec27dfbd84197ce657,5,637,310,26,978
ef73f9b099ec3fcb55ceb430458f1b62012cb43c,6,842,521,33,1402
0ebb739b3718dd1797afc59af5af311d5b5ed0ff,6,1111,737,46,1900
eba512e362feb493e7bfa195008411a6133e292e,177,264,153,1996,2590
e11b67acbef353b1425359ed487d0fa46e1672ac,4,591,257,28,880
2f0a60fc7a9574aae591b0e55cc48dd30418cfc2,8,320,167,11,506
957cf9f965ddba8067324e367ca77c85d3bdfbda,4,130,61,3,198
3b7a80f355aee304612a2f409818120e1ca414d1,0,60,5,0,65
ef5c700afc826b2608ee2601742e20c43ed2bdd7,145,149,100,1545,1939
3ee0b23acfebb5d655bafcaf0139ef3190ac672b,177,264,157,1996,2594
4080ac0975062aabc9554b309b233f453b3c97de,192,286,180,2240,2898
97fac9e6071a1df4a9884d133828ac9e1aca7374,6,124,31,0,161
3b506994a5720a705889a01b903d70287786b711,155,150,96,1547,1948
6fa6e79fee433ac587bca09dfaaf31df07fa5648,182,273,166,2040,2661
ccdbed8aa585d5cb00df9a6ca0e841c18acdb395,6,128,31,0,165
4f84ac5f641dc8b842c0cc06d5854a455939cf80,188,279,178,2191,2836
120dee38aef98a5cd6cd6b7e905def7d6dbc5e2b,147,150,100,1481,1878
73bef44c79264b6bf139ce6c50c581b8dbe29f04,153,230,141,1941,2465
9ec4d28c7629e47c6d6ca9e40a5cb2c37d6d98ea,3,393,189,13,598
e9fb0fcbedf7208d62342b31772168f72637e558,0,60,5,0,65
6c608e6b682bd1dd0d1317fa2641533455483998,150,183,127,1684,2144
c010fe959925c225fa6c8996fdaf7d0689d720fd,5,728,379,28,1140
4f91eedd00d8c97d7ba83b4b45b67d199b3a7f62,0,0,0,0,0
aaf931ff9e27fe0bccb6015fa78118796a26090f,6,123,31,0,160
941598ca916ac2e7763eec589d79afede4a67c03,153,230,145,1941,2469
bf5f3e3680ae5220a2fdd487e0ac4f32dcf42859,5,121,31,0,157
fceaea673d65fe359ef0de61527d973a2d1c7305,183,273,166,2051,2673
0985f62bce20ba6f2717d60b1f2a2fba2231d429,4,589,261,27,881
404a5fc192e3d1e6e7fca35ce06db65ed0d1a268,5,671,340,26,1042
e9835b6a3fd474f207dea6628e6842e479a08b0a,5,479,206,21,711
6a89b73d762e0af7b06e0a87b08746651834aba0,3,393,189,13,598
39f6533e2c54fedb11e05055e904c2b2976277d1,8,308,164,11,491
44b9ae4c2e35f37d1b17d0a40b70f46fb96b1088,200,284,181,2258,2923
457f7302482971b08cb4a73d185374c6fe59c43b,4,101,23,0,128
824ac34249c02cecb63064d002eae9099951d6ed,7,361,187,11,566
bc12e4eba4d3e25ed6320328d81f2366e63f7033,8,1232,799,54,2093
e3b52efc4dd996749006e4e880676b0766665cff,3,302,149,13,467
e1aa8ea347e7ca413075fa6759580e58d651eafd,6,1119,732,46,1903
c075e315e3ac84c0c0410360a0dac3ceefa634bb,2,95,9,0,106
2a75512053cabd0ca6d7e63118744507c5d41d87,5,120,61,2,188
62accc96921f2bf906621d2869207b7d1692304a,6,117,30,0,153
9fddc2893e6e4f383468f49faa66e186a09114fa,4,589,257,30,880
60ae2eb17bf52e2f8464b41f11dbcdf2d7c1b15f,5,672,341,26,1044
441f5e6e5f35d102b970bad812cd1ebe0801dd1d,3,398,156,15,572
765f1869406b79ed96d4811c32ed7f136540b282,5,75,45,0,125
0c380015272da9ae40cce5374dbbc4e46e4c8fc7,4,130,70,3,207
3119a6d29df6563e7437406db2bce70c9f07c832,5,663,339,26,1033
3dc3df55861f6fbebf6b7e3e3d6ca5e77ff55464,4,130,70,3,207
421474fe6322ff5f1769da53a0ad4279a0799903,8,320,163,11,502
b0784ffb77417942194c9939c2c51aab2d286ab4,3,363,162,13,541
a0a86b06abfbe965626788747bbd8731259d87e3,4,367,171,13,555
ddc707d64819dd5cd4191be71e67559dccabf0f1,3,353,172,13,541
f07bdac47cb16edb97e3346433425cffdd08ee06,0,70,6,0,76
f4af15cf7a7531990143731b68d4c25acecae0cd,5,637,310,26,978
5014a8308442a9a03ade85b75f81d02bb1881656,5,645,306,27,983
3fc429352a8edecbe5094e69a1b339f6e164cded,4,520,234,26,784
f52b89746b321c7f6f25ec5243650ae9908343f0,6,1085,714,45,1850
f5cf08a5722bc8ca49ea70a82dd08a06075fb611,3,401,169,15,588
0b4357cedc273c0705031b374693b8bab55286d0,6,411,211,13,641
d0c4a28a8a2c68b1ca7da4320260173150a4d6ea,0,68,5,0,73
25c79057c263c26d7b7e1e19340ca60005543872,3,383,182,13,581
e8bcc890d073504e0797607cced77820ea139508,6,127,36,0,169
c17829b5c46fb974b7362f9185515d31e1be3c4c,5,640,309,26,980
a4c4c54b8aecece1269a1fd6db78b92f698798ac,4,570,247,27,848
cc83e98defec91b23464b294dbebbbf6787cb3f9,0,42,5,0,47
1a5d5b3614d477c1aaf9cc8fe9e92db16183ee5e,142,150,96,1536,1924
2aa8e432acfd29acd3b882e139843282681bb9e8,5,367,172,11,555
fe85d269222b1266f917f45eeb3b69cbe159cc0d,3,398,153,15,569
8d292be6495e757464f85d4b11b57d37e2eab032,0,0,0,0,0
731e372655e92a9b143830e01b7b946483880b7f,178,267,163,2027,2635
d7ff82fbe34a4e9bad97a387b5bae2b0e5c806a2,5,63,31,0,99
0d06c5b9efeb11c7e7ac69fbfde79e6f5f22505f,6,121,30,0,157
9406bc60d3d4742ba70c4df5524d581d8e5b3dc3,8,314,164,11,497
78bb03219ca88758f62760ba8d55f33df9ca70cb,8,308,164,11,491
eddb8c4e3af566862eb2613ce42983bd0ea0897d,149,184,127,1723,2183
0f4e19ff79912b8fe98a5c9836c4e276e3ff19d3,4,101,19,0,124
865c21f3656191e26f56daadf92fd54575771ae5,5,647,307,27,986
5a846574041f43c89fee498dc940a0cb5e97d880,5,515,234,26,780
d45d99c6e39c06f6b6e6f3856cd317c10b0916a2,4,69,48,0,121
e20af5fa1b83466736c7fb38aa9157cdd19034e4,5,422,171,18,616
4747b33b7a2d0ca462b0e5a91e799e7b897244d2,6,401,202,13,622
b14002522833d569ae2a47589cae1dc8d4df67b8,4,591,257,28,880
2ae51d5a76d02323a342fa20cc7fc18ba0154458,5,801,466,32,1304
0624445611a32e8cbed6aa71f8ac15c5b7d9af1a,6,647,306,27,986
af4bef2bdd3405b2b5a13d8e81c210799f4e49b0,7,1041,670,44,1762
f6b2c95b3ad46bc77fe8f082cdc344409ce9def6,5,746,418,28,1197
43b31833d5500395a1e1c3b12f04c9ef25e4372b,5,106,54,2,167
befa9a4b0a10f4e0f05dc678c6659b02cbf7f4fb,150,190,129,1718,2187
30689895621c6e03681a826c75af687dcbe5971b,3,357,154,13,527
3f239f1d8f4e982b80363f0dc4c920a8342886cd,8,320,167,11,506
5e4b5da7cb330f9d4d778e4ae5d4c21805bbfd7e,150,183,126,1645,2104
bac34217a32fd89e707984ce6ece359fe0e711bc,3,393,189,13,598
f75d93ea3c3fe42837c26f0c6b24901dfaf64fa1,6,842,527,33,1408
3d3eb6190f734053de7cb4a6a68711f23c48553d,3,402,160,17,582
785ed01324b703be42471ee734fbe0fb80ac92ce,5,66,43,0,114
4c7d7d4959c08d832b07ea9bb7210794833f5a01,0,0,0,0,0
097e49009b23d24092dfa358a51fd7ddc103c558,3,121,24,0,148
4c5acb98258dea838a34b064b5961ab93f5db5f9,183,273,166,2051,2673
5cedd186769e2eeb9e5b42c1de1ac38eeeb55483,4,591,260,28,883
1948a122bf98b54051a2fc075398f44fb6d985d7,4,591,256,28,879
9b509c7a57d139ef8d9259ac75b61c7f25831d19,4,390,210,13,617
8524c5d79f85cbc5f4548813e6146e2aa3527da6,4,101,22,0,127
7286f8376247d2b7286dca6ca46c0ac8a7e9dce3,149,184,127,1723,2183
eac8961a601c9eb4b05b172d623f4d4c08ed7c08,6,115,31,0,152
b1b5cda383febaa5b4342408e8554172567acd09,3,393,189,13,598
118e1e1aa58a77c5c90b1f542c1fc3b93618afdf,6,383,204,13,606
4fc5a4cd26bb45c0a1ab25424ba177a917d3597a,5,369,178,11,563
c5976634c63b47ced67dad9150c4de6f61fe4960,4,517,234,26,781
8f8b3433a9d0c909183f086a33c8aa686a370cf6,7,1003,657,43,1710
f7a9b121f1ef32b5df172bebd7d4eeed0ddd6dd3,5,127,37,0,169
dee54fa2b106298de40ccce9e01b99f2ce45feb1,3,392,187,15,597
a430615f56b1b96202495960649a39fee29be867,5,120,61,2,188
7e6d0d7cd96d56e73138f48bd2b53c59060eb035,5,127,34,0,166
853f51d8a5565578c10374af07fe354ad215e347,7,335,175,11,528
434e82f554e6eda30810f1d94d9e61a0f213ccff,5,747,418,28,1198
e4c6dfd855859ea3fc88a785d070626598ff73bc,0,0,0,0,0
24f474c15e2ed73a4ccf137fc6934a12f0f8bb79,153,234,141,1947,2475
6d2b0d9161362c4941888bdc139e464257545a98,151,220,143,1936,2450
c809068f3751b4d9417b39421d1cbee38654aeed,6,395,212,13,626
caba1d08a4d2e164258eda38052ef10fbd801003,183,301,183,2230,2897
2a58cc7d524d5ba108555e6244607b07eed44f08,5,84,47,0,136
261a1c65b7feaf998081a91841385718b088ce84,182,269,166,2040,2657
29c4ab896bbb910f160b5556c0f1d9d3a7a5f032,183,273,166,2051,2673
cba80938ea23e438cad6bbf7db26336ad22b1d8c,4,505,233,26,768
1e0e91edf00a6de2f4d3dcd438e0322353d78261,4,456,207,17,684
f1ae58aeb283f8507ce7e0a967e345b1ce5c67e9,4,590,267,26,887
7aecb0eff2d9ba0db99f2dc8c555d2f2fbd963b0,0,60,5,0,65
c9f157e40d49a2f9a6986a0101ffc33d56631f9c,0,70,6,0,76
28025a4d128ae7ac4593b0b2cdbbc4a0d3e9c1b2,6,1071,696,45,1818
edeab74625dd554b7909548ddc3e3609d3388779,6,127,34,0,167
91ce597f8c9d867ebe8472b1255e65cb4c068e1a,5,116,32,0,153
e494e4d65c154c54acb6d2d3af499225be2bb2cc,4,380,178,13,575
aec9fd990f2cae6375f668e12e90df6b6254eb9f,148,168,113,1679,2108
9a098c699d7ca095d1c8395925ea0395878617eb,150,162,107,1629,2048
37a7e3d6d77c6a6c5642c9b346d4e2cd57c3f5e6,3,296,154,13,466
7c6bc9fb7c992c0426eac960ea5c32cc420b046c,5,71,48,0,124
5d5770253d326274a8f72b531d58c5f6755e4dda,4,71,50,0,125
13bcc8808c2f23e92e18b7843dec68ab6bf69dc9,6,842,507,33,1388
5b8509436a60728d00b3344f3986fd8ea8a02cc0,2,95,10,0,107
e531db939725722358235a0edbb424b004c674ff,150,183,127,1684,2144
2284fd9f7e9573894055eb2c367b6bb09380bd98,147,152,99,1480,1878
76bb7462f3c33507c39d5e94f4e350c789ff0a3d,6,117,30,0,153
1fce91f62c57fd127039bc06faa308aa81d93c67,5,735,387,28,1155
48a97d6ac445045a8058541e5f9503298cfc93a9,7,653,298,27,985
16f1a29f180beebd27dfb119c62e7212add047d4,5,116,33,0,154
31e3c38eb3d4e4533478801856a5d2063793d01b,3,369,199,13,584
5c38eb1e59ccdb3763f4cfdc0946a84e2a59c3de,5,72,43,0,120
b19d110de6ad2fa68bd407d7bab776af91f33aa1,6,123,34,0,163
0e28a9073388598d94a2fa11fdda0bb14c8897c8,5,359,179,11,554
ca9869bb0a880e74eadaec836abe5afbc1887583,5,798,465,32,1300
adb014678c6591fd7bb457b334b2bbf1b7d14229,4,522,223,27,776
dc94e59a333fc591bfa9b0c3a823c58b1048bfad,177,264,157,1996,2594
38d26fc14e8876c015d051ceb48b156698031815,6,409,211,13,639
69e3a258b9c9b324e08ff5d1c6009bab2813c9a4,2,96,12,0,110
ac6737c16d78f2f2fa8c56720a960956d5b1e631,3,350,168,13,534
b09529481c7d444b004569356b2fbd6ae273d5f2,4,591,257,28,880
2800ca15a6f2bf7ad31138ff21c032fc8e02c7a0,6,439,191,20,656
539335c6f9f847b9c79a21176776dea72935b88d,5,66,40,0,111
a3e3ff1762e18b4500f23986c2339da4ad634559,5,353,181,11,550
3a25f071238e32c90bfea579b0b30cabfa8aa1cd,153,230,141,1941,2465
82171182f66cda16ddaddbe466685577732cbd95,3,368,196,13,580
eaf6771a4016baf3f5bfee6f7bf983cb80339051,6,121,33,0,160
30b30eb24fd0c6922af8beb4d0297410fb5fd2fc,5,682,349,26,1062
35d21e56e0b305ae590a99fd8aecc7cbea472d2c,4,511,234,26,775
b07fa6ad824c5a45d85a9790bff57ac5a736c8f4,7,673,306,26,1012
b7607b60b3b2793e5116077969cd9bec136d1037,5,653,315,26,999
40bcb00959d775a7f63dbeabdde67973596491aa,8,326,168,11,513
273fcdb6a73cf221a7a1d00aa33a3ed780947db5,5,63,33,0,101
6cc56d1677d49e920e9bd9368289b14cbb754701,5,116,32,0,153
9ce2d6680f799a1b2dc2ca27cfa78262f23f455a,5,653,315,26,999
cdf0e3ef6eaf9594c6ef758a86241d671b38068f,4,474,211,18,707
7b985004be8f0cf0d1953f53c518767fbe313718,4,130,69,3,206
a898845a5afa32d00f7c5a717869fb3a50e562da,6,121,34,0,161
908318c0157dc654c70b7d74efd2124d3300319e,5,511,234,26,776
3c8e7ad5f4e1e198498bc91e391a851727638495,4,591,256,28,879
c5a6955271d7d0f314111574dcee9fc85bd4ec63,3,397,152,15,567
7b64497f9db977dc4f78b07eb4d7b00f2c2d323e,149,184,127,1723,2183
526c7fb791aeaf037c4d1add5351cd4d995fd736,6,401,195,13,615
7daf5107f32a84df5385f78ae2f0cd249f1ddfdc,177,264,157,1996,2594
902103bd2233694010523415d1567ca4505cdb58,150,190,129,1722,2191
0e8a6cbcf55d3ca78bb77495e38dfbeacad8f20a,4,101,23,0,128
edae5aa3cc723eb1d5da294c004f0bc6f301e309,147,152,99,1480,1878
ec689ae8c8e03e0014fb97dcca4d9646733aae18,3,412,164,18,597
26e37900409e437bfd0fe0436c87563cf5b102b9,3,338,161,13,515
3a865b32ad4439eed867a041d4dc06fb3759052a,6,645,306,27,984
a041d979982309c50f2687eeb240cc66975fe14c,5,672,334,26,1037
df4bf33252b496978afa125a6a4c525702085f8c,4,100,21,0,125
b9c478bb8baa2fe6cf5fb23cd012dea0cfc222a0,139,150,96,1531,1916
7db235c31c7744bc164733ebb16948ad4856fe83,5,647,308,27,987
58e6e23d47e45bc8793a772abb8089ce4f50989d,6,439,194,20,659
fedcd8b705a8193aa1c25cc2840c42c2be5a85da,3,378,180,13,574
0dfd3e9b83c4ddfcac35311b92d6b803dfe6138f,3,360,161,13,537
6e73e9359b2dd6992d5d0e6b53b107eba35cffbd,5,640,309,26,980
3520cdf49015046194267d55de0c1cd82c5a236d,4,381,209,13,607
ddb100a55841e0b65d72a9e781f8a4b822bfc73f,7,358,187,11,563
fe78bec0e3d4c61ba23f7b24e2ad6f9171ffaf72,162,197,136,1895,2390
9db4bcca57ab1493b5cdde8f8bd1dd96ab719add,8,314,164,11,497
3169d9d22da6cc989173e262080eb1d46a6d3e01,3,392,187,15,597
f01cbdfd4bb252648c7fd1f0723969836c106443,3,411,174,15,603
a89054049479b7633c2b10ce05d58bb751f5ec27,149,184,127,1723,2183
dd1961a30c2b524a082d2cf38c1b027208e4fb84,5,106,54,2,167
1316b5bfd84de4df47cd0f29d3c61ac2482e4607,3,385,183,13,584
6cb7bf171b043865eba6a2f618e8faf82f9b6383,177,264,157,1996,2594
2645d35f3ef6aaba305685faa80701898c1f2079,5,768,435,29,1237
b5ddad62b6b025b0f9c21738265e5585d44c5e06,165,258,146,1986,2555
dc4ac252c523968b0ac64432881fd6e56d83fcd4,5,513,234,26,778
c055ceac1db45dac5f9b8b6c35f92232d1184e78,3,401,168,15,587
c4d36b1cba206dd1fe9fdd9928c100172a65b7a6,6,843,485,33,1367
a621820685a68d51d822aed14786936fa7ce5cf6,4,101,20,0,125
7102544b157257c74717bc4ae8f501d315b6a184,4,511,234,26,775
cf319e699349a35d86bc393702126964263bd6fe,8,327,172,11,518
29c309bf63acad8f852ac8c78d60006c957041ae,3,391,188,13,595
e1da890106ca086875f4df6310628ac5a0726c78,3,391,185,13,592
f417f809894993928d55fc1bf22da2dbde8ff0e5,150,162,107,1629,2048
38ba37290e6928044458df963eb6c1a2aee12dbc,143,153,96,1528,1920
e6aeea05292865ccdb63b9ba4c0c0e65850483bf,8,320,167,11,506
0b8c9a2ea8a5de472d08da860a9fa132bce43a04,5,119,61,2,187
0e8162aa55a6f258829ffc29b7d01c2f510ed0a0,183,273,166,2051,2673
c058f14f6fae7d8e98c790a05826345604e055cd,3,383,182,13,581
37812f35df4d9a3795f661496a96e634d8268eda,5,127,35,0,167
c61106368c54fe9fd23a127feb24e577de161167,6,117,30,0,153
14cab1c7e9d148786d8d43130666ba1201e43f9e,4,570,247,27,848
8b0c1723ef5d38cf4e2e7a5a1c12fc52d2f13d6a,153,230,141,1941,2465
661e2207eb9b35eaeb00d9dbad031d99880e127f,183,273,166,2051,2673
c8a19afe047d9a2bad21e69fcef893d3aeee63c2,5,745,410,28,1188
0c9c2865e22fa3f5cf95eeb30a7f0e7aca8cade4,157,211,135,1891,2394
8b6a2c2cf3bd5f2058c943a669060d21d3e6f5db,0,0,0,0,0
fba1d630276cfda617dd349d21c18edb8cb67dd9,5,127,34,0,166
70be84f5bfc0d310bb2ba8bbd1c1dd01c6c27d9c,3,392,187,15,597
fee8ff8a9ddd2aa0bd8ec879316f35c39fe79a55,148,168,112,1681,2109
7456ecf859e1d4b30b8f47d7d894432fd08d6ec4,3,340,161,13,517
e7cf42b9c7d735496ce614322b4575b533cd7060,188,279,178,2191,2836
ca8568633e3423a122d85c1765803f4d8abeb975,177,264,157,1996,2594
41944a4765925263048b15166f42c999880fc2fc,4,386,181,13,584
4cb5a476a4bc7561d8236e26a90b523ad1532768,3,121,25,0,149
0bf32bbb1b8f67ef96d0db3d8c4bf50f3c85e917,4,747,418,28,1197
82dad1219f81196d155a1a396eb4bb283f119f8e,5,690,358,26,1079
28256e2ec0d44fc5d5199acec4be5966454e122a,5,660,333,26,1024
6bb5114e7c93cf31c9faaf9ae389c8d29f7fd65c,6,104,53,2,165
752b261644df9df2fed28b463b3b73c322acd443,3,400,166,15,584
b582d1a2d53701c07144ae6c031aade513b6046b,3,301,150,13,467
8d060bf1a211de063ab0b83e59f02c0bb6373292,6,121,33,0,160
244ecd93b31aebf954d86cc57203dacbed4e97c5,0,0,0,0,0
c8b84c298b8c062342f8022d4652eb6b15809c26,5,671,339,26,1041
ba95d4fa5a9a4989f8ecee6f65942a3424609c82,166,261,149,2003,2579
edf73669a328dace348118143f8d90f16e986a7c,154,248,141,1959,2502
8e1f3b6e85a9aa455964c699aa8025266df0d952,8,970,614,43,1635
a4741c9fb0356c734afeecb763b0a4c5cabeccd9,4,489,209,27,729
e1ea7ed088c597c12b994b868e58ac4c2d603d9c,4,101,19,0,124
a0bc39d9c8ec44d0cc7ee8af8904870fcc95aabf,7,1234,799,56,2096
16c6fee8bbc243d2669e055664f51e6ef24119fb,3,368,199,13,583
21e41175362cae9b8df32f605a11b7ca8279515a,4,103,22,0,129
b65aa352485adcd0253a7c318ca028e43a91dce1,6,115,30,0,151
b3f46b75f549639198ffe5c58a5682b3d322a87b,3,377,177,13,570
f9c431bacbfd4d3bdd913031370dd413a36d1e0d,182,269,166,2040,2657
2f9d459c48f8840228868f22a695275f2ede81b0,4,74,49,0,127
eb5df0dfabd0cce8be63bd74cca6a83cbe3c239d,4,496,213,27,740
765c1c5d89c704f1c4fa876c1b6442182da7adbb,3,406,173,15,597
45b68094cab195ca0c338c8a75feb0684bf72fcd,161,211,136,1935,2443
e4fc4639357ad083cdb1c2742288a4bdcd30476d,8,314,165,11,498
513a4b205ae25d6449025d2934f8f5666395a56c,4,497,220,27,748
ac75111b29e62e62312aa83fd580627b1b106514,0,0,0,0,0
0781d718fcffc7bef7f2224da2ea5f07ee8dfb2a,145,150,99,1459,1853
1d425e8fa7c5e509836c42183df37881fa5f47f1,142,150,96,1536,1924
47273156f82cb257fa86a886b662c579ed251634,6,389,205,13,613
2bcee07ab0331be023d1cfc48f5b4627f6e6d933,170,274,155,1991,2590
d73a1fb56a28e2d166f38a3804273b6c8b536ea9,4,590,260,27,881
42ce320c053c90fc44998a2b2c703e7c3075eb34,4,538,224,27,793
029a2e7fd6aa1f00edcab4ba47b7ab15fb5d6af3,4,133,79,3,219
ae19bb0b675f5457c6c659d152127a3c5e1d3b56,5,479,206,21,711
2060e05a33f21b9f5ce0a63e3d32111e6839bd6f,0,71,7,0,78
fb49c2bfb74475b99f2370d80ca29699ba78d9cf,4,548,228,27,807
1531abf7028ee58a04f2ad8d1daab7cc4eb90de2,4,388,186,13,591
97e257c2f07546d44513e7b58b13e7e8f4135dc1,6,842,527,33,1408
720e21666f260b13fafd37dd55c575a17a1694fb,5,117,35,0,157
0bb1af57eabfe873cac1d74ead4a7cfe3a722490,4,496,212,27,739
eb74fba67b140dffaa90ec63954b1589b241ecb6,5,127,36,0,168
3b0abb9550162679bb934e9f45e6bcf57c149cb7,0,42,5,0,47
dfec1d00762a468076907fbb20806d07e1537a46,4,64,37,0,105
e4bf5498b261611c58580d7324ce5df9dd1400ed,6,120,30,0,156
ee231ab599e5a273bf67c9698f670238190105f0,3,392,187,13,595
bd97f2ccb0d8dde384d7705e18aae1ff2826a278,5,127,34,0,166
85fd5809a31b0c478b4de0d12bea58032f11fcd7,8,1267,822,57,2154
02d88b24b5807817901b80f1d083bd0b9c81ede6,4,512,232,26,774
9a670fb30aae8a4be65bb063d381d76bb5aaa9ec,3,102,24,0,129
4b89ddf073004f3814ada771893d7f3944b1e549,5,519,228,26,778
7588a5bf35907a9a5aba74e67e87ca2749f5c940,4,494,209,27,734
d0a4a8738798459c767ea20dc12b94ce38f6810f,5,664,341,26,1036
1646c50ddafac4d9d146b0ba7289177d55495a08,5,664,343,26,1038
b7dd836ad01c3fa315fe95f48496d874b4337939,4,121,30,0,155
4b89ff202f8ccd7f632fa83ac1cdada7a03fd845,5,794,468,32,1299
594e34e8e8f6989b4074effe5daf59ebc5cc9245,5,116,33,0,154
edc28c75273b5c01d961fba22ae3ef9c45091225,3,344,154,13,514
dab7d1e8608f51e84cca665da8173eb0afdb51b9,3,407,174,15,599
8627b033292f855fa3b5c59ad0687eeb95636955,4,100,21,0,125
24eb2875d9e62a7132acfa54a8d62351ef48bc22,7,934,592,43,1576
c18d8c5313a8d26cc09544f1e3f69b58c7539057,147,159,105,1608,2019
ecf879fe15c2e9eaf632aeaed33a3a9b3288bb57,5,121,31,0,157
bc08923c640e0ead73abb625889ae83e28f1556b,6,121,33,0,160
eedf1eb35e1d48f10dd153fcfea9a22b2f391965,187,279,178,2188,2832
e7d31880dcb3a9549561e147854d47650d9f0713,4,590,265,27,886
43d5068ae2491b7e4ebac60d526c0ee042a36a5b,0,0,0,0,0
4298e77c7edab4281a7da1113220c2435ca57b89,9,1298,865,57,2229
a14115077bcafde53410fa0bcd668116bd53809f,177,266,153,1996,2592
acc176223a598f1e214d795072d0e8eb2f6b97b4,6,840,500,33,1379
8c47320a36a0cbc1b3c824a59bb42d38fae558a2,0,70,7,0,77
8871538d87218b7f1f9cfe18bb753af26bfd81d6,4,85,47,0,136
5c574c519c1291734fde13bd0d1f9578919df4c1,4,101,19,0,124
e401715ecd11a73e56aa04d3d966e1b5e54b5c63,160,197,134,1882,2373
a36af0ab35bfd0a6252570b6b1b220312bef05b4,6,104,53,2,165
9c510594bbe89d2b699ec6390a96ef1b300dd4c4,7,344,179,11,541
c466bfd1636421f1d6953b5efe273fbd5b34af47,6,122,31,0,159
1c5147b8c854df4d1a60b6764d042ff6aae380dd,177,266,153,1996,2592
38c43d1a416155cbef69d07a0a653a8fe1ddbfea,3,400,168,15,586
73ae50987b1602d6876dc9837aef830b5a291f94,0,42,5,0,47
66b5fd042522fc58fded09d549b6b12d61ee1cf9,8,1243,789,57,2097
34fed69b3947c30eb25fa419af61e93515347131,4,380,178,13,575
bf590ae0caa4eaec181e77d817f776d92bff4c07,5,465,200,21,691
f8acd7d3a4795fa1e6015897b0fa9ba89aff5146,5,116,32,0,153
0d3cd468155493715efc5118ddfafcdc0b89ae23,4,69,50,0,123
1d7749126571d1c0bcec3a4cc2c4d40a95b49a93,3,390,155,15,563
43f3526ae8675db4c0e2a1ef4d080f525e291d7a,182,273,166,2040,2661
23012efa64ecce6fdeddab9321213eeae7b85e32,4,70,45,0,119
72baa183c599a7aafeec339f34219e4625af485b,5,109,59,2,175
d93370c0ef3598aae3323648f6d310fe282681b9,4,511,234,26,775
c6787dd922341ae49229313988406251128f6cb4,4,378,176,13,571
52d094436d1ff8cb3031924e2b2cf39b993d2e4c,150,174,126,1710,2160
7c701f687f37497aa7f0c99d7c4912afabc0deea,155,150,96,1548,1949
51bac455be9e835f7401b5ec6c1b311578c6b54e,5,637,310,26,978
68aa6d8157f1b531adfe33badbc17c54b47c53d5,6,434,180,18,638
ccf3cd2a7d66a2f0a0777ecde7fcf34df2aaaed2,4,591,258,30,883
9e743087f6c81e5b5512a4c7a0f700b533e05e02,5,127,35,0,167
2537689dfef15fcecf85d7edad0398003fb33619,3,300,152,13,468
530885ac0fbb260397d269c5442749f2ac4620b5,5,785,452,30,1272
da1aeeebcb2a0240471955787c7a82315621e67d,3,121,24,0,148
444307592dbbe0b03659ca35facda5bf9360ddf3,6,125,35,0,166
c0e42064576a6c8266c6ce0f6a40cb3306206738,3,396,165,15,579
c6ff0338cda50c6b275fca3efae56740affc80d0,202,290,181,2268,2941
e6eecd2f753845985c950a346f45ccf07d55b413,4,71,47,0,122
0733a537f6436cb899a66bd820445c80290bd317,147,159,105,1608,2019
bba21ad66d4408a954ae31928417db1ea6665b16,6,439,192,20,657
7c856dcd3e3cf384e141a58b14d6f3cb6058a0d0,6,121,33,0,160
30f8b27bd7032e3dd638115987caad0f651fe65e,6,435,179,18,638
953054a80a4b5ca1905bdec7aa2b17cfefc61e40,201,284,180,2258,2923
9f164d8c974775a882f8a787fd9f507e008bd5f9,5,84,47,0,136
a993c30a099b6f70eb54876f676287d6736b37a9,6,436,187,18,647
aa67491aa11826cdd689a14355400588702df71a,5,729,395,28,1157
805c7ad99f5dc738a1e18b47f2e142502dcb37e0,6,117,30,0,153
a814c3a581643f8e60d9b98949863e11634da3ee,150,144,98,1227,1619
9a08f15649772b1a1aa9bcaeceab962236489f15,5,511,234,26,776
e3ba9df81347c7264873e557573e868ed2affa7a,3,321,158,13,495
572728b90b7c04b380665dee24a251cc27eae1af,7,1030,662,44,1743
7be36544a60c1894d2773f25bf0de27dcdaf7ab9,3,121,26,0,150
7879c9b9712ff8cfb8abef2c260c65085d73b8ea,4,71,46,0,121
f95ce28dac04001ac0d18d79c4ba241653cb6900,144,153,99,1542,1938
b6a73feffa4c7d004baacc800f05aa4e9db32bbd,0,70,6,0,76
254fff66ffc16ebed7e82bd1f4af602840879c39,5,127,35,0,167
9ac76ff218e0df7c9790a7d4c2ff18b1174e8cb5,5,119,60,2,186
edffc05881cef509a636497fcf3e47ce02f8544e,183,273,166,2045,2667
486ea1cc447f8a4a8bb35de4caca9b689758d8c3,5,71,43,0,119
bad906faa9aa7d0d63906e5e8b88d3c3b79a5a85,155,150,96,1547,1948
e7fc0d9965cd508907d0723bdca01c6eb179c079,4,447,202,17,670
b40621f07f8d70d3916b3469d7d3729cd96528a3,3,366,177,13,559
f5838f2f878798ddcbb327676b5135ca2eb7d1c7,5,127,35,0,167
adc6dde6585d67fcb474643bf154d2c633049396,5,127,36,0,168
51c04b049f0e51d345693b70d4a49659ae751efa,3,121,26,0,150
3fb735109142c80adf6e37ddbe6874f9e05438fd,5,124,63,2,194
7c5b101e13fe591e74c090dacbc5e55f1ebd72de,5,791,460,32,1288
c8d13632398ce5bcbe04f9a8ae4e757a326d251a,5,428,173,18,624
96a58ecd30205b4e417b91ab02124245d281ba3d,3,302,148,13,466
eb13763f46645d945a83f8b5ac8d7f9b95a85f1c,146,164,123,1694,2127
0e8db80ed55ed592f4ab5cacdf5a3a83ecd517c3,148,168,112,1681,2109
bc2c9e9257b7afe96de5b5fd73e15cc0a74a73d3,4,585,257,27,873
6746d67c989f836cdf8c109cedc3e806279e89dd,3,400,154,15,572
21ed26428d23fb5da19b78dd5cfd4fddc4539eff,3,402,174,15,594
a7669bcfbac14f013b7d4ca368cc5503de30ccc1,0,0,0,0,0
72576f5ce834a636526a4f3f38b807579a65e93e,3,121,25,0,149
ad97147b6b487f70cc2186b3dce0bb2ec42c8320,34,279,169,243,725
330e8e7683e1dcad123beaa6bf83c4c23235ba63,7,650,296,26,979
9c7dfc5d4dd14eda823b1b2b8bb8cd433c723f71,0,42,5,0,47
cdf4b5a5bb1e12de6ea23ba2fa6339a0d99f64e3,3,367,188,13,571
ef7a4c2c84672c6aa00ddc680b4b148501e266be,147,150,100,1481,1878
66a3e14e09dbc86124d2491168f851ea590c80cc,3,383,182,13,581
d0d4c2682864794cba6a4ba43cc4671c3136327f,5,118,31,0,154
ebe8d743725381aa39828a95a26d784a31552ad6,155,190,129,1771,2245
d2b7042275815d365f4d872871705bab9ea82772,4,386,181,13,584
229dd058fc89ca6bded448cb6067c6afc8e64aca,177,264,157,1996,2594
2183f4cc63fbd05420d4645f66fb0ea50c2dacea,5,361,174,11,551
55ee9c9d1c37172bb1429f80570132c58bd9cfcd,5,674,336,26,1041
80f1ea8ffc6055f5c869c78f2277572f0df45bb7,7,330,175,11,523
74728fbb811912a917811be8cd2d0ebb727aa852,192,279,178,2194,2843
1f516affda6ff5ba91d6590262163b310971067d,4,386,204,14,608
b3931683f3bad2064a2018284cd1ec07ed988d35,5,116,32,0,153
69344462385fe5b01d0295b6b9f28ec8568aea96,148,165,111,1660,2084
3bee6e603e4201549a35191d4715fed90e952730,4,101,23,0,128
9c9feba9a669e6a1a0166ea17ea67597942419af,2,96,12,0,110
6de20ba1ba1f7c7ae9638153efec352ef86322cd,144,153,98,1537,1932
3fa55515cbb817b21c48b4430fd7e99464c728c7,3,121,26,0,150
1e2f743bb732b0122dd92000d6a145329395a657,7,1238,805,56,2106
41c41d525aaeb61ad8cac39129b1ccee384cbe3d,5,124,63,2,194
811a95e8dc6c9e777e8e22fafd3068eb297be77e,5,127,35,0,167
c6ee15ef0eb47cd352c237112af211b8cedb4f55,0,68,6,0,74
3690d312f73773f885794ee4e3e8e7a721aa42cc,3,360,173,13,549
f005b9f3b7b655a6f15f555794c3d53d2731a0b1,4,585,257,27,873
5f451888cf4b9a607185cecd642ace8337df8082,0,42,5,0,47
5bdb35f2d6a85a6dc123cb0a8839b5729e6fae30,5,768,435,29,1237
53971d4021fffc2f55292fb111a49bd295e2d8e4,153,190,129,1769,2241
f0a45113662632db0efabbf42ee85fdb936a54bc,6,122,32,0,160
cb90e237f502340c100ffe42000721a0de7b77e0,4,371,176,13,564
be760ccf42d690ad12ce278007c4202198cce4a6,144,137,88,1190,1559
ae528d01fde6bdbf968bdeecc3848907aea226ea,4,387,181,13,585
66cd9460d1139c8bc00d6554290b1b69e096ba2c,4,130,62,3,199
0b1d954126786283065b7b22dec4f58cf89a83ca,6,431,184,18,639
a3b70eac07bd8e21fe41bee594a05b59edaf4f5e,6,410,212,13,641
9dfff7ec9774aeca64a8e5f86f8c1372d1a851ff,3,390,170,15,578
f5483ea435caf30a4d008dd12a660e603796e705,3,401,168,15,587
9b0fb541211f25449850f52cf301568b2d2b9247,161,214,136,1940,2451
e7c283e2247e027322e12e1f9874a3a20c56c095,149,184,127,1724,2184
304612a650fc749aabdf42e3b3400fe653b5b6bc,170,273,153,1983,2579
a35d1a64bf2b6559070f99a8584f6e19e2b1d196,5,69,42,0,116
d08fb037c7866da1d83160414ed42d09c680a66a,10,1302,866,57,2235
4e7fc47089d449ab0bf8be2e8da556338d828a93,0,42,5,0,47
16eacb277ebaca85eea315c6c9ce55168558f074,6,405,217,13,641
659c11e37b3fbcd2b1515b7c4239711bbb82e0f8,8,1254,799,57,2118
e4eb016dc842a538b0ef733087273cd2ab1c44ab,4,374,174,13,565
b16c7a6e8f8cd155da78d500f2ea29a7bcce6b8a,183,273,166,2051,2673
ee30ea79007ff1260ca0e66f594ca5a87d48c8d6,4,522,236,26,788
fdeddf6b8370392d2433347565cfc101b4b9dfb5,5,71,43,0,119
2c775be06f330079dba84fe2fb467c76312c16ea,4,771,437,30,1242
85b8210697898f1c1ab2edb0d849c94b71fa052a,5,127,35,0,167
eafb308b1698bd83aaf42b612ddcfaa20ce6e125,5,638,314,26,983
a4e0da748fb91507895619c98df0dace2df86af5,3,404,174,15,596
1252cf2af5b66f757a2942dc559cac21b5d108ad,7,653,300,26,986
82485180907889e3a0e64fb4de57d9e5f94a8c85,177,264,157,1996,2594
edb5dae7edb2ac0e13c5971bffcebf64c991b0c7,4,771,445,30,1250
222f4161bcb5807386f08f1a05e812d046a2dbfc,5,795,469,32,1301
d7560917035d9fee288ce25c84892f65e2406cb8,5,120,61,2,188
9330d60417c071029fcedc50476882b400e78f53,4,512,234,26,776
857da116570daf586d95452aea98aaab7ec0ad79,0,0,0,0,0
b99dd3c169019113e08b707d1d6bd0c1147d5972,4,385,208,13,610
1f1c7b3b940020cad09fa223f31ff1d9dcc67586,6,842,527,33,1408
3159b4bbeb4a8b4d510f9bf1876085bb6ecf3f30,5,668,338,26,1037
b39820ff29b833d9bdb4c3641012d59e7fbacc46,6,117,30,0,153
85e1ff9c339443de48d5fdaff396bff83929a7b5,4,591,258,30,883
6e144f9e81b350eff6e1cb0eed96c7eaeefd2561,144,137,88,1190,1559
f6dadc6e9cc1ce5a59ed0601963611124f587e16,150,190,129,1722,2191
9434d1b81ad7d3a2ab9b54653dfba46c107ad2a5,151,220,143,1936,2450
0199170782a9878c9bfaa682ee8269a22bd1c512,3,367,184,13,567
424ffde02c37742a5a532fa3ef67a3fa1328fab1,4,74,47,0,125
9664d28516852277927ae6939d71c47b16d1bd23,3,400,168,15,586
6ecdcf2ca66f8be66a084bacff0a2db9bb3c7f88,188,279,178,2191,2836
baaca13b06700bdf64ad5dce6c9b4786577cd1cc,5,119,61,2,187
20b25e454a957c5a57a59997e64026fab8cd91a0,151,220,143,1936,2450
ecbed17752f50d8fd401cca39bf525c4e03a44d5,6,1179,766,51,2002
c23cccc41d69c94db89048257125e6cd58a8d71c,5,121,31,0,157
bdb9d1939479da96f03bbee9819577b1a3ed3f9a,8,1298,862,57,2225
