Class,Assertion roulette,Conditional test logic,Constructor initialization,Eager test,Empty test,Exception handling,Ignored tests,Unknown test,Total
mpetazzoni_ttorrent.com.turn.ttorrent.client.strategy.RequestStrategy,0,0,0,0,0,0,0,0,0
mpetazzoni_ttorrent.com.turn.ttorrent.client.storage.FileCollectionStorage,0,0,0,0,0,0,0,0,0
mpetazzoni_ttorrent.com.turn.ttorrent.client.storage.PieceStorage,2,0,0,2,0,0,0,0,4
mpetazzoni_ttorrent.com.turn.ttorrent.client.announce.TrackerClient,0,0,0,0,0,0,0,1,1
mpetazzoni_ttorrent.com.turn.ttorrent.common.TorrentUtils,0,0,0,0,0,0,0,0,0
mpetazzoni_ttorrent.com.turn.ttorrent.common.protocol.http.HTTPAnnounceResponseMessage,1,0,0,1,0,0,0,0,2
mpetazzoni_ttorrent.com.turn.ttorrent.common.protocol.udp.UDPAnnounceResponseMessage,1,0,0,1,0,0,0,0,2
mpetazzoni_ttorrent.com.turn.ttorrent.network.ConnectionManager,1,0,0,1,0,0,0,0,2
andrewgaul_s3proxy.org.gaul.s3proxy.GlobBlobStoreLocator,4,0,0,0,0,0,0,0,4
andrewgaul_s3proxy.org.gaul.s3proxy.CrossOriginResourceSharing,9,0,0,0,0,0,0,0,9
andrewgaul_s3proxy.org.gaul.s3proxy.S3Proxy,1,0,0,0,0,1,0,0,2
andrewgaul_s3proxy.org.gaul.s3proxy.AliasBlobStore,1,0,0,0,0,1,0,0,2
andrewgaul_s3proxy.org.gaul.s3proxy.junit.S3ProxyRule,1,0,0,1,0,0,0,0,2
andrewgaul_s3proxy.org.gaul.s3proxy.junit.S3ProxyExtension,1,0,0,1,0,0,0,0,2
apache_storm.org.apache.storm.daemon.drpc.DRPCServer,4,0,0,4,0,1,0,0,9
apache_storm.org.apache.storm.daemon.drpc.DRPC,3,0,0,3,0,2,0,3,11
apache_storm.org.apache.storm.daemon.logviewer.utils.LogCleaner,3,0,0,3,0,0,0,0,6
apache_storm.org.apache.storm.daemon.logviewer.utils.ResourceAuthorizer,1,0,0,1,0,0,0,0,2
apache_storm.org.apache.storm.utils.Utils,9,2,0,7,0,0,0,6,24
apache_storm.org.apache.storm.daemon.logviewer.utils.WorkerLogs,0,0,0,0,0,0,0,0,0
apache_storm.org.apache.storm.daemon.logviewer.handler.LogviewerLogPageHandler,0,0,0,0,0,0,0,2,2
apache_storm.org.apache.storm.daemon.logviewer.handler.LogviewerProfileHandler,2,0,0,2,0,0,0,0,4
apache_storm.org.apache.storm.daemon.logviewer.handler.LogviewerLogDownloadHandler,2,0,0,2,0,0,0,0,4
apache_storm.org.apache.storm.daemon.ui.UIHelpers,7,0,0,4,0,0,0,0,11
apache_storm.org.apache.storm.starter.bolt.RollingCountBolt,1,0,0,0,0,0,0,3,4
apache_storm.org.apache.storm.starter.bolt.AbstractRankerBolt,2,0,0,0,0,0,0,6,8
apache_storm.org.apache.storm.starter.tools.RankableObjectWithFields,1,0,0,1,0,0,0,0,2
apache_storm.org.apache.storm.starter.tools.SlotBasedCounter,3,0,0,1,0,0,0,0,4
apache_storm.org.apache.storm.starter.tools.Rankings,0,0,0,0,0,0,0,0,0
apache_storm.org.apache.storm.starter.tools.SlidingWindowCounter,0,0,0,0,0,0,0,0,0
apache_storm.org.apache.storm.hdfs.bolt.AbstractHdfsBolt,2,0,0,2,0,0,0,0,4
apache_storm.org.apache.storm.tuple.ITuple,1,0,0,1,0,0,0,0,2
apache_storm.org.apache.storm.hdfs.bolt.HdfsBolt,0,0,0,0,0,0,0,1,1
apache_storm.org.apache.storm.validation.ConfigValidation,1,0,0,0,0,0,0,4,5
apache_storm.org.apache.storm.hdfs.spout.HdfsSpout,8,0,0,7,0,0,0,2,17
apache_storm.org.apache.storm.hdfs.spout.ProgressTracker,1,0,0,1,0,0,0,0,2
apache_storm.org.apache.storm.hdfs.spout.FileLock,5,0,0,5,0,0,0,0,10
apache_storm.org.apache.storm.hdfs.spout.DirLock,2,0,0,2,0,0,0,0,4
apache_storm.org.apache.storm.hdfs.trident.HdfsState,3,0,0,3,0,0,0,0,6
apache_storm.org.apache.storm.elasticsearch.common.EsTestUtil,1,0,0,0,0,0,0,1,2
apache_storm.org.apache.storm.elasticsearch.EsLookupResultOutput,0,0,0,0,0,0,0,0,0
apache_storm.org.apache.storm.elasticsearch.common.EsConfig,3,0,0,0,0,0,0,0,3
apache_storm.org.apache.storm.elasticsearch.trident.EsState,0,0,0,0,0,0,0,2,2
apache_storm.org.apache.storm.kafka.bolt.KafkaBolt,3,0,0,3,0,0,0,0,6
apache_storm.org.apache.storm.kafka.spout.SimpleRecordTranslator,1,0,0,0,0,0,0,0,1
apache_storm.org.apache.storm.kafka.spout.KafkaSpout,9,0,0,9,0,0,0,4,22
apache_storm.org.apache.storm.kafka.spout.KafkaSpoutRetryService,0,0,0,0,0,0,0,1,1
apache_storm.org.apache.storm.kafka.spout.ByTopicRecordTranslator,1,0,0,1,0,0,0,0,2
apache_storm.org.apache.storm.kafka.spout.KafkaSpoutConfig,1,0,0,1,0,0,0,2,4
apache_storm.org.apache.storm.kafka.spout.internal.CommonKafkaSpoutConfig,0,0,0,0,0,0,0,0,0
apache_storm.org.apache.storm.kafka.spout.KafkaSpoutRetryExponentialBackoff,8,0,0,8,0,0,0,0,16
apache_storm.org.apache.storm.utils.Time,9,0,0,4,0,0,0,4,17
apache_storm.org.apache.storm.kafka.spout.KafkaSpoutMessageId,1,0,0,0,0,0,0,0,1
apache_storm.org.apache.storm.kafka.spout.DefaultRecordTranslator,1,0,0,1,0,0,0,0,2
apache_storm.org.apache.storm.hive.bolt.mapper.DelimitedRecordHiveMapper,5,0,0,5,0,0,0,2,12
apache_storm.org.apache.storm.hive.bolt.mapper.JsonRecordHiveMapper,1,0,0,1,0,0,0,4,6
apache_storm.org.apache.storm.loadgen.NormalDistStats,0,0,0,0,0,0,0,1,1
apache_storm.org.apache.storm.loadgen.LoadCompConf,2,0,0,2,0,0,0,0,4
apache_storm.org.apache.storm.loadgen.LoadMetricsServer,0,0,0,0,0,0,0,0,0
apache_storm.org.apache.storm.loadgen.OutputStream,1,0,0,0,0,0,0,0,1
apache_storm.org.apache.storm.security.auth.ReqContext,5,0,0,2,0,0,0,0,7
apache_storm.org.apache.storm.blobstore.NimbusBlobStore,0,0,0,0,0,0,0,1,1
apache_storm.org.apache.storm.topology.InputDeclarer,1,1,0,0,0,1,0,0,3
apache_storm.org.apache.storm.cluster.PaceMakerStateStorage,2,0,0,2,0,0,0,0,4
apache_storm.org.apache.storm.generated.HBPulse,1,0,0,1,0,0,0,0,2
apache_storm.org.apache.storm.generated.HBMessageData,1,0,0,1,0,0,0,0,2
apache_storm.org.apache.storm.StormSubmitter,6,0,0,1,0,0,0,0,7
apache_storm.org.apache.storm.utils.ConfigUtils,14,0,0,10,0,0,0,0,24
apache_storm.org.apache.storm.Testing,2,0,0,2,0,0,0,4,8
apache_storm.org.apache.storm.utils.LocalState,3,0,0,3,0,0,0,0,6
apache_storm.org.apache.storm.pacemaker.Pacemaker,9,0,0,9,0,0,0,0,18
apache_storm.org.apache.storm.topology.TopologyBuilder,13,0,0,13,0,0,0,0,26
apache_storm.org.apache.storm.testing.FeederSpout,6,0,0,6,0,1,0,0,13
apache_storm.org.apache.storm.metrics2.RollingAverageGauge,1,0,0,1,0,0,0,0,2
apache_storm.org.apache.storm.assignments.LocalAssignmentsBackendFactory,2,0,0,2,0,0,0,0,4
apache_storm.org.apache.storm.windowing.WaterMarkEventGenerator,4,0,0,4,0,0,0,0,8
apache_storm.org.apache.storm.windowing.TriggerPolicy,9,0,0,0,0,0,0,0,9
apache_storm.org.apache.storm.windowing.WindowManager,2,0,0,2,0,0,0,0,4
apache_storm.org.apache.storm.windowing.Event,1,0,0,1,0,0,0,0,2
apache_storm.org.apache.storm.windowing.persistence.WindowState,1,0,0,0,0,0,0,0,1
apache_storm.org.apache.storm.topology.PersistentWindowedBoltExecutor,3,0,0,3,0,0,0,3,9
apache_storm.org.apache.storm.topology.WindowedBoltExecutor,1,0,0,1,0,2,0,1,5
apache_storm.org.apache.storm.windowing.persistence.SimpleWindowPartitionCache,7,0,0,3,0,0,0,1,11
apache_storm.org.apache.storm.topology.StatefulWindowedBoltExecutor,0,0,0,0,0,0,0,3,3
apache_storm.org.apache.storm.tuple.Tuple,0,0,0,0,0,0,0,6,6
apache_storm.org.apache.storm.metric.internal.LatencyStat,1,0,0,1,0,0,0,0,2
apache_storm.org.apache.storm.metric.internal.CountStat,1,0,0,1,0,0,0,0,2
apache_storm.org.apache.storm.metric.internal.RateTracker,1,0,0,1,0,0,0,0,2
apache_storm.org.apache.storm.metric.ClusterMetricsConsumerExecutor,2,0,0,0,0,0,0,0,2
apache_storm.org.apache.storm.bolt.JoinBolt,1,0,0,1,0,0,0,0,2
apache_storm.org.apache.storm.state.State,1,0,0,1,0,0,0,0,2
apache_storm.org.apache.storm.state.BaseStateIterator,0,0,0,0,0,0,0,0,0
apache_storm.org.apache.storm.state.Serializer,1,0,0,0,0,0,0,0,1
apache_storm.org.apache.storm.utils.DefaultShellLogHandler,0,0,0,0,0,0,0,4,4
apache_storm.org.apache.storm.utils.ShellBoltMessageQueue,3,0,0,2,0,0,0,0,5
apache_storm.org.apache.storm.utils.JCQueue,2,2,0,2,0,0,0,0,6
apache_storm.org.apache.storm.utils.CuratorUtils,1,0,0,1,0,0,0,0,2
apache_storm.org.apache.storm.utils.ShellUtils,0,0,0,0,0,0,0,0,0
apache_storm.org.apache.storm.utils.ThriftTopologyUtils,0,0,0,0,0,0,0,0,0
apache_storm.org.apache.storm.utils.SimpleVersion,6,0,0,6,0,0,0,0,12
apache_storm.org.apache.storm.Config,2,0,0,2,0,0,0,0,4
apache_storm.org.apache.storm.utils.ServerUtils,6,2,0,3,0,0,0,0,11
apache_storm.org.apache.storm.utils.EquivalenceUtils,3,0,0,2,0,0,0,0,5
apache_storm.org.apache.storm.utils.ZookeeperServerCnxnFactory,0,0,0,0,0,0,0,0,0
apache_storm.org.apache.storm.streams.StatefulProcessorBolt,1,0,0,0,0,0,0,0,1
apache_storm.org.apache.storm.streams.ProcessorBolt,3,0,0,1,0,0,0,0,4
apache_storm.org.apache.storm.streams.StreamBuilder,7,0,0,7,0,0,0,0,14
apache_storm.org.apache.storm.streams.Node,1,0,0,0,0,0,0,0,1
apache_storm.org.apache.storm.streams.WindowedProcessorBolt,1,0,0,1,0,0,0,0,2
apache_storm.org.apache.storm.scheduler.Cluster,1,1,0,1,0,0,0,0,3
apache_storm.org.apache.storm.spout.CheckpointSpout,7,0,0,7,0,0,0,0,14
apache_storm.org.apache.storm.security.auth.ClientAuthUtils,5,0,0,2,0,0,0,2,9
apache_storm.org.apache.storm.security.auth.AutoSSL,3,1,0,3,0,1,0,0,8
apache_storm.org.apache.storm.security.auth.ShellBasedGroupsMapping,1,0,0,1,0,0,0,0,2
apache_storm.org.apache.storm.security.auth.DefaultHttpCredentialsPlugin,1,0,0,1,0,0,0,0,2
apache_storm.org.apache.storm.security.auth.ServerAuthUtils,1,0,0,1,0,0,0,0,2
apache_storm.org.apache.storm.security.auth.KerberosPrincipalToLocal,1,0,0,1,0,0,0,0,2
apache_storm.org.apache.storm.security.auth.ThriftServer,2,0,0,1,0,0,0,0,3
apache_storm.org.apache.storm.security.auth.IAuthorizer,1,0,0,0,0,0,0,0,1
apache_storm.org.apache.storm.security.auth.authorizer.DRPCSimpleACLAuthorizer,1,0,0,0,0,0,0,0,1
apache_storm.org.apache.storm.generated.WorkerToken,2,0,0,2,0,0,0,0,4
apache_storm.org.apache.storm.generated.WorkerSummary,6,0,0,0,0,0,0,0,6
apache_storm.org.apache.storm.generated.ErrorInfo,2,0,0,2,0,0,0,0,4
apache_storm.org.apache.storm.cluster.IStormClusterState,1,0,0,1,0,0,0,0,2
apache_storm.org.apache.storm.daemon.metrics.ClientMetricsUtils,4,0,0,0,0,0,0,0,4
apache_storm.org.apache.storm.daemon.metrics.MetricsUtils,5,0,0,0,0,0,0,0,5
apache_storm.org.apache.storm.daemon.supervisor.Container,2,0,0,2,0,0,0,1,5
apache_storm.org.apache.storm.daemon.supervisor.Slot,9,0,0,8,0,0,0,0,17
apache_storm.org.apache.storm.generated.LocalAssignment,0,0,0,0,0,0,0,0,0
apache_storm.org.apache.storm.daemon.supervisor.BasicContainer,4,0,0,4,0,0,0,1,9
apache_storm.org.apache.storm.daemon.worker.LogConfigManager,2,0,0,2,0,0,0,2,6
apache_storm.org.apache.storm.generated.LogLevel,1,0,0,1,0,0,0,0,2
apache_storm.org.apache.storm.daemon.worker.BackPressureTracker,5,0,0,4,0,0,0,0,9
apache_storm.org.apache.storm.messaging.ConnectionWithStatus,1,0,0,1,0,0,0,0,2
apache_storm.org.apache.storm.tuple.Fields,7,0,0,0,0,0,0,0,7
apache_storm.org.apache.storm.executor.ExecutorTransfer,0,0,0,0,0,0,0,1,1
apache_storm.org.apache.storm.executor.error.ReportError,1,0,0,1,0,0,0,0,2
apache_storm.org.apache.storm.blobstore.ClientBlobStore,0,0,0,0,0,0,0,2,2
apache_storm.org.apache.storm.blobstore.BlobStore,0,0,0,0,0,0,0,2,2
apache_storm.org.apache.storm.blobstore.LocalFsBlobStoreSynchronizer,1,0,0,0,0,0,0,0,1
apache_storm.org.apache.storm.blobstore.BlobStoreUtils,1,0,0,1,0,0,0,6,8
apache_storm.org.apache.storm.blobstore.LocalFsBlobStore,0,0,0,0,0,0,0,1,1
apache_storm.org.apache.storm.serialization.SerializationFactory,0,0,0,0,0,0,0,0,0
apache_storm.org.apache.storm.serialization.GzipThriftSerializationDelegate,1,0,0,1,0,0,0,0,2
apache_storm.org.apache.storm.serialization.GzipBridgeThriftSerializationDelegate,1,0,0,1,0,0,0,0,2
apache_storm.org.apache.storm.serialization.ThriftSerializationDelegate,1,0,0,1,0,0,0,0,2
apache_storm.org.apache.storm.messaging.DeserializingConnectionCallback,2,0,0,2,0,0,0,0,4
apache_storm.org.apache.storm.grouping.ShuffleGrouping,1,0,0,1,0,0,0,0,2
apache_storm.org.apache.storm.grouping.CustomStreamGrouping,1,0,0,1,0,0,0,0,2
apache_storm.org.apache.storm.grouping.LoadAwareShuffleGrouping,2,0,0,2,0,0,0,0,4
apache_storm.org.apache.storm.daemon.GrouperFactory,1,0,0,1,0,0,0,0,2
apache_storm.org.apache.storm.dependency.DependencyUploader,2,0,0,2,0,0,0,0,4
apache_storm.org.apache.storm.dependency.DependencyPropertiesParser,2,0,0,0,0,0,0,0,2
apache_storm.org.apache.storm.trident.windowing.config.TumblingCountWindow,2,0,0,2,0,0,0,0,4
apache_storm.org.apache.storm.trident.windowing.InMemoryWindowsStore,1,0,0,1,0,0,0,0,2
apache_storm.org.apache.storm.generated.StormTopology,0,1,0,0,0,0,0,0,1
apache_storm.org.apache.storm.grouping.PartialKeyGrouping,3,0,0,3,0,0,0,0,6
apache_storm.org.apache.storm.submit.dependency.DependencyResolver,0,0,0,0,0,0,0,0,0
apache_storm.org.apache.storm.submit.dependency.AetherUtils,2,0,0,0,0,0,0,0,2
apache_storm.org.apache.storm.command.CLI,2,0,0,1,0,0,0,0,3
apache_storm.org.apache.storm.LocalCluster,2,0,0,1,0,0,0,0,3
apache_storm.org.apache.storm.Thrift,1,0,0,1,0,0,0,0,2
apache_storm.org.apache.storm.kafka.spout.internal.OffsetManager,5,0,0,5,0,0,0,0,10
apache_storm.org.apache.storm.kafka.spout.subscription.RoundRobinManualPartitioner,1,0,0,1,0,0,0,0,2
apache_storm.org.apache.storm.kafka.spout.subscription.NamedTopicFilter,0,0,0,0,0,0,0,0,0
apache_storm.org.apache.storm.kafka.spout.subscription.PatternTopicFilter,0,0,0,0,0,0,0,0,0
apache_storm.org.apache.storm.kafka.spout.trident.KafkaTridentSpoutBatchMetadata,3,0,0,3,0,0,0,0,6
apache_storm.org.apache.storm.kafka.spout.trident.KafkaTridentSpoutEmitter,6,0,0,6,0,0,0,2,14
apache_storm.org.apache.storm.kafka.spout.subscription.ManualPartitioner,0,0,0,0,0,0,0,0,0
apache_storm.org.apache.storm.kafka.spout.trident.KafkaTridentSpoutTopicPartition,0,0,0,0,0,0,0,1,1
apache_storm.org.apache.storm.kafka.spout.subscription.TopicFilter,1,0,0,1,0,0,0,0,2
apache_storm.org.apache.storm.hdfs.blobstore.HdfsBlobStoreImpl,1,1,0,1,0,0,0,0,3
apache_storm.org.apache.storm.jms.spout.JmsSpout,1,0,0,1,0,0,0,1,3
apache_storm.org.apache.storm.redis.state.RedisKeyValueStateProvider,1,0,0,1,0,0,0,0,2
apache_storm.org.apache.storm.redis.state.RedisKeyValueState,1,0,0,1,0,0,0,0,2
apache_storm.org.apache.storm.redis.common.adapter.RedisCommandsAdapterJedis,0,0,0,0,0,0,0,0,0
apache_storm.org.apache.storm.hdfs.bolt.format.SimpleFileNameFormat,2,0,0,2,0,0,0,0,4
apache_storm.org.apache.storm.hdfs.avro.AvroSchemaRegistry,0,0,0,0,0,0,0,0,0
apache_storm.org.apache.storm.hdfs.trident.format.SimpleFileNameFormat,2,0,0,2,0,0,0,0,4
apache_storm.org.apache.storm.jdbc.common.Util,1,0,0,0,0,0,0,0,1
apache_storm.org.apache.storm.jdbc.common.JdbcClient,1,0,0,1,0,0,0,0,2
apache_storm.org.apache.storm.rocketmq.DefaultMessageBodySerializer,1,0,0,0,0,0,0,0,1
apache_storm.org.apache.storm.rocketmq.bolt.RocketMqBolt,0,0,0,0,0,0,0,2,2
apache_storm.org.apache.storm.rocketmq.common.selector.DefaultTopicSelector,1,0,0,1,0,0,0,0,2
apache_storm.org.apache.storm.rocketmq.common.selector.FieldNameBasedTopicSelector,1,0,0,1,0,0,0,0,2
apache_storm.org.apache.storm.rocketmq.common.mapper.FieldNameBasedTupleToMessageMapper,1,0,0,1,0,0,0,0,2
apache_storm.org.apache.storm.rocketmq.spout.RocketMqSpout,0,0,0,0,0,0,0,2,2
apache_storm.org.apache.storm.rocketmq.spout.scheme.StringScheme,1,0,0,1,0,0,0,0,2
apache_storm.org.apache.storm.rocketmq.spout.scheme.StringKeyValueScheme,0,0,0,0,0,0,0,0,0
apache_storm.org.apache.storm.cassandra.trident.state.MapStateFactoryBuilder,0,0,0,0,0,0,0,3,3
apache_storm.org.apache.storm.container.oci.OciUtils,1,0,0,0,0,0,0,2,3
apache_storm.org.apache.storm.hbase.state.HBaseKeyValueStateProvider,1,0,0,0,0,0,0,0,1
apache_storm.org.apache.storm.hbase.state.HBaseKeyValueState,1,0,0,1,0,0,0,0,2
apache_storm.org.apache.storm.eventhubs.spout.MessageId,0,0,0,0,0,0,0,0,0
apache_storm.org.apache.storm.eventhubs.spout.EventHubSpoutConfig,0,0,0,0,0,0,0,0,0
apache_storm.org.apache.storm.eventhubs.trident.TransactionalTridentEventHubEmitter,1,0,0,0,0,0,0,0,1
apache_storm.org.apache.storm.metricstore.MetricStore,3,0,0,3,0,0,0,0,6
apache_storm.org.apache.storm.metricstore.rocksdb.RocksDbValue,2,0,0,2,0,0,0,0,4
apache_storm.org.apache.storm.metricstore.rocksdb.StringMetadataCache,2,0,0,2,0,0,0,0,4
apache_storm.org.apache.storm.metricstore.rocksdb.RocksDbKey,2,0,0,2,0,0,0,0,4
apache_storm.org.apache.storm.scheduler.resource.RasNodes,1,0,0,1,0,0,0,0,2
apache_storm.org.apache.storm.scheduler.IScheduler,24,1,0,24,0,0,0,0,49
apache_storm.org.apache.storm.topology.ResourceDeclarer,2,0,0,2,0,0,0,0,4
apache_storm.org.apache.storm.scheduler.TopologyDetails,1,0,0,1,0,0,0,0,2
apache_storm.org.apache.storm.scheduler.SupervisorDetails,4,0,0,4,0,0,0,0,8
apache_storm.org.apache.storm.scheduler.resource.normalization.NormalizedResourceOffer,0,0,0,0,0,0,0,0,0
apache_storm.org.apache.storm.scheduler.resource.normalization.NormalizedResources,3,0,0,2,0,0,0,0,5
apache_storm.org.apache.storm.scheduler.resource.normalization.NormalizedResourceRequest,2,0,0,0,0,0,0,0,2
apache_storm.org.apache.storm.scheduler.resource.normalization.ResourceMapArrayBridge,1,0,0,1,0,0,0,0,2
apache_storm.org.apache.storm.scheduler.utils.FileConfigLoader,1,0,0,0,0,0,0,0,1
apache_storm.org.apache.storm.scheduler.utils.ArtifactoryConfigLoader,3,0,0,1,0,0,0,0,4
apache_storm.org.apache.storm.container.docker.DockerCommand,0,0,0,0,0,0,0,0,0
apache_storm.org.apache.storm.container.docker.DockerPsCommand,0,0,0,0,0,0,0,0,0
apache_storm.org.apache.storm.container.docker.DockerStopCommand,0,0,0,0,0,0,0,0,0
apache_storm.org.apache.storm.container.docker.DockerRunCommand,0,0,0,0,0,0,0,0,0
apache_storm.org.apache.storm.container.docker.DockerWaitCommand,0,0,0,0,0,0,0,0,0
apache_storm.org.apache.storm.container.docker.DockerExecCommand,0,0,0,0,0,0,0,0,0
apache_storm.org.apache.storm.container.docker.DockerRmCommand,0,0,0,0,0,0,0,0,0
apache_storm.org.apache.storm.container.docker.DockerInspectCommand,0,0,0,0,0,0,0,0,0
apache_storm.org.apache.storm.daemon.nimbus.Nimbus,1,0,0,1,0,0,0,0,2
apache_storm.org.apache.storm.localizer.AsyncLocalizer,7,0,0,7,0,0,0,1,15
apache_storm.org.apache.storm.testing.TmpPath,1,0,0,1,0,0,0,0,2
apache_storm.org.apache.storm.localizer.LocallyCachedBlob,3,0,0,3,0,0,0,0,6
apache_storm.org.apache.storm.localizer.LocalizedResourceRetentionSet,2,0,0,2,0,0,0,0,4
apache_storm.org.apache.storm.flux.parser.FluxParser,12,0,0,12,0,0,0,0,24
apache_storm.org.apache.storm.flux.FluxBuilder,1,0,0,0,0,0,0,0,1
apache_storm.org.apache.storm.flux.Flux,0,0,0,0,0,0,0,1,1
apache_storm.org.apache.storm.ExclamationTopology,1,0,0,0,0,0,0,0,1
apache_storm.org.apache.storm.sql.runtime.serde.tsv.TsvSerializer,0,0,0,0,0,0,0,0,0
apache_storm.org.apache.storm.sql.runtime.serde.avro.AvroSerializer,0,0,0,0,0,0,0,0,0
apache_storm.org.apache.storm.sql.runtime.serde.json.JsonScheme,0,0,0,0,0,0,0,0,0
apache_storm.org.apache.storm.sql.runtime.serde.json.JsonSerializer,0,0,0,0,0,0,0,0,0
apache_storm.org.apache.storm.sql.runtime.serde.csv.CsvSerializer,1,0,0,1,0,0,0,0,2
apache_storm.org.apache.storm.sql.StormSqlLocalClusterImpl,6,0,0,6,0,0,0,0,12
apache_storm.org.apache.storm.sql.runtime.DataSourcesRegistry,5,0,0,5,0,0,0,0,10
jai-imageio_jai-imageio-jpeg2000.com.github.jaiimageio.jpeg2000.impl.I18N,0,0,0,0,0,0,0,0,0
jai-imageio_jai-imageio-jpeg2000.com.github.jaiimageio.jpeg2000.J2KImageWriteParam,2,0,0,1,0,0,0,0,3
renepickhardt_generalized-language-modeling-toolkit.de.typology.splitter.Aggregator,3,0,0,0,0,0,0,0,3
renepickhardt_generalized-language-modeling-toolkit.de.typology.splitter.Sequencer,2,0,0,0,0,0,0,0,2
renepickhardt_generalized-language-modeling-toolkit.de.typology.splitter.SequenceModifier,1,0,0,0,0,0,0,0,1
renepickhardt_generalized-language-modeling-toolkit.de.typology.indexes.WordIndexer,0,0,0,0,0,0,0,0,0
renepickhardt_generalized-language-modeling-toolkit.de.typology.indexes.WordIndex,1,0,0,0,0,0,0,0,1
renepickhardt_generalized-language-modeling-toolkit.de.typology.smoother.KneserNeySmoother,2,0,0,2,0,0,0,0,4
NLPchina_nlp-lang.org.nlpcn.commons.lang.jianfan.JianFan,0,0,0,0,0,0,0,1,1
NLPchina_nlp-lang.org.nlpcn.commons.lang.util.WordWeight,0,0,0,0,0,0,0,4,4
NLPchina_nlp-lang.org.nlpcn.commons.lang.util.IOUtil,0,0,0,0,0,0,0,0,0
NLPchina_nlp-lang.org.nlpcn.commons.lang.util.StringUtil,1,0,0,0,0,0,0,1,2
NLPchina_nlp-lang.org.nlpcn.commons.lang.util.WordAlert,0,0,0,0,0,0,0,1,1
NLPchina_nlp-lang.org.nlpcn.commons.lang.util.FileFinder,1,0,0,0,0,0,0,0,1
NLPchina_nlp-lang.org.nlpcn.commons.lang.util.logging.LogFactory,0,0,0,0,0,0,0,1,1
NLPchina_nlp-lang.org.nlpcn.commons.lang.standardization.SentencesUtil,0,0,0,0,0,0,0,1,1
NLPchina_nlp-lang.org.nlpcn.commons.lang.index.MemoryIndex,0,0,0,0,0,0,0,1,1
NLPchina_nlp-lang.org.nlpcn.commons.lang.finger.FingerprintService,0,0,0,0,0,0,0,0,0
NLPchina_nlp-lang.org.nlpcn.commons.lang.finger.SimHashService,0,0,0,0,0,0,0,0,0
NLPchina_nlp-lang.org.nlpcn.commons.lang.dat.DATMaker,0,0,0,0,0,0,0,1,1
NLPchina_nlp-lang.org.nlpcn.commons.lang.pinyin.Pinyin,0,0,0,0,0,0,0,2,2
NLPchina_nlp-lang.org.nlpcn.commons.lang.tire.domain.Forest,1,0,0,1,0,0,0,0,2
NLPchina_nlp-lang.org.nlpcn.commons.lang.tire.SmartGetWord,0,0,0,0,0,0,0,1,1
NLPchina_nlp-lang.org.nlpcn.commons.lang.tire.library.Library,0,0,0,0,0,0,0,0,0
prometheus_jmx_exporter.io.prometheus.jmx.JmxCollector,1,0,0,0,0,0,0,0,1
prometheus_jmx_exporter.io.prometheus.jmx.JmxMBeanPropertyCache,2,0,0,2,0,0,0,9,13
graphaware_neo4j-reco.com.graphaware.reco.neo4j.cypher.Statement,2,0,0,1,0,0,0,0,3
graphaware_neo4j-reco.com.graphaware.reco.neo4j.module.RecommendationModuleConfiguration,1,0,0,0,0,0,0,0,1
google_closure-compiler.java.util.regex.Matcher,1,0,0,0,0,0,0,0,1
SahaginOrg_sahagin-java.org.sahagin.share.AcceptableLocales,0,0,0,0,0,0,0,2,2
SahaginOrg_sahagin-java.org.sahagin.runlib.external.adapter.AdapterContainer,1,0,0,1,0,0,0,0,2
SahaginOrg_sahagin-java.org.sahagin.share.TestDocResolver,2,0,0,2,0,0,0,0,4
SahaginOrg_sahagin-java.org.sahagin.share.CommonUtils,1,0,0,0,0,0,0,0,1
SahaginOrg_sahagin-java.org.sahagin.share.runresults.RootMethodRunResult,0,0,0,0,0,0,0,0,0
SahaginOrg_sahagin-java.org.sahagin.share.srctree.SrcTree,0,0,0,0,0,0,0,0,0
SahaginOrg_sahagin-java.org.sahagin.runlib.external.TestStepLabelMethod,0,0,0,0,0,0,0,8,8
spotify_trickle.com.spotify.trickle.BindingDep,0,0,0,0,0,0,0,1,1
spotify_trickle.com.spotify.trickle.Input,3,0,0,2,0,1,0,7,13
spotify_trickle.com.spotify.trickle.Graph,3,0,0,1,0,3,0,8,15
spotify_trickle.com.spotify.trickle.NodeInfo,0,0,0,0,0,0,0,0,0
spotify_trickle.com.spotify.trickle.ConfigurableGraph,0,0,0,0,0,0,0,1,1
spotify_trickle.com.spotify.trickle.TraverseState,2,0,0,2,0,0,0,0,4
spotify_trickle.com.spotify.trickle.NodeExecutionFallback,2,0,0,0,0,2,0,0,4
wildfly-security_wildfly-elytron.org.wildfly.security.permission.AbstractPermission,5,0,0,5,0,0,0,0,10
wildfly-security_wildfly-elytron.org.wildfly.security.permission.AbstractBooleanPermission,1,0,0,1,0,0,0,0,2
wildfly-security_wildfly-elytron.org.wildfly.security.permission.AbstractNameOnlyPermission,1,0,0,1,0,0,0,0,2
wildfly-security_wildfly-elytron.org.wildfly.security.permission.AbstractNameSetOnlyPermission,1,0,0,1,0,0,0,0,2
wildfly-security_wildfly-elytron.org.wildfly.security.provider.util.ProviderFactory,0,0,0,0,0,0,0,0,0
wildfly-security_wildfly-elytron.org.wildfly.security.http.HttpServerAuthenticationMechanismFactory,0,0,0,0,0,0,0,2,2
wildfly-security_wildfly-elytron.org.wildfly.security.http.HttpServerAuthenticationMechanism,4,0,0,0,0,0,0,0,4
wildfly-security_wildfly-elytron.org.wildfly.security.http.HttpAuthenticator,6,0,0,0,0,0,0,0,6
wildfly-security_wildfly-elytron.org.wildfly.security.http.oidc.OidcClientConfigurationBuilder,1,0,0,1,0,0,0,0,2
wildfly-security_wildfly-elytron.org.wildfly.security.http.oidc.OidcSecurityRealm,4,0,0,4,0,0,0,0,8
wildfly-security_wildfly-elytron.org.wildfly.security.keystore.LdapGeneralizedTimeUtil,4,0,0,0,0,0,0,0,4
wildfly-security_wildfly-elytron.org.wildfly.security.keystore.ModifyTrackingKeyStore,1,0,0,1,0,0,0,0,2
wildfly-security_wildfly-elytron.org.wildfly.security.keystore.AtomicLoadKeyStore,2,0,0,1,0,0,0,0,3
wildfly-security_wildfly-elytron.org.wildfly.security.keystore.KeyStoreUtil,7,0,0,1,0,0,0,0,8
wildfly-security_wildfly-elytron.org.wildfly.security.keystore.UnmodifiableKeyStore,1,0,0,0,0,0,0,0,1
wildfly-security_wildfly-elytron.org.wildfly.security.password.PasswordFactory,21,1,0,14,0,0,3,34,73
wildfly-security_wildfly-elytron.org.wildfly.security.keystore.AliasFilter,0,0,0,0,0,0,0,9,9
wildfly-security_wildfly-elytron.org.wildfly.security.manager.StackInspector,1,0,0,1,0,0,0,0,2
wildfly-security_wildfly-elytron.org.wildfly.security.manager.WildFlySecurityManager,1,0,0,0,0,0,0,0,1
wildfly-security_wildfly-elytron.org.wildfly.security.authz.jacc.ElytronPolicyConfiguration,2,0,0,2,0,0,0,0,4
wildfly-security_wildfly-elytron.org.wildfly.security.authz.jacc.ElytronPolicyConfigurationFactory,2,0,0,1,0,1,0,0,4
wildfly-security_wildfly-elytron.org.wildfly.security.authz.RoleDecoder,1,0,0,1,0,0,0,0,2
wildfly-security_wildfly-elytron.org.wildfly.security.authz.SourceAddressRoleDecoder,2,0,0,0,0,0,0,0,2
wildfly-security_wildfly-elytron.org.wildfly.security.authz.RegexRoleMapper,9,0,0,9,0,0,0,0,18
wildfly-security_wildfly-elytron.org.wildfly.security.authz.MappedRoleMapper,1,0,0,1,0,0,0,0,2
wildfly-security_wildfly-elytron.org.wildfly.security.authz.RoleMapper,3,0,0,3,0,0,0,0,6
wildfly-security_wildfly-elytron.org.wildfly.security.authz.Roles,8,0,0,8,0,0,0,0,16
wildfly-security_wildfly-elytron.org.wildfly.security.auth.server.IdentityCredentials,0,0,0,0,0,0,0,1,1
wildfly-security_wildfly-elytron.org.wildfly.security.auth.server.SecurityDomain,30,0,0,23,0,2,0,0,55
wildfly-security_wildfly-elytron.org.wildfly.security.auth.server.SecurityIdentity,3,0,0,3,0,0,0,0,6
wildfly-security_wildfly-elytron.org.wildfly.security.auth.util.CaseNameRewriter,0,0,0,0,0,0,0,0,0
wildfly-security_wildfly-elytron.org.wildfly.security.auth.util.MutableNameRewriter,2,0,0,2,0,0,0,0,4
wildfly-security_wildfly-elytron.org.wildfly.security.ssl.MechanismDatabase,1,0,0,1,0,0,0,0,2
wildfly-security_wildfly-elytron.org.wildfly.security.ssl.CipherSuiteSelector,26,0,0,26,0,0,0,0,52
wildfly-security_wildfly-elytron.org.wildfly.security.SecurityFactory,11,0,0,11,0,2,0,26,50
wildfly-security_wildfly-elytron.org.wildfly.security.ssl.JDKSpecific,1,0,0,0,0,0,0,0,1
wildfly-security_wildfly-elytron.org.wildfly.security.ssl.X509RevocationTrustManager,0,0,0,0,0,0,0,0,0
wildfly-security_wildfly-elytron.org.wildfly.security.cache.RealmIdentityCache,2,0,0,2,0,0,0,0,4
wildfly-security_wildfly-elytron.org.wildfly.security.auth.realm.FileSystemSecurityRealm,12,0,0,12,0,1,0,0,25
wildfly-security_wildfly-elytron.org.wildfly.security.auth.realm.FileSystemSecurityRealmBuilder,0,0,0,0,0,0,0,6,6
wildfly-security_wildfly-elytron.org.wildfly.security.auth.client.AuthenticationConfiguration,2,0,0,2,0,0,0,0,4
wildfly-security_wildfly-elytron.org.wildfly.security.keystore.WildFlyElytronKeyStoreProvider,1,0,0,1,0,0,0,0,2
wildfly-security_wildfly-elytron.org.wildfly.security.auth.server.SecurityRealm,7,0,0,7,0,0,0,0,14
wildfly-security_wildfly-elytron.org.wildfly.security.auth.realm.jdbc.mapper.PasswordKeyMapper,8,0,0,8,0,0,0,3,19
wildfly-security_wildfly-elytron.org.wildfly.security.auth.realm.jdbc.JdbcSecurityRealmBuilder,0,0,0,0,0,0,0,2,2
wildfly-security_wildfly-elytron.org.wildfly.security.authz.Attributes,22,0,0,22,0,0,0,0,44
wildfly-security_wildfly-elytron.org.wildfly.security.auth.realm.LegacyPropertiesSecurityRealm,2,0,0,2,0,0,0,2,6
wildfly-security_wildfly-elytron.org.wildfly.security.auth.server.RealmIdentity,4,0,0,3,0,0,0,0,7
wildfly-security_wildfly-elytron.org.wildfly.security.auth.realm.DistributedSecurityRealm,1,0,0,1,0,0,0,0,2
wildfly-security_wildfly-elytron.org.wildfly.security.auth.realm.ldap.UserPasswordPasswordUtil,24,0,0,24,0,0,0,0,48
wildfly-security_wildfly-elytron.org.wildfly.security.auth.realm.token.TokenSecurityRealm,8,0,0,8,0,0,0,6,22
wildfly-security_wildfly-elytron.org.wildfly.security.pem.Pem,3,0,0,2,0,0,0,0,5
wildfly-security_wildfly-elytron.org.wildfly.security.auth.util.MappedRegexRealmMapper,0,0,0,0,0,0,0,0,0
wildfly-security_wildfly-elytron.org.wildfly.security.auth.util.SimpleRegexRealmMapper,0,0,0,0,0,0,0,0,0
wildfly-security_wildfly-elytron.org.wildfly.security.auth.jaspi.JaspiConfigurationBuilder,0,0,0,0,0,0,0,20,20
wildfly-security_wildfly-elytron.org.wildfly.security.auth.client.AuthenticationContext,19,0,0,17,0,8,0,0,44
wildfly-security_wildfly-elytron.org.wildfly.security.auth.client.MatchRule,3,0,0,3,0,0,0,1,7
wildfly-security_wildfly-elytron.org.wildfly.security.auth.client.ElytronXmlParser,17,0,0,16,0,1,0,2,36
wildfly-security_wildfly-elytron.org.wildfly.security.password.WildFlyElytronPasswordProvider,5,0,0,5,0,0,0,0,10
wildfly-security_wildfly-elytron.org.wildfly.security.tool.ElytronToolMessages,0,0,0,0,0,0,0,3,3
wildfly-security_wildfly-elytron.org.wildfly.security.tool.Command,3,3,0,0,0,0,0,0,6
wildfly-security_wildfly-elytron.org.wildfly.security.encryption.SecretKeyUtil,3,0,0,3,0,0,0,0,6
wildfly-security_wildfly-elytron.org.wildfly.security.encryption.CipherUtil,1,0,0,1,0,0,0,0,2
wildfly-security_wildfly-elytron.org.wildfly.security.tool.CredentialStoreCommand,1,0,0,0,0,0,0,0,1
wildfly-security_wildfly-elytron.org.wildfly.security.credential.KeyPairCredential,8,0,0,0,0,0,0,0,8
wildfly-security_wildfly-elytron.org.wildfly.security.tool.ElytronTool,2,2,0,0,0,2,2,0,8
wildfly-security_wildfly-elytron.org.wildfly.security.credential.store.CredentialStore,9,4,0,8,0,2,1,1,25
wildfly-security_wildfly-elytron.org.wildfly.security.util.StringEnumeration,1,0,0,1,0,0,0,0,2
wildfly-security_wildfly-elytron.org.wildfly.security.util.ArrayIterator,7,0,0,7,0,0,0,0,14
wildfly-security_wildfly-elytron.org.wildfly.security.util.PasswordBasedEncryptionUtil,1,0,0,1,0,0,0,0,2
wildfly-security_wildfly-elytron.org.wildfly.security.password.spec.MaskedPasswordAlgorithmSpec,2,0,0,2,0,0,0,0,4
wildfly-security_wildfly-elytron.org.wildfly.security.key.RawSecretKeyFactory,0,0,0,0,0,0,0,0,0
wildfly-security_wildfly-elytron.org.wildfly.security.credential.store.impl.MapCredentialStore,2,0,0,1,0,0,0,0,3
wildfly-security_wildfly-elytron.org.wildfly.security.credential.store.impl.KeyStoreCredentialStore,3,0,0,2,0,0,0,0,5
wildfly-security_wildfly-elytron.org.wildfly.security.password.interfaces.ClearPassword,1,0,0,0,0,0,0,0,1
wildfly-security_wildfly-elytron.org.wildfly.security.audit.PeriodicRotatingFileAuditEndpoint,0,0,0,0,0,0,0,9,9
wildfly-security_wildfly-elytron.org.wildfly.security.audit.SizeRotatingFileAuditEndpoint,0,0,0,0,0,0,0,3,3
wildfly-security_wildfly-elytron.org.wildfly.security.audit.AuditEndpoint,0,0,0,0,0,0,0,6,6
wildfly-security_wildfly-elytron.org.wildfly.security.audit.SyslogAuditEndpoint,0,1,0,0,0,0,1,0,2
wildfly-security_wildfly-elytron.org.wildfly.security.digest.WildFlyElytronDigestProvider,1,0,0,0,0,0,0,0,1
wildfly-security_wildfly-elytron.org.wildfly.security.sasl.gssapi.AbstractGssapiMechanism,3,0,0,0,0,0,0,0,3
wildfly-security_wildfly-elytron.org.wildfly.security.mechanism.gssapi.GSSCredentialSecurityFactory,1,0,0,1,0,0,0,0,2
wildfly-security_wildfly-elytron.org.wildfly.security.sasl.gs2.Gs2,2,0,0,0,0,0,0,0,2
wildfly-security_wildfly-elytron.org.wildfly.security.sasl.util.LegacyRealmListSaslServerFactory,4,0,0,4,0,0,0,0,8
wildfly-security_wildfly-elytron.org.wildfly.security.Version,1,0,0,0,0,0,0,0,1
wildfly-security_wildfly-elytron.org.wildfly.security.sasl.util.UsernamePasswordHashUtil,0,0,0,0,0,0,0,0,0
wildfly-security_wildfly-elytron.org.wildfly.security.auth.callback.AbstractCredentialCallback,3,0,0,0,0,0,0,0,3
wildfly-security_wildfly-elytron.org.wildfly.security.mechanism.digest.DigestUtil,1,0,0,1,0,0,0,0,2
wildfly-security_wildfly-elytron.org.wildfly.security.sasl.digest._private.DigestUtil,5,0,0,0,0,0,0,0,5
wildfly-security_wildfly-elytron.org.wildfly.security.password.util.ModularCrypt,6,0,0,6,0,0,0,0,12
wildfly-security_wildfly-elytron.org.wildfly.security.password.interfaces.BCryptPassword,5,0,0,5,0,0,0,0,10
wildfly-security_wildfly-elytron.org.wildfly.security.password.impl.PasswordFactorySpiImpl,3,0,0,3,0,0,0,4,10
wildfly-security_wildfly-elytron.org.wildfly.security.password.interfaces.MaskedPassword,1,0,0,1,0,0,0,0,2
wildfly-security_wildfly-elytron.org.wildfly.security.password.impl.ScramDigestPasswordImpl,1,0,0,1,0,0,0,0,2
wildfly-security_wildfly-elytron.org.wildfly.security.password.impl.AbstractPasswordImpl,1,0,0,0,0,0,0,0,1
wildfly-security_wildfly-elytron.org.wildfly.security.password.interfaces.UnixSHACryptPassword,0,0,0,0,0,0,0,0,0
wildfly-security_wildfly-elytron.org.wildfly.security.asn1.OidsUtil,1,0,0,0,0,0,0,0,1
wildfly-security_wildfly-elytron.org.wildfly.security.asn1.DEREncoder,5,0,0,5,0,0,0,0,10
wildfly-security_wildfly-elytron.org.wildfly.security.asn1.DERDecoder,21,1,0,18,0,1,0,0,41
wildfly-security_wildfly-elytron.org.wildfly.security.x500.cert.PKCS10CertificateSigningRequest,0,0,0,0,0,0,0,0,0
wildfly-security_wildfly-elytron.org.wildfly.security.x500.cert.X509CertificateBuilder,6,0,0,6,0,0,0,0,12
wildfly-security_wildfly-elytron.org.wildfly.security.x500.cert.SelfSignedX509CertificateAndSigningKey,7,0,0,4,0,1,0,0,12
wildfly-security_wildfly-elytron.org.wildfly.security.x500.cert.acme.AcmeClientSpi,10,0,0,10,0,2,0,0,22
wildfly-security_wildfly-elytron.org.wildfly.security.x500.X500PrincipalBuilder,2,0,0,2,0,0,0,0,4
wildfly-security_wildfly-elytron.org.wildfly.security.x500.X500,4,0,0,0,0,0,0,0,4
wildfly-security_wildfly-elytron.org.wildfly.security.x500.principal.X500AttributePrincipalDecoder,3,0,0,0,0,0,0,0,3
wildfly-security_wildfly-elytron.org.wildfly.security.auth.server.PrincipalDecoder,1,0,0,1,0,0,0,0,2
wildfly-security_wildfly-elytron.org.wildfly.security.x500.principal.X500SubjectEvidenceDecoder,0,0,0,0,0,0,0,0,0
wildfly-security_wildfly-elytron.org.wildfly.security.x500.principal.X509SubjectAltNameEvidenceDecoder,1,0,0,0,0,0,0,0,1
wildfly-security_wildfly-elytron.org.wildfly.security.auth.server.EvidenceDecoder,1,0,0,0,0,0,0,0,1
wildfly-security_wildfly-elytron.org.wildfly.security.x500.util.X500PrincipalUtil,1,0,0,1,0,0,0,0,2
wildfly-security_wildfly-elytron.org.wildfly.security.auth.realm.ldap.AttributeMapping,19,0,0,0,0,0,0,0,19
wildfly-security_wildfly-elytron.org.wildfly.security.auth.realm.ldap.LdapSecurityRealmBuilder,7,0,0,7,0,1,0,0,15
wildfly-security_wildfly-elytron.org.wildfly.security.auth.server.ModifiableSecurityRealm,1,0,0,1,0,0,0,0,2
tesseradata_RHIPE.org.godhuli.rhipe.PersonalServer,0,0,0,0,0,0,0,1,1
tesseradata_RHIPE.org.godhuli.rhipe.RHMR,0,0,0,0,0,0,0,1,1
tesseradata_RHIPE.org.godhuli.rhipe.mr.WordCount,0,0,0,0,0,0,0,1,1
JCTools_JCTools.org.jctools.maps.NonBlockingHashMap,12,2,0,10,0,1,0,0,25
JCTools_JCTools.org.jctools.maps.NonBlockingIdentityHashMap,9,2,0,9,0,1,0,0,21
JCTools_JCTools.org.jctools.maps.NonBlockingHashMapLong,8,1,0,8,0,0,0,0,17
JCTools_JCTools.org.jctools.channels.spsc.SpscChannel,2,0,0,2,0,0,0,0,4
JCTools_JCTools.org.jctools.channels.ChannelProducer,2,0,0,2,0,0,0,0,4
JCTools_JCTools.org.jctools.channels.ChannelConsumer,0,0,0,0,0,0,0,0,0
JCTools_JCTools.org.jctools.queues.spec.ConcurrentQueueSpec,9,2,0,7,0,0,0,0,18
JCTools_JCTools.org.jctools.queues.QueueProgressIndicators,1,0,0,1,0,0,0,0,2
JCTools_JCTools.org.jctools.queues.MessagePassingQueue,10,3,0,6,0,0,0,0,19
JCTools_JCTools.org.jctools.queues.SpscGrowableArrayQueue,2,0,0,0,0,0,0,0,2
JCTools_JCTools.org.jctools.queues.alt.ConcurrentQueue,3,2,0,3,0,0,0,0,8
JCTools_JCTools.org.jctools.counters.Counter,0,0,0,0,0,0,0,1,1
JCTools_JCTools.org.jctools.util.Pow2,2,0,0,0,0,0,0,0,2
JCTools_JCTools.org.jctools.util.RangeUtil,0,0,0,0,0,0,0,0,0
JCTools_JCTools.org.jctools.util.SimpleCompiler,2,0,0,2,0,0,0,0,4
JCTools_JCTools.org.jctools.util.Template,0,0,0,0,0,0,0,0,0
JCTools_JCTools.org.jctools.maps.NonBlockingSetInt,5,0,0,2,0,1,0,0,8
JCTools_JCTools.org.jctools.maps.NonBlockingHashSet,3,0,0,1,0,0,0,0,4
JCTools_JCTools.org.jctools.channels.mapping.Mapper,1,0,0,0,0,0,0,0,1
sharneng_gm4java.org.gm4java.im4java.GMOperation,0,0,0,0,0,0,0,15,15
sharneng_gm4java.org.gm4java.im4java.GMBatchCommand,1,0,0,1,0,0,0,4,6
sharneng_gm4java.org.gm4java.engine.support.GMConnectionPool,0,0,0,0,0,1,0,9,10
sharneng_gm4java.org.gm4java.engine.support.PooledGMConnection,0,0,0,0,0,0,0,4,4
sharneng_gm4java.org.gm4java.engine.support.GMProcessFactory,0,0,0,0,0,0,0,0,0
sharneng_gm4java.org.gm4java.engine.support.GMProcessFactoryImpl,3,0,0,2,0,0,0,6,11
sharneng_gm4java.org.gm4java.engine.support.SimpleGMService,0,0,0,0,0,0,0,4,4
sharneng_gm4java.org.gm4java.engine.support.PooledGMService,0,0,0,0,0,0,0,8,8
sharneng_gm4java.org.gm4java.engine.support.ReaderWriterProcess,0,0,0,0,0,0,0,8,8
sharneng_gm4java.org.gm4java.engine.GMExecutor,1,0,0,0,0,0,0,6,7
sharneng_gm4java.org.gm4java.engine.GMConnection,0,0,0,0,0,0,0,4,4
bedrin_jdbc-sniffer.io.sniffy.socket.SnifferSocketImplFactory,9,1,0,7,0,3,0,0,20
bedrin_jdbc-sniffer.io.sniffy.Sniffy,41,11,0,38,0,22,0,11,123
bedrin_jdbc-sniffer.io.sniffy.nio.SniffySelectorProviderModule,0,0,0,0,0,0,0,0,0
bedrin_jdbc-sniffer.io.sniffy.tls.SniffyTlsModule,2,0,0,2,0,0,0,0,4
bedrin_jdbc-sniffer.io.sniffy.util.JVMUtil,1,4,0,1,0,0,0,0,6
bedrin_jdbc-sniffer.io.sniffy.tls.SSLSocketAdapter,3,0,0,0,0,0,0,4,7
bedrin_jdbc-sniffer.io.sniffy.SniffyUsage,0,0,0,0,0,0,0,0,0
bedrin_jdbc-sniffer.io.sniffy.Sniffer,10,0,0,6,0,15,0,17,48
bedrin_jdbc-sniffer.io.sniffy.LegacySpy,18,0,0,0,0,18,0,0,36
bedrin_jdbc-sniffer.io.sniffy.WrongNumberOfQueriesError,1,0,0,1,0,1,0,0,3
bedrin_jdbc-sniffer.io.sniffy.BaseSpy,0,0,0,0,0,0,0,0,0
bedrin_jdbc-sniffer.io.sniffy.Spy,0,0,0,0,0,0,0,2,2
bedrin_jdbc-sniffer.io.sniffy.socket.SnifferOutputStream,0,0,0,0,0,0,0,4,4
bedrin_jdbc-sniffer.io.sniffy.socket.CompatSnifferSocketImpl,3,0,0,0,0,7,0,12,22
bedrin_jdbc-sniffer.io.sniffy.socket.SnifferInputStream,3,0,0,3,0,0,0,4,10
bedrin_jdbc-sniffer.io.sniffy.socket.TcpConnections,0,0,0,0,0,0,0,9,9
bedrin_jdbc-sniffer.io.sniffy.util.Range,0,0,0,0,0,0,0,0,0
bedrin_jdbc-sniffer.io.sniffy.util.StackTraceExtractor,2,0,0,0,0,0,0,0,2
bedrin_jdbc-sniffer.io.sniffy.util.IOUtil,0,0,0,0,0,0,0,0,0
bedrin_jdbc-sniffer.io.sniffy.util.StringUtil,1,0,0,0,0,0,0,0,1
bedrin_jdbc-sniffer.io.sniffy.util.ReflectionFieldCopier,2,0,0,2,0,0,0,0,4
bedrin_jdbc-sniffer.io.sniffy.util.ExceptionUtil,2,0,0,0,0,1,0,0,3
bedrin_jdbc-sniffer.io.sniffy.test.SharedConnectionDataSource,3,0,0,2,0,0,0,0,5
bedrin_jdbc-sniffer.io.sniffy.test.AnnotationProcessor,5,0,0,1,0,0,0,0,6
bedrin_jdbc-sniffer.io.sniffy.sql.SqlQueries,3,0,0,0,0,0,0,67,70
bedrin_jdbc-sniffer.io.sniffy.sql.SqlUtil,1,0,0,0,0,0,0,0,1
bedrin_jdbc-sniffer.io.sniffy.sql.SniffyDataSource,7,0,0,6,0,1,0,0,14
bedrin_jdbc-sniffer.io.sniffy.servlet.SniffyRequestProcessor,0,0,0,0,0,0,0,0,0
bedrin_jdbc-sniffer.io.sniffy.servlet.SniffyServlet,19,0,0,8,0,0,0,0,27
bedrin_jdbc-sniffer.io.sniffy.servlet.Buffer,0,0,0,0,0,0,0,0,0
bedrin_jdbc-sniffer.io.sniffy.servlet.SniffyFilter,46,0,0,33,0,2,0,2,83
bedrin_jdbc-sniffer.io.sniffy.servlet.FilterServletConfigAdapter,1,0,0,1,0,0,0,0,2
petitparser_java-petitparser.org.petitparser.context.Result,10,0,0,0,0,0,0,0,10
petitparser_java-petitparser.org.petitparser.grammar.xml.ast.XmlDocument,0,0,0,0,0,0,0,0,0
petitparser_java-petitparser.org.petitparser.grammar.xml.XmlCharacterParser,2,0,0,0,0,0,0,0,2
petitparser_java-petitparser.org.petitparser.tools.GrammarDefinition,3,0,0,2,0,0,0,0,5
petitparser_java-petitparser.org.petitparser.parser.Parser,32,0,0,30,0,0,0,19,81
petitparser_java-petitparser.org.petitparser.utils.Functions,4,0,0,0,0,0,0,0,4
petitparser_java-petitparser.org.petitparser.utils.Mirror,8,0,0,8,0,0,0,0,16
petitparser_java-petitparser.org.petitparser.utils.Tracer,2,0,0,2,0,0,0,0,4
petitparser_java-petitparser.org.petitparser.utils.Profiler,3,0,0,3,0,0,0,0,6
petitparser_java-petitparser.org.petitparser.utils.Optimizer,1,0,0,1,0,0,0,0,2
petitparser_java-petitparser.org.petitparser.parser.primitive.CharacterPredicate,19,0,0,19,0,0,0,0,38
petitparser_java-petitparser.org.petitparser.parser.primitive.CharacterParser,56,0,0,12,0,0,0,8,76
petitparser_java-petitparser.org.petitparser.parser.primitive.FailureParser,1,0,0,0,0,0,0,1,2
petitparser_java-petitparser.org.petitparser.parser.primitive.StringParser,4,0,0,0,0,0,0,2,6
petitparser_java-petitparser.org.petitparser.context.Token,1,1,0,1,0,0,0,0,3
petitparser_java-petitparser.org.petitparser.parser.combinators.SettableParser,0,0,0,0,0,0,0,1,1
petitparser_java-petitparser.org.petitparser.tools.ExpressionBuilder,0,0,0,0,0,0,0,1,1
mulesoft_jaxrs-to-raml.org.raml.jaxrs.parser.gatherers.JerseyGatherer,0,0,0,0,0,0,0,0,0
mulesoft_jaxrs-to-raml.org.raml.jaxrs.parser.model.JerseyJaxRsEntity,0,0,0,0,0,0,0,0,0
mulesoft_jaxrs-to-raml.org.raml.jaxrs.parser.source.Utilities,0,0,0,0,0,0,0,0,0
mulesoft_jaxrs-to-raml.org.raml.utilities.types.Cast,0,0,0,0,0,0,0,0,0
square_burst.com.squareup.burst.ParentRunnerSpy,1,0,0,0,0,0,0,0,1
square_burst.com.squareup.burst.Burst,0,0,0,0,0,0,0,1,1
square_burst.com.squareup.burst.BurstableConstructor,0,0,0,0,0,0,0,6,6
skroutz_elasticsearch-analysis-turkishstemmer.org.elasticsearch.index.analysis.TurkishStemmer,15,0,0,0,0,0,0,0,15
skroutz_elasticsearch-analysis-turkishstemmer.org.elasticsearch.index.analysis.stemmer.turkish.states.State,3,0,0,0,0,0,0,0,3
englishtown_vertx-jersey.com.englishtown.vertx.jersey.features.jackson.JacksonFeature,0,0,0,0,0,0,0,0,0
englishtown_vertx-jersey.com.englishtown.vertx.jersey.features.swagger.SwaggerFeature,0,0,0,0,0,0,0,0,0
englishtown_vertx-jersey.com.englishtown.vertx.jersey.features.swagger.internal.SwaggerServletConfig,4,0,0,0,0,0,0,0,4
englishtown_vertx-jersey.com.englishtown.vertx.jersey.JerseyVerticle,1,0,0,0,0,0,0,0,1
englishtown_vertx-jersey.com.englishtown.vertx.jersey.security.DefaultSecurityContext,2,0,0,2,0,0,0,0,4
englishtown_vertx-jersey.com.englishtown.vertx.jersey.impl.VertxResponseWriter,0,0,0,0,0,0,0,2,2
englishtown_vertx-jersey.com.englishtown.vertx.jersey.impl.DefaultJerseyHandler,2,0,0,0,0,0,0,4,6
englishtown_vertx-jersey.com.englishtown.vertx.jersey.impl.DefaultJerseyOptions,6,0,0,0,0,0,0,0,6
englishtown_vertx-jersey.com.englishtown.vertx.jersey.impl.DefaultVertxContainer,1,0,0,1,0,1,0,1,4
englishtown_vertx-jersey.com.englishtown.vertx.jersey.JerseyServer,1,0,0,0,0,0,0,2,3
englishtown_vertx-jersey.com.englishtown.vertx.jersey.impl.DefaultJerseyServer,0,0,0,0,0,0,0,0,0
englishtown_vertx-jersey.com.englishtown.vertx.jersey.inject.impl.VertxResponseWriterProvider,0,0,0,0,0,0,0,0,0
englishtown_vertx-jersey.com.englishtown.vertx.jersey.promises.WhenJerseyServer,0,0,0,0,0,0,0,0,0
englishtown_vertx-jersey.com.englishtown.vertx.guice.BootstrapBinder,0,0,0,0,0,0,0,1,1
englishtown_vertx-jersey.com.englishtown.vertx.guice.GuiceJerseyBinder,1,0,0,1,0,0,0,1,3
jooby-project_jooby.io.jooby.internal.whoops.Whoops,0,0,0,0,0,0,0,1,1
jooby-project_jooby.io.jooby.freemarker.FreemarkerModule,1,0,0,1,0,0,0,0,2
jooby-project_jooby.io.jooby.hikari.HikariModule,15,0,0,0,0,0,0,0,15
jooby-project_jooby.io.jooby.pebble.PebbleModule,1,0,0,1,0,0,0,0,2
jooby-project_jooby.io.jooby.internal.cli.CommandContextImpl,1,0,0,0,0,0,0,0,1
jooby-project_jooby.io.jooby.json.YassonModule,1,0,0,1,0,0,0,0,2
jooby-project_jooby.io.jooby.json.JacksonModule,0,0,0,0,0,0,0,0,0
jooby-project_jooby.io.jooby.Body,0,0,0,0,0,0,0,0,0
jooby-project_jooby.io.jooby.Context,0,0,0,0,0,0,0,2,2
jooby-project_jooby.io.jooby.Value,14,0,0,12,0,1,0,2,29
jooby-project_jooby.io.jooby.Reified,1,0,0,1,0,0,0,1,3
jooby-project_jooby.io.jooby.internal.Chi,8,0,0,8,0,0,0,0,16
jooby-project_jooby.io.jooby.AssetSource,1,0,0,1,0,0,0,0,2
jooby-project_jooby.io.jooby.internal.handler.LinkedHandler,14,0,0,4,0,0,0,0,18
jooby-project_jooby.io.jooby.run.ServerRef,0,0,0,0,0,0,0,1,1
jooby-project_jooby.io.jooby.handlebars.HandlebarsModule,0,0,0,0,0,0,0,0,0
jooby-project_jooby.io.jooby.di.JoobyModule,0,0,0,0,0,0,0,1,1
jooby-project_jooby.io.jooby.email.CommonsEmailModule,2,0,0,0,0,0,0,0,2
jooby-project_jooby.io.jooby.Environment,6,0,0,4,0,0,0,0,10
jooby-project_jooby.io.jooby.internal.utow.UtowFileUpload,0,0,0,0,0,0,0,0,0
jooby-project_jooby.io.jooby.MockRouter,2,0,0,2,0,0,0,0,4
jooby-project_jooby.io.jooby.WebSocket,2,0,0,2,0,0,0,0,4
jooby-project_jooby.io.jooby.ParamLookup,0,0,0,0,0,0,0,1,1
jooby-project_jooby.io.jooby.Jooby,0,0,0,0,0,0,0,0,0
jooby-project_jooby.io.jooby.Router,1,0,0,0,0,0,0,0,1
jooby-project_jooby.io.jooby.SslOptions,4,0,0,4,0,0,0,0,8
jooby-project_jooby.io.jooby.ServerOptions,1,0,0,1,0,0,0,0,2
jooby-project_jooby.io.jooby.Cors,1,0,0,1,0,0,0,0,2
jooby-project_jooby.io.jooby.Server,2,0,0,2,0,0,0,0,4
jooby-project_jooby.io.jooby.ServerSentMessage,0,0,0,0,0,0,0,0,0
jooby-project_jooby.io.jooby.Usage,0,0,0,0,0,0,0,0,0
jooby-project_jooby.io.jooby.Cookie,4,0,0,3,0,0,0,0,7
jooby-project_jooby.io.jooby.DefaultContext,0,0,0,0,0,0,0,0,0
jooby-project_jooby.io.jooby.MediaType,7,0,0,5,0,0,0,0,12
jooby-project_jooby.io.jooby.ValueNode,1,0,0,0,0,0,0,0,1
jooby-project_jooby.io.jooby.internal.HashValue,2,0,0,2,0,0,0,0,4
jooby-project_jooby.io.jooby.ByteRange,2,0,0,1,0,0,0,0,3
jooby-project_jooby.io.jooby.internal.pac4j.UrlResolverImpl,2,0,0,0,0,0,0,0,2
jooby-project_jooby.io.jooby.internal.LocaleUtils,3,0,0,1,0,0,0,0,4
jooby-project_jooby.io.jooby.MockSession,1,0,0,1,0,0,0,0,2
jooby-project_jooby.io.jooby.StatusCode,2,0,0,0,0,0,0,0,2
jooby-project_jooby.io.jooby.MockResponse,2,0,0,2,0,0,0,0,4
jooby-project_jooby.io.jooby.banner.BannerModule,1,0,0,1,0,0,0,1,3
jooby-project_jooby.io.jooby.exception.StatusCodeException,7,0,0,2,0,0,0,0,9
openhab_jmdns.javax.jmdns.impl.ServiceInfoImpl,1,0,0,1,0,0,0,0,2
openhab_jmdns.javax.jmdns.impl.ServiceTypeDecoder,13,0,0,0,0,0,0,0,13
openhab_jmdns.javax.jmdns.JmDNS,19,0,0,19,0,0,0,2,40
openhab_jmdns.javax.jmdns.impl.util.ByteWrangler,2,0,0,0,0,0,0,0,2
openhab_jmdns.javax.jmdns.impl.tasks.state.DNSStateTask,1,0,0,1,0,0,0,0,2
openhab_jmdns.javax.jmdns.impl.DNSMessage,2,0,0,2,0,0,0,0,4
openhab_jmdns.javax.jmdns.impl.DNSRecord,1,0,0,1,0,0,0,0,2
openhab_jmdns.javax.jmdns.impl.DNSCache,1,0,0,1,0,0,0,0,2
openhab_jmdns.javax.jmdns.JmmDNS,5,0,0,5,0,0,1,0,11
openhab_jmdns.javax.jmdns.ServiceInfo,2,0,0,2,0,0,0,0,4
augustt198_lumen.me.august.lumen.common.BytecodeUtil,4,0,0,1,0,0,0,0,5
augustt198_lumen.me.august.lumen.compile.scanner.Token,2,0,0,2,0,0,0,0,4
augustt198_lumen.me.august.lumen.compile.scanner.TokenSource,1,0,0,1,0,0,0,1,3
augustt198_lumen.me.august.lumen.compile.resolve.convert.Conversions,1,0,0,1,0,0,0,0,2
augustt198_lumen.me.august.lumen.compile.parser.ast.ProgramNode,3,0,0,3,0,0,0,1,7
augustt198_lumen.me.august.lumen.compile.parser.ast.expr.TernaryExpr,1,0,0,1,0,0,0,0,2
augustt198_lumen.me.august.lumen.compile.parser.ast.expr.StaticField,1,0,0,1,0,0,0,0,2
augustt198_lumen.me.august.lumen.compile.parser.ast.expr.StaticMethodCall,1,0,0,1,0,0,0,0,2
augustt198_lumen.me.august.lumen.compile.parser.ast.expr.OwnedExpr,1,0,0,0,0,0,0,0,1
augustt198_lumen.me.august.lumen.compile.parser.ast.expr.CastExpr,1,0,0,1,0,0,0,0,2
augustt198_lumen.me.august.lumen.compile.parser.ast.Typed,1,0,0,1,0,0,0,0,2
augustt198_lumen.me.august.lumen.compile.resolve.data.ClassData,2,0,0,2,0,0,0,0,4
augustt198_lumen.me.august.lumen.compile.resolve.TypeVisitor,0,0,0,0,0,0,0,0,0
augustt198_lumen.me.august.lumen.compile.parser.ast.expr.Expression,2,0,0,0,0,0,0,0,2
augustt198_lumen.me.august.lumen.common.TypeUtil,1,0,0,1,0,0,0,0,2
augustt198_lumen.me.august.lumen.compile.analyze.scope.Scope,2,0,0,2,0,0,0,0,4
Pragmatists_junitparams.junitparams.internal.ParameterisedTestClassRunner,0,0,0,0,0,0,0,0,0
Pragmatists_junitparams.junitparams.internal.Utils,0,0,0,0,0,0,0,0,0
Pragmatists_junitparams.junitparams.internal.TestMethod,3,0,0,0,0,0,1,1,5
Pragmatists_junitparams.junitparams.naming.TestCaseNamingStrategy,0,0,0,0,0,0,0,0,0
Pragmatists_junitparams.junitparams.custom.combined.Cartesian,0,0,0,0,0,0,0,0,0
wildfly-extras_wildfly-camel.org.wildfly.camel.catalog.CatalogCreator,1,0,0,1,0,0,0,1,3
wildfly-extras_wildfly-camel.org.wildfly.extras.config.ConfigSupport,4,0,0,4,0,0,0,1,9
wildfly-extras_wildfly-camel.org.wildfly.camel.test.common.utils.TestUtils,7,0,0,1,0,1,0,1,10
wildfly-extras_wildfly-camel.org.wildfly.camel.test.common.aws.AWSUtils,1,0,0,0,0,0,0,0,1
wildfly-extras_wildfly-camel.org.wildfly.camel.test.common.utils.AvailablePortFinder,5,1,0,0,0,0,0,0,6
wildfly-extras_wildfly-camel.org.wildfly.camel.test.common.http.HttpRequest,8,0,0,0,0,0,0,1,9
wildfly-extras_wildfly-camel.org.wildfly.camel.test.common.utils.EnvironmentUtils,0,0,0,0,0,0,0,0,0
wildfly-extras_wildfly-camel.org.wildfly.extension.camel.CamelContextRegistry,63,0,0,16,0,7,0,0,86
wildfly-extras_wildfly-camel.org.wildfly.camel.test.common.utils.LogUtils,0,0,0,0,0,0,0,0,0
wildfly-extras_wildfly-camel.org.wildfly.extension.camel.SpringCamelContextFactory,1,0,0,0,0,0,0,0,1
wildfly-extras_wildfly-camel.org.wildfly.extension.camel.SpringCamelContextBootstrap,0,0,0,0,0,0,0,0,0
wildfly-extras_wildfly-camel.org.wildfly.extension.camel.security.LoginContextBuilder,1,0,0,0,0,0,0,2,3
wildfly-extras_wildfly-camel.org.wildfly.extension.camel.CamelContextFactory,0,0,0,0,0,0,0,3,3
wildfly-extras_wildfly-camel.org.wildfly.camel.test.common.aws.KinesisUtils,1,0,0,1,0,0,0,0,2
wildfly-extras_wildfly-camel.org.wildfly.extension.camel.WildFlyCamelContext,2,1,0,0,0,0,0,0,3
wildfly-extras_wildfly-camel.org.wildfly.camel.test.common.aws.S3Utils,1,0,0,1,0,0,0,0,2
wildfly-extras_wildfly-camel.org.wildfly.camel.test.common.aws.DynamoDBUtils,2,0,0,2,0,0,0,0,4
wildfly-extras_wildfly-camel.org.wildfly.camel.test.common.aws.SDBUtils,1,0,0,1,0,0,0,0,2
wildfly-extras_wildfly-camel.org.wildfly.camel.test.common.types.Customer,7,0,0,7,0,0,0,0,14
wildfly-extras_wildfly-camel.org.wildfly.extension.camel.ContextCreateHandlerRegistry,1,0,0,0,0,0,0,0,1
wildfly-extras_wildfly-camel.org.wildfly.camel.utils.ObjectNameFactory,1,0,0,1,0,0,0,0,2
wildfly-extras_wildfly-camel.org.wildfly.camel.test.common.utils.XMLUtils,0,0,0,0,0,0,0,0,0
wildfly-extras_wildfly-camel.org.wildfly.camel.test.common.utils.FileUtils,1,0,0,0,0,0,0,0,1
wildfly-extras_wildfly-camel.org.wildfly.camel.utils.ServiceLocator,1,0,0,1,0,0,0,0,2
wildfly-extras_wildfly-camel.org.wildfly.extension.camel.EndpointRegistryClient,0,0,0,0,0,0,0,0,0
wildfly-extras_wildfly-camel.org.wildfly.camel.test.common.types.Endpoint,0,0,0,0,0,0,0,0,0
jivesoftware_jive-selenium-pages-framework.com.jivesoftware.selenium.pagefactory.framework.browser.web.WebBrowser,0,0,0,0,0,0,0,1,1
GluuFederation_oxTrust.org.gluu.oxtrust.service.IGroupService,1,0,0,0,0,0,0,0,1
GluuFederation_oxTrust.org.gluu.oxtrust.service.IPersonService,1,0,0,0,0,0,0,0,1
GluuFederation_oxTrust.org.gluu.oxtrust.model.User,1,0,0,0,0,0,0,0,1
GluuFederation_oxTrust.org.gluu.oxtrust.service.PasswordGenerator,0,0,0,0,0,0,0,0,0
GluuFederation_oxTrust.org.gluu.oxtrust.service.ConfigurationService,1,0,0,1,0,0,0,0,2
GluuFederation_oxTrust.org.gluu.oxtrust.api.GluuServerStatus,1,0,0,1,0,1,0,0,3
GluuFederation_oxTrust.org.gluu.oxtrust.api.server.model.GluuGroupApi,3,0,0,2,0,3,0,0,8
GluuFederation_oxTrust.org.gluu.oxtrust.api.server.model.AuthenticationMethod,2,0,0,2,0,2,0,0,6
GluuFederation_oxTrust.org.gluu.oxtrust.model.OxAuthSectorIdentifier,2,0,0,1,0,2,0,0,5
GluuFederation_oxTrust.org.gluu.oxtrust.model.OxAuthClient,3,0,0,1,0,3,0,0,7
GluuFederation_oxTrust.org.gluu.oxtrust.api.server.model.GluuPersonApi,3,0,0,2,0,3,0,0,8
NLPchina_elasticsearch-sql.com.alibaba.druid.pool.ElasticSearchDruidDataSourceFactory,2,0,0,0,0,0,0,0,2
NLPchina_elasticsearch-sql.org.nlpcn.es4sql.query.SqlElasticSearchRequestBuilder,4,3,0,0,0,1,0,0,8
NLPchina_elasticsearch-sql.org.nlpcn.es4sql.spatial.WktToGeoJsonConverter,0,0,0,0,0,0,0,0,0
NLPchina_elasticsearch-sql.org.elasticsearch.plugin.nlpcn.executors.CSVResult,28,1,0,26,0,0,0,0,55
NLPchina_elasticsearch-sql.org.nlpcn.es4sql.parse.SqlParser,74,4,0,74,0,0,0,0,152
NLPchina_elasticsearch-sql.org.nlpcn.es4sql.query.SqlElasticRequestBuilder,2,0,0,2,0,0,0,1,5
NLPchina_elasticsearch-sql.org.nlpcn.es4sql.Util,3,0,0,0,0,0,0,0,3
NLPchina_elasticsearch-sql.org.nlpcn.es4sql.query.ESActionFactory,0,0,0,0,0,0,0,12,12
Steveice10_MCProtocolLib.com.github.steveice10.mc.protocol.codec.MinecraftCodecHelper,0,0,0,0,0,1,0,0,1
Steveice10_MCProtocolLib.com.github.steveice10.mc.protocol.packet.login.serverbound.ServerboundKeyPacket,1,0,0,1,0,0,0,0,2
Steveice10_MCProtocolLib.com.github.steveice10.mc.protocol.codec.MinecraftPacket,0,0,0,0,0,0,0,0,0
tomitribe_crest.org.tomitribe.crest.test.Jar,2,0,0,0,0,0,0,0,2
tomitribe_crest.org.tomitribe.crest.maven.CrestCommandLoaderDescriptorGeneratorMojo,0,0,0,0,0,0,0,0,0
tomitribe_crest.org.tomitribe.crest.cli.impl.CommandParser,5,0,0,0,0,0,0,0,5
tomitribe_crest.org.tomitribe.crest.cli.api.format.Table,0,0,0,0,0,0,0,0,0
tomitribe_crest.org.tomitribe.crest.cmds.Cmd,0,0,0,0,0,0,0,0,0
tomitribe_crest.org.tomitribe.crest.val.BuiltInValidation,0,0,0,0,0,1,0,0,1
tomitribe_crest.org.tomitribe.crest.cmds.targets.Substitution,1,0,0,0,0,0,0,0,1
tomitribe_crest.org.tomitribe.crest.help.Justify,0,0,0,0,0,0,0,0,0
tomitribe_crest.org.tomitribe.crest.help.Wrap,3,0,0,0,0,0,0,2,5
tomitribe_crest.org.tomitribe.crest.help.Highlight,2,0,0,0,0,0,0,0,2
tomitribe_crest.org.tomitribe.crest.help.DocumentParser,0,0,0,0,0,0,0,0,0
tomitribe_crest.org.tomitribe.crest.table.Data,2,0,0,2,0,0,0,0,4
tomitribe_crest.org.tomitribe.crest.table.Options,9,0,0,9,0,0,0,0,18
tomitribe_crest.org.tomitribe.crest.table.Width,3,0,0,3,0,0,0,0,6
tomitribe_crest.org.tomitribe.crest.javadoc.JavadocParser,0,0,0,0,0,0,0,2,2
tomitribe_crest.org.tomitribe.crest.cmds.utils.CommandLine,4,0,0,0,0,0,0,0,4
tomitribe_crest.org.tomitribe.crest.converters.Converter,1,0,0,0,0,0,0,0,1
yahoo_xpath_proto_builder.com.yahoo.xpathproto.ProtoBuilder,2,0,0,0,0,0,0,0,2
yahoo_xpath_proto_builder.com.yahoo.xpathproto.handler.RfcTimestampHandler,1,0,0,0,0,0,0,0,1
yahoo_xpath_proto_builder.com.yahoo.xpathproto.dataobject.Context,1,0,0,1,0,0,0,0,2
cloudfoundry_java-buildpack-auto-reconfiguration.org.cloudfoundry.reconfiguration.CloudPropertySourceApplicationContextInitializer,0,0,0,0,0,0,0,0,0
cloudfoundry_java-buildpack-auto-reconfiguration.org.cloudfoundry.reconfiguration.CloudProfileApplicationListener,0,0,0,0,0,0,0,0,0
cloudfoundry_java-buildpack-auto-reconfiguration.org.cloudfoundry.reconfiguration.CloudServiceReconfigurationBeanFactoryPostProcessor,0,0,0,0,0,0,0,0,0
cloudfoundry_java-buildpack-auto-reconfiguration.org.cloudfoundry.reconfiguration.CloudAutoReconfigurationServletContainerInitializer,0,0,0,0,0,0,0,0,0
cloudfoundry_java-buildpack-auto-reconfiguration.org.cloudfoundry.reconfiguration.CloudProfileApplicationContextInitializer,0,0,0,0,0,0,0,0,0
cloudfoundry_java-buildpack-auto-reconfiguration.org.cloudfoundry.reconfiguration.CloudServiceReconfigurationApplicationContextInitializer,0,0,0,0,0,0,0,0,0
metricminer-msr_metricminer2.org.repodriller.filter.range.ListOfCommits,1,0,0,1,0,0,0,0,2
metricminer-msr_metricminer2.org.repodriller.filter.range.BetweenDates,1,0,0,1,0,0,0,0,2
metricminer-msr_metricminer2.org.repodriller.filter.range.Range,2,0,0,2,0,0,0,0,4
metricminer-msr_metricminer2.org.repodriller.filter.range.SinceCommit,1,0,0,1,0,0,0,0,2
metricminer-msr_metricminer2.org.repodriller.filter.range.LastMonths,2,0,0,2,0,0,0,0,4
metricminer-msr_metricminer2.org.repodriller.filter.range.SingleCommit,1,0,0,1,0,0,0,0,2
metricminer-msr_metricminer2.org.repodriller.filter.diff.OnlyDiffsWithoutFileTypes,0,0,0,0,0,0,0,0,0
metricminer-msr_metricminer2.org.repodriller.filter.diff.OnlyDiffsWithFileTypes,0,0,0,0,0,0,0,0,0
metricminer-msr_metricminer2.org.repodriller.filter.commit.OnlyNoMerge,1,0,0,0,0,0,0,0,1
metricminer-msr_metricminer2.org.repodriller.filter.commit.OnlyModificationsWithFileTypes,1,0,0,1,0,0,0,0,2
metricminer-msr_metricminer2.org.repodriller.filter.commit.OnlyInMainBranch,1,0,0,0,0,0,0,0,1
metricminer-msr_metricminer2.org.repodriller.filter.commit.OnlyInBranches,1,0,0,0,0,0,0,0,1
metricminer-msr_metricminer2.org.repodriller.domain.Commit,2,0,0,0,0,0,0,0,2
metricminer-msr_metricminer2.org.repodriller.domain.Modification,2,0,0,1,0,0,0,0,3
metricminer-msr_metricminer2.org.repodriller.domain.DiffParser,6,0,0,6,0,0,0,0,12
metricminer-msr_metricminer2.org.repodriller.scm.GitRepository,20,0,0,19,0,0,0,0,39
metricminer-msr_metricminer2.org.repodriller.scm.SCMRepository,1,0,0,1,0,0,0,0,2
metricminer-msr_metricminer2.org.repodriller.scm.SubversionRepository,8,0,0,7,0,0,0,0,15
metricminer-msr_metricminer2.org.repodriller.RepositoryMining,11,0,0,11,0,0,0,8,30
GlenKPeterson_fp4java7.org.organicdesign.fp.type.RuntimeTypes,2,0,0,0,0,0,0,0,2
GlenKPeterson_fp4java7.org.organicdesign.fp.function.Fn2,1,0,0,1,0,0,0,0,2
GlenKPeterson_fp4java7.org.organicdesign.fp.function.Fn0,1,0,0,1,0,0,0,0,2
GlenKPeterson_fp4java7.org.organicdesign.fp.function.Fn1,7,0,0,7,0,0,0,1,15
GlenKPeterson_fp4java7.org.organicdesign.fp.FunctionUtils,9,0,0,3,0,0,0,0,12
GlenKPeterson_fp4java7.org.organicdesign.fp.oneOf.Or,3,0,0,2,0,0,0,0,5
GlenKPeterson_fp4java7.org.organicdesign.fp.oneOf.OneOf5,2,0,0,1,0,0,0,0,3
GlenKPeterson_fp4java7.org.organicdesign.fp.oneOf.OneOf3,2,0,0,1,0,0,0,0,3
GlenKPeterson_fp4java7.org.organicdesign.fp.oneOf.Option,6,0,0,1,0,0,0,0,7
GlenKPeterson_fp4java7.org.organicdesign.fp.oneOf.OneOf2,1,0,0,1,0,0,0,0,2
GlenKPeterson_fp4java7.org.organicdesign.fp.oneOf.OneOf4,2,0,0,1,0,0,0,0,3
GlenKPeterson_fp4java7.org.organicdesign.fp.collections.BaseMap,1,0,0,0,0,0,0,0,1
GlenKPeterson_fp4java7.org.organicdesign.fp.xform.Transformable,7,0,0,5,0,0,0,0,12
GlenKPeterson_fp4java7.org.organicdesign.fp.collections.PersistentHashMap,19,0,0,17,0,0,0,0,36
GlenKPeterson_fp4java7.org.organicdesign.fp.collections.PersistentHashSet,8,0,0,7,0,0,0,0,15
GlenKPeterson_fp4java7.org.organicdesign.fp.collections.PersistentVector,12,0,0,9,0,0,1,2,24
GlenKPeterson_fp4java7.org.organicdesign.fp.StaticImports,0,0,0,0,0,0,0,0,0
GlenKPeterson_fp4java7.org.organicdesign.fp.tuple.Tuple3,3,0,0,3,0,0,0,0,6
GlenKPeterson_fp4java7.org.organicdesign.fp.function.LazyRef,1,0,0,1,0,0,0,0,2
GlenKPeterson_fp4java7.org.organicdesign.fp.tuple.Tuple7,1,0,0,1,0,0,0,0,2
GlenKPeterson_fp4java7.org.organicdesign.fp.tuple.Tuple9,1,0,0,1,0,0,0,0,2
GlenKPeterson_fp4java7.org.organicdesign.fp.tuple.Tuple2,1,0,0,1,0,0,0,0,2
GlenKPeterson_fp4java7.org.organicdesign.fp.tuple.Tuple4,1,0,0,1,0,0,0,0,2
GlenKPeterson_fp4java7.org.organicdesign.fp.tuple.Tuple5,1,0,0,1,0,0,0,0,2
GlenKPeterson_fp4java7.org.organicdesign.fp.tuple.Tuple8,1,0,0,1,0,0,0,0,2
GlenKPeterson_fp4java7.org.organicdesign.fp.tuple.Tuple6,1,0,0,1,0,0,0,0,2
GlenKPeterson_fp4java7.org.organicdesign.fp.tuple.Tuple10,1,0,0,1,0,0,0,0,2
GlenKPeterson_fp4java7.org.organicdesign.fp.tuple.Tuple11,1,0,0,1,0,0,0,0,2
GlenKPeterson_fp4java7.org.organicdesign.fp.tuple.Tuple12,1,0,0,1,0,0,0,0,2
GlenKPeterson_fp4java7.org.organicdesign.fp.collections.UnmodList,17,0,0,13,0,0,0,0,30
GlenKPeterson_fp4java7.org.organicdesign.fp.collections.UnmodSortedIterable,1,0,0,0,0,0,0,3,4
GlenKPeterson_fp4java7.org.organicdesign.fp.xform.Xform,9,0,0,8,0,0,0,0,17
GlenKPeterson_fp4java7.org.organicdesign.fp.collections.UnmodIterable,7,0,0,7,0,0,0,0,14
GlenKPeterson_fp4java7.org.organicdesign.fp.collections.RangeOfInt,6,0,0,5,0,0,0,2,13
GlenKPeterson_fp4java7.org.organicdesign.fp.collections.PersistentTreeMap,12,0,0,8,0,0,0,0,20
GlenKPeterson_fp4java7.org.organicdesign.fp.collections.UnmodMap,4,0,0,1,0,0,0,0,5
GlenKPeterson_fp4java7.org.organicdesign.fp.collections.UnmodIterator,0,0,0,0,0,0,0,0,0
GlenKPeterson_fp4java7.org.organicdesign.fp.collections.UnmodCollection,3,0,0,0,0,0,0,0,3
GlenKPeterson_fp4java7.org.organicdesign.fp.collections.ImList,1,0,0,1,0,0,0,0,2
GlenKPeterson_fp4java7.org.organicdesign.fp.collections.ImSortedMap,2,0,0,2,0,0,0,0,4
GlenKPeterson_fp4java7.org.organicdesign.fp.collections.UnmodSet,5,0,0,3,0,0,0,0,8
GlenKPeterson_fp4java7.org.organicdesign.fp.collections.Equator,10,0,0,8,0,0,0,0,18
GlenKPeterson_fp4java7.org.organicdesign.fp.collections.RrbTree,20,0,0,15,0,5,0,9,49
GlenKPeterson_fp4java7.org.organicdesign.fp.collections.PersistentTreeSet,5,0,0,5,0,0,0,0,10
GlenKPeterson_fp4java7.org.organicdesign.fp.collections.AbstractUnmodIterable,0,0,0,0,0,0,0,0,0
GlenKPeterson_fp4java7.org.organicdesign.fp.collections.ImMap,1,0,0,1,0,0,0,0,2
GlenKPeterson_fp4java7.org.organicdesign.fp.collections.Cowry,1,0,0,0,0,0,0,0,1
GlenKPeterson_fp4java7.org.organicdesign.fp.indent.IndentUtils,1,0,0,0,0,0,0,0,1
GlenKPeterson_fp4java7.org.organicdesign.fp.collections.UnmodSortedMap,3,0,0,3,0,0,0,0,6
uwolfer_gerrit-rest-java-client.com.google.gerrit.extensions.api.changes.Changes,3,0,0,3,0,2,0,0,8
uwolfer_gerrit-rest-java-client.com.google.gerrit.extensions.api.accounts.AccountApi,0,0,0,0,0,0,0,0,0
uwolfer_gerrit-rest-java-client.com.google.gerrit.extensions.api.projects.Projects,0,0,0,0,0,0,0,0,0
uwolfer_gerrit-rest-java-client.com.urswolfer.gerrit.client.rest.tools.Tools,0,0,0,0,0,0,0,0,0
uwolfer_gerrit-rest-java-client.com.google.gerrit.extensions.api.config.Server,0,0,0,0,0,0,0,0,0
uwolfer_gerrit-rest-java-client.com.urswolfer.gerrit.client.rest.http.GerritRestClient,1,0,0,1,0,0,0,0,2
uwolfer_gerrit-rest-java-client.com.urswolfer.gerrit.client.rest.http.LoginCache,2,0,0,2,0,0,0,0,4
uwolfer_gerrit-rest-java-client.com.urswolfer.gerrit.client.rest.http.UserAgentHttpRequestInterceptor,0,0,0,0,0,0,0,1,1
uwolfer_gerrit-rest-java-client.com.urswolfer.gerrit.client.rest.http.changes.FileApiRestClient,1,0,0,1,0,0,0,0,2
uwolfer_gerrit-rest-java-client.com.google.gerrit.extensions.api.changes.CommentApi,0,0,0,0,0,0,0,0,0
uwolfer_gerrit-rest-java-client.com.urswolfer.gerrit.client.rest.http.changes.DraftApiRestClient,0,0,0,0,0,0,0,2,2
uwolfer_gerrit-rest-java-client.com.urswolfer.gerrit.client.rest.http.changes.ChangesRestClient,0,0,0,0,0,0,0,2,2
uwolfer_gerrit-rest-java-client.com.google.gerrit.extensions.api.changes.RevisionApi,2,0,0,2,0,0,0,0,4
uwolfer_gerrit-rest-java-client.com.urswolfer.gerrit.client.rest.http.changes.ChangeApiRestClient,0,0,0,0,0,0,0,2,2
uwolfer_gerrit-rest-java-client.com.google.gerrit.extensions.api.changes.ChangeApi,0,0,0,0,0,0,0,15,15
uwolfer_gerrit-rest-java-client.com.urswolfer.gerrit.client.rest.http.changes.parsers.ChangeInfosParser,4,0,0,0,0,0,0,1,5
uwolfer_gerrit-rest-java-client.com.urswolfer.gerrit.client.rest.http.changes.ReviewerApiRestClient,0,0,0,0,0,0,0,1,1
uwolfer_gerrit-rest-java-client.com.urswolfer.gerrit.client.rest.http.changes.parsers.ReviewResultParser,1,0,0,0,0,0,0,0,1
uwolfer_gerrit-rest-java-client.com.urswolfer.gerrit.client.rest.http.changes.parsers.CommitInfosParser,2,0,0,0,0,0,0,0,2
uwolfer_gerrit-rest-java-client.com.urswolfer.gerrit.client.rest.http.changes.parsers.ReviewerInfosParser,3,0,0,0,0,0,0,0,3
uwolfer_gerrit-rest-java-client.com.urswolfer.gerrit.client.rest.http.changes.parsers.FileInfoParser,0,0,0,0,0,0,0,0,0
uwolfer_gerrit-rest-java-client.com.urswolfer.gerrit.client.rest.http.changes.parsers.ReviewInfoParser,0,0,0,0,0,0,0,0,0
uwolfer_gerrit-rest-java-client.com.urswolfer.gerrit.client.rest.http.groups.GroupsRestClient,0,0,0,0,0,0,0,2,2
uwolfer_gerrit-rest-java-client.com.urswolfer.gerrit.client.rest.http.groups.GroupsParser,0,0,0,0,0,0,0,0,0
uwolfer_gerrit-rest-java-client.com.urswolfer.gerrit.client.rest.http.groups.GroupApiRestClient,1,0,0,1,0,0,0,3,5
uwolfer_gerrit-rest-java-client.com.urswolfer.gerrit.client.rest.http.config.ServerRestClient,0,0,0,0,0,0,0,0,0
uwolfer_gerrit-rest-java-client.com.google.gerrit.extensions.api.projects.LabelApi,0,0,0,0,0,0,0,1,1
uwolfer_gerrit-rest-java-client.com.google.gerrit.extensions.api.projects.ProjectApi,0,0,0,0,0,0,0,2,2
uwolfer_gerrit-rest-java-client.com.urswolfer.gerrit.client.rest.http.projects.ProjectApiRestClient,0,0,0,0,0,0,0,0,0
uwolfer_gerrit-rest-java-client.com.urswolfer.gerrit.client.rest.http.projects.ProjectsParser,2,0,0,0,0,0,0,0,2
uwolfer_gerrit-rest-java-client.com.google.gerrit.extensions.api.projects.BranchApi,0,0,0,0,0,0,0,2,2
uwolfer_gerrit-rest-java-client.com.urswolfer.gerrit.client.rest.http.projects.BranchApiRestClient,1,0,0,1,0,0,0,0,2
uwolfer_gerrit-rest-java-client.com.urswolfer.gerrit.client.rest.http.projects.TagInfoParser,2,0,0,0,0,0,0,0,2
uwolfer_gerrit-rest-java-client.com.google.gerrit.extensions.api.projects.TagApi,0,0,0,0,0,0,0,0,0
uwolfer_gerrit-rest-java-client.com.urswolfer.gerrit.client.rest.http.projects.BranchInfoParser,2,0,0,0,0,0,0,0,2
uwolfer_gerrit-rest-java-client.com.urswolfer.gerrit.client.rest.accounts.AccountApi,1,0,0,1,0,0,0,0,2
uwolfer_gerrit-rest-java-client.com.urswolfer.gerrit.client.rest.http.accounts.AccountsParser,0,0,0,0,0,0,0,0,0
uwolfer_gerrit-rest-java-client.com.urswolfer.gerrit.client.rest.http.accounts.AccountsRestClient,0,0,0,0,0,0,0,5,5
uwolfer_gerrit-rest-java-client.com.urswolfer.gerrit.client.rest.http.accounts.SshKeysParser,0,0,0,0,0,0,0,0,0
imglib_imglib2.net.imglib2.AbstractLocalizable,2,2,0,0,0,0,0,0,4
imglib_imglib2.net.imglib2.Interval,0,0,0,0,0,0,0,0,0
imglib_imglib2.net.imglib2.FinalRealInterval,1,0,0,0,0,0,0,0,1
imglib_imglib2.net.imglib2.AbstractRealInterval,0,0,0,0,0,0,0,0,0
imglib_imglib2.net.imglib2.AbstractEuclideanSpace,8,0,0,7,0,0,0,0,15
imglib_imglib2.net.imglib2.Point,5,4,0,4,0,0,0,0,13
imglib_imglib2.net.imglib2.RealLocalizable,0,0,0,0,0,0,0,0,0
imglib_imglib2.net.imglib2.EuclideanSpace,0,0,0,0,0,0,0,0,0
imglib_imglib2.net.imglib2.Dimensions,0,0,0,0,0,0,0,0,0
imglib_imglib2.net.imglib2.util.Binning,2,0,0,2,0,0,0,0,4
imglib_imglib2.net.imglib2.RealPointSampleList,2,0,0,2,0,0,0,0,4
imglib_imglib2.net.imglib2.FinalInterval,2,0,0,0,0,0,0,1,3
imglib_imglib2.net.imglib2.AbstractInterval,1,0,0,1,0,0,0,0,2
imglib_imglib2.net.imglib2.RealPoint,1,0,0,0,0,0,0,0,1
imglib_imglib2.net.imglib2.Localizable,0,0,0,0,0,0,0,0,0
imglib_imglib2.net.imglib2.FinalDimensions,1,0,0,0,0,0,0,0,1
imglib_imglib2.net.imglib2.AbstractRealLocalizable,2,2,0,0,0,0,0,0,4
imglib_imglib2.net.imglib2.RandomAccessible,2,0,0,1,0,0,0,1,4
imglib_imglib2.net.imglib2.RealRandomAccessible,1,0,0,0,0,0,0,0,1
imglib_imglib2.net.imglib2.type.operators.ValueEquals,0,0,0,0,0,0,0,2,2
imglib_imglib2.net.imglib2.type.Type,0,0,0,0,0,0,0,2,2
imglib_imglib2.net.imglib2.type.operators.Sub,0,0,0,0,0,0,0,0,0
imglib_imglib2.net.imglib2.type.operators.Add,0,0,0,0,0,0,0,0,0
imglib_imglib2.net.imglib2.type.operators.Mul,0,0,0,0,0,0,0,0,0
imglib_imglib2.net.imglib2.type.operators.MulFloatingPoint,0,0,0,0,0,0,0,0,0
imglib_imglib2.net.imglib2.type.operators.Div,0,0,0,0,0,0,0,0,0
imglib_imglib2.net.imglib2.type.numeric.complex.AbstractComplexType,1,0,0,1,0,0,0,0,2
imglib_imglib2.net.imglib2.type.numeric.complex.ComplexFloatType,1,0,0,1,0,0,0,0,2
imglib_imglib2.net.imglib2.type.numeric.integer.UnsignedShortType,3,0,0,2,0,0,0,0,5
imglib_imglib2.net.imglib2.type.numeric.integer.Unsigned4BitType,1,0,0,1,0,0,0,0,2
imglib_imglib2.net.imglib2.type.numeric.integer.AbstractIntegerBitType,6,0,0,3,0,0,0,0,9
imglib_imglib2.net.imglib2.type.numeric.integer.UnsignedLongType,6,0,0,5,0,0,0,1,12
imglib_imglib2.net.imglib2.type.numeric.integer.UnsignedIntType,3,0,0,2,0,0,0,0,5
imglib_imglib2.net.imglib2.type.numeric.integer.UnsignedByteType,3,0,0,2,0,0,0,0,5
imglib_imglib2.net.imglib2.type.numeric.integer.ByteType,2,0,0,1,0,0,0,0,3
imglib_imglib2.net.imglib2.type.numeric.integer.UnsignedVariableBitLengthType,2,0,0,1,0,0,0,0,3
imglib_imglib2.net.imglib2.type.numeric.integer.LongType,2,0,0,1,0,0,0,1,4
imglib_imglib2.net.imglib2.type.numeric.IntegerType,1,0,0,1,0,0,0,0,2
imglib_imglib2.net.imglib2.type.numeric.ComplexType,1,0,0,0,0,0,0,0,1
imglib_imglib2.net.imglib2.type.numeric.integer.IntegerTypes,1,0,0,0,0,0,0,0,1
imglib_imglib2.net.imglib2.type.numeric.integer.Unsigned128BitType,5,0,0,2,0,0,0,0,7
imglib_imglib2.net.imglib2.type.numeric.integer.Unsigned12BitType,1,0,0,1,0,0,0,0,2
imglib_imglib2.net.imglib2.type.numeric.integer.ShortType,6,0,0,1,0,0,0,0,7
imglib_imglib2.net.imglib2.type.numeric.integer.Unsigned2BitType,2,0,0,2,0,0,0,0,4
imglib_imglib2.net.imglib2.type.numeric.integer.IntType,4,0,0,3,0,0,0,2,9
imglib_imglib2.net.imglib2.type.logic.BitType,1,0,0,1,0,0,0,0,2
imglib_imglib2.net.imglib2.type.logic.NativeBoolType,1,0,0,1,0,0,0,0,2
imglib_imglib2.net.imglib2.iterator.LocalizingRealIntervalIterator,1,0,0,1,0,0,0,0,2
imglib_imglib2.net.imglib2.img.sparse.Ntree,3,0,0,2,0,0,0,0,5
imglib_imglib2.net.imglib2.view.IntervalView,0,0,0,0,0,0,0,8,8
imglib_imglib2.net.imglib2.img.array.ArrayImg,4,0,0,3,0,0,0,0,7
imglib_imglib2.net.imglib2.util.Intervals,8,0,0,4,0,0,0,11,23
imglib_imglib2.net.imglib2.img.basictypeaccess.array.AbstractLongArray,0,0,0,0,0,0,0,0,0
imglib_imglib2.net.imglib2.img.cell.AbstractCellImg,4,0,0,4,0,0,0,0,8
imglib_imglib2.net.imglib2.IterableRealInterval,1,0,0,0,0,0,0,0,1
imglib_imglib2.net.imglib2.img.cell.Cell,1,0,0,0,0,0,0,0,1
imglib_imglib2.net.imglib2.Positionable,16,0,0,16,0,0,0,0,32
imglib_imglib2.net.imglib2.parallel.Parallelization,1,0,0,1,0,0,0,0,2
imglib_imglib2.net.imglib2.parallel.DefaultTaskExecutor,1,0,0,0,0,0,0,0,1
imglib_imglib2.net.imglib2.parallel.TaskExecutors,2,0,0,2,0,0,0,0,4
imglib_imglib2.net.imglib2.position.FunctionRealRandomAccessible,1,0,0,1,0,0,0,0,2
imglib_imglib2.net.imglib2.position.FunctionRandomAccessible,1,0,0,1,0,0,0,0,2
imglib_imglib2.net.imglib2.position.transform.FloorOffset,18,0,0,11,0,0,0,0,29
imglib_imglib2.net.imglib2.position.transform.AbstractPositionableTransform,3,0,0,3,0,0,0,0,6
imglib_imglib2.net.imglib2.util.StopWatch,0,0,0,0,0,0,4,1,5
imglib_imglib2.net.imglib2.util.Util,3,0,0,0,0,0,0,0,3
imglib_imglib2.net.imglib2.util.RealSum,0,0,0,0,0,0,0,0,0
imglib_imglib2.net.imglib2.util.FlatCollections,0,0,0,0,0,0,0,12,12
imglib_imglib2.net.imglib2.util.Partition,1,0,0,0,0,0,0,0,1
imglib_imglib2.net.imglib2.util.Localizables,1,0,0,1,0,0,0,0,2
imglib_imglib2.net.imglib2.test.ImgLib2Assert,0,0,0,0,0,0,0,8,8
imglib_imglib2.net.imglib2.util.LinAlgHelpers,4,0,0,1,0,0,0,0,5
imglib_imglib2.net.imglib2.util.IterablePair,2,0,0,1,0,0,0,0,3
imglib_imglib2.net.imglib2.util.KthElement,4,0,0,0,0,0,0,0,4
imglib_imglib2.net.imglib2.img.AbstractImg,1,0,0,1,0,0,0,0,2
imglib_imglib2.net.imglib2.view.HyperSlicesView,0,0,0,0,0,0,0,0,0
imglib_imglib2.net.imglib2.view.ViewTransforms,0,0,0,0,0,0,0,0,0
imglib_imglib2.net.imglib2.transform.integer.SequentializeTransform,3,0,0,1,0,0,0,0,4
imglib_imglib2.net.imglib2.IterableInterval,2,0,0,2,0,0,0,0,4
imglib_imglib2.net.imglib2.type.numeric.real.DoubleType,1,0,0,1,0,0,0,0,2
imglib_imglib2.net.imglib2.type.numeric.real.FloatType,2,0,0,1,0,0,0,0,3
imglib_imglib2.net.imglib2.test.RandomImgs,0,0,0,0,0,0,0,4,4
imglib_imglib2.net.imglib2.converter.Converters,1,0,0,1,0,0,0,0,2
imglib_imglib2.net.imglib2.type.numeric.ARGBType,0,0,0,0,0,0,0,0,0
imglib_imglib2.net.imglib2.Sampler,0,0,0,0,0,0,0,0,0
imglib_imglib2.net.imglib2.converter.RealTypeConverters,0,0,0,0,0,0,0,2,2
imglib_imglib2.net.imglib2.converter.RealTypeConverterInternals,1,0,0,0,0,0,0,0,1
imglib_imglib2.net.imglib2.histogram.Real1dBinMapper,6,0,0,6,0,0,0,0,12
imglib_imglib2.net.imglib2.histogram.Histogram1d,1,0,0,1,0,0,0,0,2
imglib_imglib2.net.imglib2.histogram.Integer1dBinMapper,2,0,0,2,0,0,0,0,4
imglib_imglib2.net.imglib2.histogram.HistogramNd,4,0,0,4,0,0,0,0,8
imglib_imglib2.net.imglib2.transform.integer.permutation.PermutationTransform,1,0,0,1,0,0,0,0,2
imglib_imglib2.net.imglib2.transform.integer.permutation.SingleDimensionPermutationTransform,1,0,0,1,0,0,0,0,2
imglib_imglib2.net.imglib2.transform.integer.shear.AbstractShearTransform,2,0,0,2,0,0,0,0,4
imglib_imglib2.net.imglib2.transform.integer.shear.ShearTransform,1,0,0,1,0,0,0,0,2
imglib_imglib2.net.imglib2.loops.LoopUtils,0,0,0,0,0,0,0,0,0
imglib_imglib2.net.imglib2.loops.LoopBuilder,0,0,0,0,0,0,0,1,1
imglib_imglib2.net.imglib2.type.numeric.integer.GenericIntType,0,0,0,0,0,0,0,1,1
imglib_imglib2.net.imglib2.loops.IterableLoopBuilder,0,0,0,0,0,0,0,0,0
imglib_imglib2.net.imglib2.loops.ClassCopier,0,0,0,0,0,0,0,0,0
imglib_imglib2.net.imglib2.loops.IntervalChunks,1,0,0,0,0,0,0,2,3
imglib_imglib2.net.imglib2.FlatIterationOrder,1,0,0,0,0,0,0,0,1
ToastShaman_dropwizard-auth-jwt.com.github.toastshaman.dropwizard.auth.jwt.CachingJwtAuthenticator,2,0,0,0,0,0,0,0,2
CloudSlang_cloud-slang.io.cloudslang.lang.spi.encryption.Encryption,2,0,0,2,0,0,0,0,4
sindicetech_siren.com.sindicetech.siren.analysis.NumericAnalyzer,1,0,0,1,0,0,0,0,2
sindicetech_siren.com.sindicetech.siren.qparser.tree.dsl.AbstractQuery,2,0,0,2,0,0,0,0,4
sindicetech_siren.com.sindicetech.siren.qparser.tree.dsl.TwigQuery,0,0,0,0,0,0,0,9,9
sindicetech_siren.com.sindicetech.siren.qparser.tree.ExtendedTreeQueryParser,6,0,0,6,0,0,0,1,13
sindicetech_siren.com.sindicetech.siren.qparser.tree.dsl.QueryBuilder,0,0,0,0,0,0,0,3,3
sindicetech_siren.com.sindicetech.siren.qparser.tree.dsl.NodeQuery,0,0,0,0,0,0,0,1,1
sindicetech_siren.com.sindicetech.siren.qparser.tree.dsl.AbstractBooleanQuery,0,0,0,0,0,0,0,3,3
sindicetech_siren.com.sindicetech.siren.qparser.tree.dsl.ConciseQueryBuilder,0,0,0,0,0,0,0,2,2
sindicetech_siren.com.sindicetech.siren.qparser.tree.dsl.ConciseNodeQuery,0,0,0,0,0,0,0,1,1
sindicetech_siren.com.sindicetech.siren.qparser.tree.storage.SimpleJsonByQueryExtractor,0,0,0,0,0,0,0,0,0
sindicetech_siren.com.sindicetech.siren.qparser.keyword.ExtendedKeywordQueryParser,1,0,0,0,0,0,0,0,1
sindicetech_siren.com.sindicetech.siren.search.node.DatatypedNodeQuery,0,0,0,0,0,0,0,7,7
sindicetech_siren.com.sindicetech.siren.search.node.NodeNumericRangeQuery,1,0,0,1,0,0,0,8,10
sindicetech_siren.com.sindicetech.siren.qparser.keyword.nodes.TwigQueryNode,1,0,0,1,0,0,0,0,2
sindicetech_siren.com.sindicetech.siren.qparser.keyword.ConciseKeywordQueryParser,7,0,0,7,0,0,0,0,14
sindicetech_siren.com.sindicetech.siren.analysis.ConciseJsonTokenizer,0,0,0,0,0,0,0,0,0
sindicetech_siren.com.sindicetech.siren.analysis.AnyURIAnalyzer,0,0,0,0,0,0,0,0,0
sindicetech_siren.com.sindicetech.siren.analysis.ConciseJsonAnalyzer,1,0,0,0,0,0,0,0,1
sindicetech_siren.com.sindicetech.siren.analysis.TupleTokenizer,0,0,0,0,0,0,0,2,2
sindicetech_siren.com.sindicetech.siren.analysis.filter.VIntPayloadCodec,3,0,0,3,0,0,0,0,6
sindicetech_siren.com.sindicetech.siren.search.node.TwigQuery,5,0,0,5,0,0,0,0,10
sindicetech_siren.com.sindicetech.siren.search.spans.BooleanSpanQuery,3,0,0,3,0,0,0,0,6
sindicetech_siren.com.sindicetech.siren.search.spans.MultiTermSpanQuery,2,0,0,2,0,0,0,0,4
sindicetech_siren.com.sindicetech.siren.search.spans.OrSpanQuery,3,0,0,3,0,0,0,0,6
sindicetech_siren.com.sindicetech.siren.search.spans.NotSpanQuery,3,0,0,3,0,0,0,0,6
sindicetech_siren.com.sindicetech.siren.search.spans.NodeSpanQuery,3,0,0,3,0,0,0,0,6
sindicetech_siren.com.sindicetech.siren.search.spans.NearSpanQuery,3,0,0,3,0,0,0,0,6
sindicetech_siren.com.sindicetech.siren.search.spans.PositionCheckSpanQuery,3,0,0,3,0,0,0,0,6
sindicetech_siren.com.sindicetech.siren.search.node.NodeTermRangeQuery,1,0,0,1,0,0,0,0,2
sindicetech_siren.com.sindicetech.siren.search.node.MultiNodeTermQuery,0,0,0,0,0,0,0,0,0
sindicetech_siren.com.sindicetech.siren.search.node.NodeScorer,46,0,0,46,0,0,0,0,92
sindicetech_siren.com.sindicetech.siren.search.node.LuceneProxyNodeQuery,0,0,0,0,0,0,0,1,1
sindicetech_siren.com.sindicetech.siren.search.node.NodeBooleanQuery,3,0,0,1,0,0,0,0,4
sindicetech_siren.com.sindicetech.siren.search.node.LuceneProxyNodeScorer,2,0,0,2,0,0,0,0,4
sindicetech_siren.com.sindicetech.siren.search.node.NodeTermScorer,3,0,0,3,0,0,0,0,6
sindicetech_siren.com.sindicetech.siren.search.node.NodePhraseScorer,7,0,0,7,0,0,0,0,14
sindicetech_siren.com.sindicetech.siren.search.node.NodeQuery,1,0,0,1,0,0,0,0,2
sindicetech_siren.com.sindicetech.siren.search.node.NodeBooleanScorer,1,0,0,1,0,0,0,0,2
sindicetech_siren.com.sindicetech.siren.search.node.NodeDisjunctionScorerQueue,6,0,0,6,0,0,0,0,12
sindicetech_siren.com.sindicetech.siren.util.NodeUtils,4,0,0,0,0,0,0,0,4
sindicetech_siren.com.sindicetech.siren.util.XSDPrimitiveTypeParser,1,0,0,0,0,3,0,3,7
sindicetech_siren.com.sindicetech.siren.index.codecs.siren10.DocsFreqBlockIndexOutput,0,0,0,0,0,0,0,0,0
sindicetech_siren.com.sindicetech.siren.index.codecs.block.BlockCompressor,1,0,0,1,0,0,0,0,2
GrammarViz2_grammarviz2_src.net.seninp.grammarviz.GrammarVizAnomaly,1,0,0,1,0,1,0,0,3
GrammarViz2_grammarviz2_src.net.seninp.tinker.Interval,4,0,0,3,0,0,0,0,7
hmsonline_storm-cassandra-cql.com.hmsonline.trident.cql.CqlClientFactory,2,0,0,0,0,0,0,1,3
hmsonline_storm-cassandra-cql.com.hmsonline.trident.cql.CassandraCqlStateUpdater,1,0,0,0,0,0,0,0,1
hmsonline_storm-cassandra-cql.com.hmsonline.trident.cql.incremental.CassandraCqlIncrementalStateFactory,2,0,0,1,0,0,0,0,3
lumifyio_securegraph.org.securegraph.Metadata,4,2,0,4,0,0,0,0,10
lumifyio_securegraph.org.securegraph.elasticsearch.ElasticSearchSearchIndex,0,0,0,0,0,0,0,0,0
lumifyio_securegraph.org.securegraph.GraphBaseWithSearchIndex,1,0,0,1,0,0,0,0,2
lumifyio_securegraph.org.securegraph.Graph,28,3,0,27,0,1,0,3,62
lumifyio_securegraph.org.securegraph.accumulo.AccumuloGraph,1,1,0,1,0,0,0,0,3
lumifyio_securegraph.org.securegraph.ElementBuilder,20,6,0,19,0,4,0,3,52
lumifyio_securegraph.org.securegraph.VertexBuilder,2,0,0,2,0,0,0,1,5
lumifyio_securegraph.org.securegraph.DefinePropertyBuilder,2,0,0,2,0,0,0,0,4
lumifyio_securegraph.org.securegraph.mutation.ElementMutation,0,0,0,0,0,0,0,2,2
lumifyio_securegraph.org.securegraph.query.DefaultGraphQueryIterable,5,0,0,5,0,0,0,0,10
openscore_score-actions.io.cloudslang.content.abbyy.entities.inputs.ProcessImageInput,4,0,0,4,0,4,0,1,13
openscore_score-actions.io.cloudslang.content.abbyy.entities.inputs.ProcessTextFieldInput,0,0,0,0,0,0,0,0,0
openscore_score-actions.io.cloudslang.content.abbyy.utils.EncodingUtils,1,0,0,0,0,0,0,0,1
openscore_score-actions.io.cloudslang.content.abbyy.utils.InputParser,1,0,0,1,0,8,0,5,15
openscore_score-actions.io.cloudslang.content.abbyy.utils.ResultUtils,3,0,0,0,0,0,0,0,3
openscore_score-actions.io.cloudslang.content.abbyy.http.AbbyyResponseParser,0,0,0,0,0,0,0,8,8
openscore_score-actions.io.cloudslang.content.abbyy.http.HttpClient,0,0,0,0,0,0,0,2,2
openscore_score-actions.io.cloudslang.content.abbyy.http.AbbyyApi,3,0,0,3,0,3,0,4,13
openscore_score-actions.io.cloudslang.content.abbyy.services.AbbyyService,0,0,0,0,0,3,0,1,4
openscore_score-actions.io.cloudslang.content.abbyy.entities.responses.AbbyyResponse,1,0,0,1,0,3,0,1,6
openscore_score-actions.io.cloudslang.content.abbyy.entities.inputs.AbbyyInput,0,0,0,0,0,0,0,0,0
openscore_score-actions.io.cloudslang.content.abbyy.validators.AbbyyInputValidator,0,0,0,0,0,0,0,0,0
apache_struts.com.opensymphony.xwork2.Result,1,0,0,0,0,1,0,0,2
apache_struts.com.opensymphony.xwork2.DefaultActionProxy,1,0,0,0,0,1,0,0,2
apache_struts.com.opensymphony.xwork2.util.NamedVariablePatternMatcher,3,0,0,0,0,0,0,0,3
apache_struts.com.opensymphony.xwork2.validator.validators.RequiredFieldValidator,3,0,0,3,0,0,0,0,6
apache_struts.org.apache.struts2.conversion.UploadedFileConverter,2,0,0,0,0,0,0,0,2
apache_struts.org.apache.struts2.dispatcher.multipart.JakartaStreamMultiPartRequest,0,0,0,0,0,0,0,0,0
apache_struts.org.apache.struts2.StrutsJUnit4TestCase,3,0,0,3,0,0,0,0,6
apache_struts.com.opensymphony.xwork2.ActionContext,2,0,0,2,0,0,0,0,4
apache_struts.org.apache.struts2.dispatcher.mapper.ActionMapping,1,0,0,1,0,0,0,0,2
apache_struts.org.apache.struts2.config.entities.ConstantConfig,5,0,0,4,0,0,0,0,9
apache_struts.org.apache.struts2.config.entities.BeanConfig,2,0,0,2,0,0,0,0,4
apache_struts.org.apache.struts2.config.StrutsJavaConfigurationProvider,1,0,0,1,0,0,0,0,2
apache_struts.org.apache.struts2.util.URLDecoderUtil,1,0,0,0,0,0,0,0,1
apache_struts.org.apache.struts2.showcase.filedownload.FileDownloadAction,0,0,0,0,0,0,0,0,0
apache_struts.org.apache.struts2.tiles.StrutsTilesAnnotationProcessor,5,0,0,2,0,0,0,0,7
apache_struts.org.apache.struts.beanvalidation.constraints.impl.FieldMatchValidator,0,0,0,0,0,0,0,0,0
apache_struts.org.apache.struts2.json.JSONReader,4,0,0,0,0,0,0,0,4
apache_struts.org.apache.struts2.json.JSONWriter,0,0,0,0,0,0,0,4,4
apache_struts.org.apache.struts2.cdi.CdiObjectFactory,2,0,0,0,0,0,0,0,2
apache_struts.org.apache.struts2.osgi.OsgiUtil,4,0,0,0,0,0,0,0,4
google_guava.com.google.common.graph.ImmutableValueGraph,3,0,0,3,0,0,0,0,6
google_guava.com.google.common.graph.ValueGraphBuilder,70,0,0,56,0,22,0,3,151
google_guava.com.google.common.graph.ImmutableNetwork,3,0,0,3,0,0,0,0,6
google_guava.com.google.common.graph.NetworkBuilder,54,0,0,48,0,12,0,15,129
google_guava.com.google.common.graph.GraphBuilder,30,0,0,30,0,0,0,33,93
google_guava.com.google.common.graph.Graph,15,0,0,3,0,0,0,0,18
google_guava.com.google.common.graph.ValueGraph,0,0,0,0,0,0,0,3,3
google_guava.com.google.common.graph.Network,36,0,0,12,0,0,0,0,48
google_guava.com.google.common.collect.ImmutableList,0,0,0,0,0,0,0,3,3
google_guava.com.google.common.collect.Lists,18,0,0,0,0,0,0,120,138
google_guava.com.google.common.graph.MapIteratorCache,9,0,0,6,0,0,0,0,15
google_guava.com.google.common.graph.ElementOrder,33,0,0,33,0,0,0,0,66
google_guava.com.google.common.graph.EndpointPair,9,0,0,9,0,0,0,0,18
google_guava.com.google.common.testing.EqualsTester,0,0,0,0,0,0,0,3,3
google_guava.com.google.common.testing.ClassSanityTester,0,0,0,0,0,6,0,6,12
eXparity_hamcrest-date.org.exparity.hamcrest.date.Moments,0,0,0,0,0,0,0,0,0
eXparity_hamcrest-date.org.exparity.hamcrest.date.DateMatchers,4,0,0,0,0,0,0,0,4
eXparity_hamcrest-date.org.exparity.hamcrest.date.SqlDateMatchers,2,0,0,0,0,0,0,0,2
eXparity_hamcrest-date.org.exparity.hamcrest.date.LocalDateMatchers,2,0,0,0,0,0,0,0,2
eXparity_hamcrest-date.org.exparity.hamcrest.date.LocalDateTimeMatchers,2,0,0,0,0,0,0,0,2
eXparity_hamcrest-date.org.exparity.hamcrest.date.ZonedDateTimeMatchers,2,0,0,0,0,0,0,0,2
eXparity_hamcrest-date.org.exparity.hamcrest.date.OffsetDateTimeMatchers,2,0,0,0,0,0,0,0,2
eXparity_hamcrest-date.org.exparity.hamcrest.date.InstantMatchers,2,0,0,0,0,0,0,0,2
eXparity_hamcrest-date.org.exparity.hamcrest.date.core.TemporalMatcher,0,0,0,0,0,0,0,0,0
eXparity_hamcrest-date.org.exparity.hamcrest.date.LocalTimeMatchers,0,0,0,0,0,0,0,0,0
shilad_wikibrain.org.wikibrain.conf.Configuration,3,0,0,3,0,0,0,2,8
shilad_wikibrain.org.wikibrain.utils.WpIOUtils,4,0,0,0,0,0,0,1,5
shilad_wikibrain.org.wikibrain.utils.ZipDir,1,0,0,1,0,0,0,0,2
shilad_wikibrain.org.wikibrain.utils.ObjectDb,2,0,0,1,0,0,0,0,3
shilad_wikibrain.org.wikibrain.utils.AtomicLongSet,2,0,0,2,0,0,1,1,6
shilad_wikibrain.org.wikibrain.utils.JvmUtils,2,0,0,0,0,0,0,0,2
shilad_wikibrain.org.wikibrain.utils.Scoreboard,3,0,0,3,0,0,0,0,6
shilad_wikibrain.org.wikibrain.utils.AtomicIntSet,2,0,0,2,0,0,1,1,6
shilad_wikibrain.org.wikibrain.utils.AtomicByteArray,1,0,0,1,0,0,0,0,2
jmeter-maven-plugin_jmeter-maven-plugin.com.lazerycode.jmeter.properties.PropertiesFile,11,0,0,9,0,0,0,0,20
jmeter-maven-plugin_jmeter-maven-plugin.com.lazerycode.jmeter.configuration.JMeterProcessJVMSettings,5,0,0,5,0,0,0,0,10
jmeter-maven-plugin_jmeter-maven-plugin.com.lazerycode.jmeter.configuration.RemoteArgumentsArrayBuilder,2,0,0,0,0,0,0,0,2
jmeter-maven-plugin_jmeter-maven-plugin.com.lazerycode.jmeter.configuration.RepositoryConfiguration,1,0,0,1,0,0,0,0,2
jmeter-maven-plugin_jmeter-maven-plugin.com.lazerycode.jmeter.configuration.ArtifactHelpers,0,0,0,0,0,0,0,1,1
jmeter-maven-plugin_jmeter-maven-plugin.com.lazerycode.jmeter.configuration.ProxyConfiguration,0,0,0,0,0,0,0,0,0
jmeter-maven-plugin_jmeter-maven-plugin.com.lazerycode.jmeter.configuration.JMeterArgumentsArray,14,0,0,14,0,0,0,0,28
jmeter-maven-plugin_jmeter-maven-plugin.com.lazerycode.jmeter.configuration.RemoteConfiguration,2,0,0,2,0,0,0,0,4
jmeter-maven-plugin_jmeter-maven-plugin.com.lazerycode.jmeter.json.TestConfigurationWrapper,0,0,0,0,0,0,0,0,0
jmeter-maven-plugin_jmeter-maven-plugin.com.lazerycode.jmeter.json.TestConfiguration,5,0,0,5,0,0,0,0,10
jmeter-maven-plugin_jmeter-maven-plugin.com.lazerycode.jmeter.utility.UtilityFunctions,2,0,0,0,0,0,0,0,2
jmeter-maven-plugin_jmeter-maven-plugin.com.lazerycode.jmeter.results.ResultScanner,12,0,0,12,0,0,3,3,30
jmeter-maven-plugin_jmeter-maven-plugin.com.lazerycode.jmeter.testrunner.TestManager,3,0,0,3,0,0,0,0,6
jmeter-maven-plugin_jmeter-maven-plugin.com.lazerycode.jmeter.testrunner.TestFailureDecider,9,0,0,9,0,0,0,0,18
jmeter-maven-plugin_jmeter-maven-plugin.com.lazerycode.jmeter.testrunner.JMeterProcessBuilder,1,0,0,1,0,0,0,0,2
jmeter-maven-plugin_jmeter-maven-plugin.com.lazerycode.jmeter.mojo.AbstractJMeterMojo,3,0,0,1,0,0,0,0,4
vinhkhuc_jcrfsuite.com.github.jcrfsuite.example.Train,0,0,0,0,0,0,0,1,1
vinhkhuc_jcrfsuite.com.github.jcrfsuite.CrfTrainer,2,0,0,2,0,0,0,0,4
tech-advantage_sonar-gerrit-plugin.fr.techad.sonar.GerritInitializer,0,0,0,0,0,0,0,4,4
tech-advantage_sonar-gerrit-plugin.fr.techad.sonar.GerritConfiguration,2,0,0,2,0,0,0,0,4
tech-advantage_sonar-gerrit-plugin.fr.techad.sonar.GerritPostJob,11,0,0,10,0,0,0,3,24
tech-advantage_sonar-gerrit-plugin.fr.techad.sonar.utils.MessageUtils,0,0,0,0,0,0,0,0,0
tech-advantage_sonar-gerrit-plugin.fr.techad.sonar.gerrit.factory.GerritFacadeFactory,0,0,0,0,0,0,0,0,0
tech-advantage_sonar-gerrit-plugin.fr.techad.sonar.gerrit.factory.GerritConnectorFactory,0,0,0,0,0,0,0,0,0
tech-advantage_sonar-gerrit-plugin.fr.techad.sonar.gerrit.utils.ReviewUtils,2,0,0,0,0,0,0,0,2
tech-advantage_sonar-gerrit-plugin.fr.techad.sonar.gerrit.GerritFacade,2,0,0,0,0,0,0,0,2
tech-advantage_sonar-gerrit-plugin.fr.techad.sonar.gerrit.review.ReviewInput,8,0,0,8,0,0,0,0,16
tech-advantage_sonar-gerrit-plugin.fr.techad.sonar.gerrit.review.ReviewFileComment,0,0,0,0,0,0,0,0,0
tech-advantage_sonar-gerrit-plugin.fr.techad.sonar.gerrit.review.ReviewLineComment,1,0,0,1,0,0,0,0,2
tech-advantage_sonar-gerrit-plugin.fr.techad.sonar.gerrit.network.rest.GerritRestConnector,0,0,0,0,0,0,0,0,0
tech-advantage_sonar-gerrit-plugin.fr.techad.sonar.gerrit.GerritConnector,4,0,0,4,0,0,0,0,8
apache_knox.org.apache.knox.gateway.webappsec.filter.XContentTypeOptionsFilter,2,0,0,2,0,2,0,0,6
apache_knox.org.apache.knox.gateway.webappsec.filter.StrictTransportFilter,2,0,0,2,0,2,0,0,6
apache_knox.org.apache.knox.gateway.webappsec.filter.XSSProtectionFilter,2,0,0,2,0,2,0,0,6
apache_knox.org.apache.knox.gateway.webappsec.filter.XFrameOptionsFilter,2,0,0,2,0,2,0,0,6
apache_knox.org.apache.knox.gateway.encrypturi.impl.EncryptUriDeploymentContributor,1,0,0,1,0,0,0,0,2
apache_knox.org.apache.knox.gateway.services.security.AliasService,4,0,0,4,0,0,0,1,9
apache_knox.org.apache.knox.gateway.encrypturi.api.EncryptUriDescriptor,1,0,0,1,0,0,0,0,2
apache_knox.org.apache.knox.gateway.encrypturi.api.DecryptUriDescriptor,1,0,0,1,0,0,0,0,2
apache_knox.org.apache.knox.gateway.GatewayTestDriver,0,0,0,0,0,0,0,0,0
apache_knox.org.apache.knox.gateway.GatewayFilter,2,0,0,2,0,0,0,2,6
apache_knox.org.apache.knox.gateway.config.GatewayConfig,21,0,0,17,0,2,0,2,42
apache_knox.org.apache.knox.gateway.GatewayServer,0,0,0,0,0,0,0,2,2
apache_knox.org.apache.knox.gateway.GatewayForwardingServlet,0,0,0,0,0,0,0,1,1
apache_knox.org.apache.knox.gateway.dispatch.AbstractGatewayDispatch,0,0,0,0,0,0,0,0,0
apache_knox.org.apache.knox.test.TestUtils,30,0,0,30,0,1,0,1,62
apache_knox.org.apache.knox.gateway.filter.rewrite.impl.CookieScopeResponseWrapper,8,0,0,0,0,0,0,0,8
apache_knox.org.apache.knox.gateway.filter.rewrite.impl.UrlRewriteResponse,2,0,0,0,0,0,0,0,2
apache_knox.org.apache.knox.gateway.filter.rewrite.api.UrlRewriteProcessor,6,0,0,6,0,0,0,2,14
apache_knox.org.apache.knox.gateway.filter.rewrite.impl.UrlRewriteRequest,0,0,0,0,0,0,0,2,2
apache_knox.org.apache.knox.gateway.filter.rewrite.impl.FrontendFunctionProcessor,1,0,0,1,0,1,0,0,3
apache_knox.org.apache.knox.gateway.filter.rewrite.impl.UrlRewriteContextImpl,1,0,0,1,0,0,0,0,2
apache_knox.org.apache.knox.gateway.filter.rewrite.impl.UrlRewriteStepProcessorState,3,0,0,3,0,0,0,0,6
apache_knox.org.apache.knox.gateway.filter.rewrite.api.UrlRewriteRulesDescriptorFactory,18,1,0,14,0,5,0,0,38
apache_knox.org.apache.knox.test.mock.MockRequestMatcher,12,0,0,12,0,0,0,0,24
apache_knox.org.apache.knox.gateway.filter.rewrite.api.FrontendFunctionDescriptor,0,0,0,0,0,0,0,0,0
apache_knox.org.apache.knox.gateway.filter.rewrite.api.UrlRewriteServletEnvironment,0,0,0,0,0,0,0,0,0
apache_knox.org.apache.knox.gateway.util.urltemplate.Parser,23,0,0,23,0,0,0,9,55
apache_knox.org.apache.knox.gateway.pac4j.config.AzureADClientConfigurationDecorator,0,0,0,0,0,0,0,0,0
apache_knox.org.apache.knox.gateway.pac4j.config.SAML2ClientConfigurationDecorator,1,0,0,0,0,0,0,0,1
apache_knox.org.apache.knox.gateway.pac4j.config.Pac4jClientConfigurationDecorator,1,0,0,0,0,0,0,0,1
apache_knox.org.apache.knox.gateway.pac4j.session.KnoxSessionStore,1,0,0,1,0,0,0,0,2
apache_knox.org.apache.knox.gateway.preauth.filter.IPValidator,0,0,0,0,0,0,0,0,0
apache_knox.org.apache.knox.gateway.preauth.filter.HeaderPreAuthFederationFilter,4,0,0,4,0,0,0,0,8
apache_knox.org.apache.knox.gateway.preauth.filter.PreAuthService,5,0,0,4,0,1,0,0,10
apache_knox.org.apache.knox.gateway.preauth.filter.DefaultValidator,0,0,0,0,0,0,0,0,0
apache_knox.org.apache.knox.gateway.provider.federation.jwt.filter.AbstractJWTFilter,19,0,0,19,0,19,0,0,57
apache_knox.org.apache.knox.gateway.provider.federation.jwt.filter.JWTFederationFilter,1,0,0,1,0,0,0,0,2
apache_knox.org.apache.knox.gateway.provider.federation.jwt.filter.SignatureVerificationCache,4,0,0,2,0,0,0,0,6
apache_knox.org.apache.knox.gateway.filter.AclParser,3,0,0,2,0,2,0,0,7
apache_knox.org.apache.knox.gateway.filter.CompositeEnumeration,3,0,0,3,0,0,0,0,6
apache_knox.org.apache.knox.gateway.filter.RedirectToUrlFilter,0,0,0,0,0,0,0,0,0
apache_knox.org.apache.knox.gateway.deploy.impl.ServiceDefinitionDeploymentContributor,3,0,0,3,0,0,0,0,6
apache_knox.org.apache.knox.gateway.deploy.impl.ShiroDeploymentContributor,1,0,0,1,0,0,0,0,2
apache_knox.org.apache.knox.gateway.descriptor.ResourceDescriptor,2,0,0,1,0,1,0,1,5
apache_knox.org.apache.knox.gateway.deploy.impl.CompositeAuthzDeploymentContributor,3,0,0,0,0,0,0,0,3
apache_knox.org.apache.knox.gateway.service.metadata.ServiceModel,1,0,0,1,0,0,0,0,2
apache_knox.org.apache.knox.gateway.util.HttpUtils,1,0,0,0,0,0,0,0,1
apache_knox.org.apache.knox.gateway.util.Urls,4,0,0,1,0,0,0,0,5
apache_knox.org.apache.knox.gateway.util.MimeTypeMap,1,0,0,0,0,0,0,0,1
apache_knox.org.apache.knox.gateway.util.StringUtils,2,0,0,0,0,0,0,0,2
apache_knox.org.apache.knox.gateway.util.Tokens,1,0,0,0,0,0,0,0,1
apache_knox.org.apache.knox.gateway.util.CookieUtils,1,0,0,0,0,0,0,0,1
apache_knox.org.apache.knox.gateway.util.JsonUtils,2,0,0,0,0,0,0,0,2
apache_knox.org.apache.knox.gateway.util.PasswordUtils,0,0,0,0,0,0,0,0,0
apache_knox.org.apache.knox.gateway.util.JsonPath,7,0,0,0,0,2,0,0,9
apache_knox.org.apache.knox.gateway.util.IpAddressValidator,2,0,0,0,0,0,0,0,2
apache_knox.org.apache.knox.gateway.util.ServiceDefinitionsLoader,1,1,0,1,0,0,0,0,3
apache_knox.org.apache.knox.gateway.util.KnoxCLI,28,2,0,17,0,0,0,0,47
apache_knox.org.apache.knox.gateway.util.JDBCUtils,6,0,0,5,0,0,0,0,11
apache_knox.org.apache.knox.gateway.util.RegExUtils,4,0,0,0,0,0,0,0,4
apache_knox.org.apache.knox.gateway.plang.Interpreter,2,0,0,0,0,0,0,0,2
apache_knox.org.apache.knox.gateway.plang.AbstractSyntaxTree,7,0,0,0,0,0,0,0,7
apache_knox.org.apache.knox.gateway.audit.log4j.appender.JdbmQueue,1,0,0,0,0,0,0,0,1
apache_knox.org.apache.knox.gateway.audit.api.AuditService,2,0,0,2,0,0,0,0,4
apache_knox.org.apache.knox.gateway.audit.log4j.layout.AuditLayout,3,0,0,3,0,0,0,0,6
apache_knox.org.apache.knox.gateway.topology.discovery.ambari.AmbariConfigurationMonitor,1,0,0,1,0,0,0,0,2
apache_knox.org.apache.knox.gateway.topology.discovery.ambari.AmbariComponent,6,0,0,6,0,0,0,0,12
apache_knox.org.apache.knox.gateway.topology.discovery.ambari.AmbariCluster,8,0,0,8,0,0,0,0,16
apache_knox.org.apache.knox.gateway.topology.discovery.ambari.AmbariDynamicServiceURLCreator,2,0,0,2,0,0,0,11,15
apache_knox.org.apache.knox.gateway.topology.discovery.ambari.WebHdfsUrlCreator,6,0,0,6,0,0,0,0,12
apache_knox.org.apache.knox.gateway.topology.discovery.ServiceDiscoveryConfig,1,0,0,1,0,0,0,0,2
apache_knox.org.apache.knox.gateway.topology.discovery.ambari.AmbariServiceDiscovery,1,0,0,1,0,0,0,0,2
apache_knox.org.apache.knox.gateway.topology.Service,0,0,0,0,0,0,0,0,0
apache_knox.org.apache.knox.gateway.topology.Topology,8,0,0,1,0,0,0,0,9
apache_knox.org.apache.knox.gateway.ha.provider.impl.BaseZookeeperURLManager,1,0,0,0,0,0,0,0,1
apache_knox.org.apache.knox.gateway.ha.provider.HaServiceConfig,3,0,0,3,0,0,0,0,6
apache_knox.org.apache.knox.gateway.ha.provider.impl.HaDescriptorManager,5,0,0,5,0,0,0,0,10
apache_knox.org.apache.knox.gateway.ha.provider.impl.HaDescriptorFactory,15,0,0,15,0,6,0,0,36
apache_knox.org.apache.knox.gateway.ha.provider.impl.HS2ZookeeperURLManager,2,0,0,2,0,0,0,0,4
apache_knox.org.apache.knox.gateway.ha.provider.impl.AtlasZookeeperURLManager,1,0,0,1,0,0,0,0,2
apache_knox.org.apache.knox.gateway.ha.provider.HaProvider,3,0,0,3,0,1,0,0,7
apache_knox.org.apache.knox.gateway.ha.provider.impl.DefaultURLManager,4,0,0,3,0,1,0,0,8
apache_knox.org.apache.knox.gateway.ha.provider.URLManagerLoader,2,0,0,0,0,0,0,0,2
apache_knox.org.apache.knox.gateway.ha.dispatch.ConfigurableHADispatch,1,0,0,1,0,0,0,0,2
apache_knox.org.apache.knox.gateway.ha.deploy.HaProviderDeploymentContributor,4,0,0,4,0,0,0,0,8
apache_knox.org.apache.knox.gateway.service.config.remote.zk.RemoteConfigurationRegistryJAASConfig,1,0,0,0,0,1,0,0,2
apache_knox.org.apache.knox.gateway.service.config.remote.config.RemoteConfigurationRegistriesParser,1,0,0,1,0,0,0,0,2
apache_knox.org.apache.knox.gateway.shirorealm.KnoxLdapRealm,0,0,0,0,0,0,0,0,0
apache_knox.org.apache.knox.gateway.shirorealm.KnoxPamRealm,0,0,0,0,0,0,0,1,1
apache_knox.org.apache.hadoop.gateway.shirorealm.KnoxPamRealm,0,0,0,0,0,0,0,0,0
apache_knox.org.apache.knox.gateway.util.urltemplate.Template,4,0,0,4,0,0,0,0,8
apache_knox.org.apache.knox.gateway.util.urltemplate.Matcher,15,0,0,15,0,0,0,0,30
apache_knox.org.apache.knox.gateway.util.urltemplate.Token,1,0,0,1,0,0,0,0,2
apache_knox.org.apache.knox.gateway.util.urltemplate.Segment,3,0,0,0,0,0,0,0,3
apache_knox.org.apache.knox.gateway.util.urltemplate.Expander,9,0,0,9,0,1,0,0,19
apache_knox.org.apache.knox.gateway.util.urltemplate.Function,2,0,0,1,0,0,0,0,3
apache_knox.org.apache.knox.gateway.util.urltemplate.Rewriter,5,0,0,5,0,0,0,0,10
apache_knox.org.apache.knox.gateway.hostmap.impl.HostmapDeploymentContributor,1,0,0,1,0,0,0,0,2
apache_knox.org.apache.knox.gateway.hostmap.api.HostmapFunctionDescriptor,1,0,0,1,0,0,0,0,2
apache_knox.org.apache.knox.gateway.identityasserter.filter.NoImpersonationFilter,2,0,0,2,0,0,0,0,4
apache_knox.org.apache.knox.test.mock.MockHttpServletRequest,6,0,0,6,0,0,0,0,12
apache_knox.org.apache.knox.gateway.identityasserter.filter.IdentityAsserterFilter,2,0,0,2,0,0,0,0,4
apache_knox.org.apache.knox.gateway.rm.dispatch.RMHaDispatch,2,0,0,2,0,2,0,0,6
apache_knox.org.apache.knox.gateway.identityasserter.concat.filter.ConcatIdentityAssertionFilter,1,0,0,1,0,0,0,0,2
apache_knox.org.apache.knox.gateway.session.control.ConcurrentSessionVerifier,5,0,0,5,0,0,0,0,10
apache_knox.org.apache.knox.gateway.identityasserter.switchcase.SwitchCaseIdentityAssertionFilter,8,0,0,8,0,0,0,0,16
apache_knox.org.apache.knox.gateway.service.definition.ServiceDefinition,2,0,0,2,0,0,0,0,4
apache_knox.org.apache.knox.gateway.service.definition.ServiceDefinitionComparator,0,0,0,0,0,0,0,0,0
apache_knox.org.apache.knox.gateway.svcregfunc.impl.ServiceMappedUrlFunctionProcessor,3,0,0,3,0,1,0,0,7
apache_knox.org.apache.knox.gateway.svcregfunc.impl.ServiceUrlFunctionProcessor,1,0,0,1,0,0,0,0,2
apache_knox.org.apache.knox.gateway.svcregfunc.impl.ServiceRegistryFunctionProcessorBase,12,0,0,12,0,6,0,0,30
apache_knox.org.apache.knox.gateway.svcregfunc.impl.ServiceMappedAddressFunctionProcessor,3,0,0,3,0,1,0,0,7
apache_knox.org.apache.knox.gateway.svcregfunc.impl.ServiceHostFunctionProcessor,1,0,0,1,0,0,0,0,2
apache_knox.org.apache.knox.gateway.svcregfunc.impl.ServiceMappedHostFunctionProcessor,3,0,0,3,0,1,0,0,7
apache_knox.org.apache.knox.gateway.svcregfunc.impl.ServicePortFunctionProcessor,1,0,0,1,0,0,0,0,2
apache_knox.org.apache.knox.gateway.svcregfunc.impl.ServiceSchemeFunctionProcessor,1,0,0,1,0,0,0,0,2
apache_knox.org.apache.knox.gateway.svcregfunc.impl.ServiceAddressFunctionProcessor,1,0,0,1,0,0,0,0,2
apache_knox.org.apache.knox.gateway.svcregfunc.impl.ServicePathFunctionProcessor,0,0,0,0,0,0,0,0,0
apache_knox.org.apache.knox.gateway.svcregfunc.api.ServicePortFunctionDescriptor,0,0,0,0,0,0,0,0,0
apache_knox.org.apache.knox.gateway.svcregfunc.api.ServicePathFunctionDescriptor,0,0,0,0,0,0,0,0,0
apache_knox.org.apache.knox.gateway.svcregfunc.api.ServiceHostFunctionDescriptor,0,0,0,0,0,0,0,0,0
apache_knox.org.apache.knox.gateway.svcregfunc.api.ServiceSchemeFunctionDescriptor,0,0,0,0,0,0,0,0,0
apache_knox.org.apache.knox.gateway.svcregfunc.api.ServiceAddressFunctionDescriptor,0,0,0,0,0,0,0,0,0
apache_knox.org.apache.knox.gateway.svcregfunc.api.ServiceUrlFunctionDescriptor,0,0,0,0,0,0,0,0,0
apache_knox.org.apache.knox.gateway.clientcert.deploy.ClientCertDeploymentContributor,1,0,0,1,0,0,0,0,2
apache_knox.org.apache.knox.gateway.inboundurl.impl.InboundUrlFunctionProcessor,1,1,0,1,0,0,0,0,3
apache_knox.org.apache.knox.gateway.filter.rewrite.api.UrlRewriteEnvironment,0,0,0,0,0,0,0,0,0
apache_knox.org.apache.knox.gateway.inboundurl.api.InboundUrlFunctionDescriptor,1,1,0,0,0,0,0,0,2
apache_knox.org.apache.knox.gateway.service.knoxsso.WebSSOResource,10,0,0,9,0,1,0,0,20
apache_knox.org.apache.knox.gateway.audit.log4j.audit.Log4jAuditor,1,0,0,0,0,0,0,0,1
apache_knox.org.apache.knox.gateway.identityasserter.regex.filter.RegexIdentityAssertionFilter,3,0,0,3,0,0,0,0,6
apache_knox.org.apache.knox.gateway.identityasserter.regex.filter.RegexTemplate,3,0,0,0,0,0,0,0,3
apache_knox.org.apache.knox.gateway.topology.discovery.cm.ClouderaManagerServiceDiscoveryRepository,5,0,0,5,0,0,0,0,10
apache_knox.org.apache.knox.gateway.topology.discovery.cm.monitor.ClusterConfigurationStore,2,0,0,2,0,0,0,0,4
apache_knox.org.apache.knox.gateway.topology.discovery.cm.monitor.DiscoveryConfigurationStore,2,0,0,2,0,0,0,0,4
apache_knox.org.apache.knox.gateway.topology.discovery.cm.monitor.PollingConfigurationAnalyzer,1,0,0,1,0,0,0,0,2
apache_knox.org.apache.knox.gateway.topology.discovery.cm.monitor.ServiceConfigurationModel,2,0,0,2,0,0,0,0,4
apache_knox.org.apache.knox.gateway.topology.discovery.cm.auth.AuthUtils,1,0,0,0,0,1,0,0,2
apache_knox.org.apache.knox.gateway.topology.discovery.cm.ServiceModel,3,0,0,0,0,0,0,0,3
apache_knox.org.apache.knox.gateway.topology.discovery.cm.collector.AbstractURLCollector,5,0,0,0,0,0,0,0,5
apache_knox.org.apache.knox.gateway.identityasserter.common.filter.AbstractIdentityAsserterDeploymentContributor,1,0,0,1,0,0,0,0,2
apache_knox.org.apache.knox.gateway.plang.Parser,7,0,0,0,0,0,0,0,7
apache_knox.org.apache.knox.gateway.identityasserter.common.function.UsernameFunctionDescriptor,0,0,0,0,0,0,0,0,0
apache_knox.org.apache.knox.gateway.identityasserter.common.function.UsernameFunctionProcessor,1,0,0,0,0,0,0,2,3
apache_knox.org.apache.knox.gateway.service.health.MetricsResource,1,0,0,0,0,0,0,0,1
apache_knox.org.apache.knox.gateway.service.health.PingResource,0,0,0,0,0,0,0,0,0
apache_knox.org.apache.knox.gateway.topology.discovery.ServiceDiscoveryFactory,4,1,0,3,0,0,0,0,8
apache_knox.org.apache.knox.gateway.topology.discovery.ServiceDiscovery,1,0,0,0,0,0,0,0,1
apache_knox.org.apache.knox.gateway.topology.simple.SimpleDescriptor,3,2,0,3,0,3,0,0,11
apache_knox.org.apache.knox.gateway.topology.simple.SimpleDescriptorImpl,1,0,0,1,0,0,0,0,2
apache_knox.org.apache.knox.gateway.topology.simple.ProviderConfiguration,2,1,0,0,0,0,0,0,3
apache_knox.org.apache.knox.gateway.config.ConfigurationInjectorBuilder,9,0,0,7,0,2,0,0,18
apache_knox.org.apache.knox.gateway.config.impl.MappedConfigurationBinding,0,0,0,0,0,0,0,0,0
apache_knox.org.apache.knox.gateway.config.spi.ConfigurationAdapterDescriptor,1,0,0,0,0,0,0,0,1
apache_knox.org.apache.knox.gateway.config.impl.BeanConfigurationAdapter,0,0,0,0,0,0,0,0,0
apache_knox.org.apache.knox.gateway.config.impl.GatewayConfigImpl,14,0,0,9,0,0,0,0,23
apache_knox.org.apache.knox.gateway.jersey.JerseyDispatchDeploymentContributor,1,0,0,1,0,0,0,0,2
apache_knox.org.apache.knox.gateway.topology.hadoop.xml.HadoopXmlResourceParser,3,0,0,3,0,2,0,0,8
apache_knox.org.apache.knox.gateway.launcher.Config,3,0,0,3,0,0,0,0,6
apache_knox.org.apache.knox.gateway.service.knoxtoken.JWKSResource,1,0,0,1,0,0,0,0,2
apache_knox.org.apache.knox.gateway.service.knoxtoken.TokenResource,18,0,0,17,0,0,0,1,36
apache_knox.org.apache.knox.gateway.identityasserter.hadoop.groups.filter.HadoopGroupProviderFilter,3,0,0,3,0,0,0,0,6
apache_knox.org.apache.knox.gateway.shell.KnoxSession,4,1,0,3,0,2,0,1,11
apache_knox.org.apache.knox.gateway.shell.KnoxTokenCredentialCollector,2,0,0,1,0,1,0,0,4
apache_knox.org.apache.knox.gateway.shell.alias.Alias,6,0,0,6,0,6,0,0,18
apache_knox.org.apache.knox.gateway.shell.alias.AddAliasResponse,1,0,0,1,0,1,0,0,3
apache_knox.org.apache.knox.gateway.shell.alias.ListAliasResponse,1,0,0,1,0,1,0,0,3
apache_knox.org.apache.knox.gateway.shell.alias.RemoveAliasResponse,1,0,0,1,0,1,0,0,3
apache_knox.org.apache.knox.gateway.shell.table.KnoxShellTableFilter,6,0,0,6,0,0,0,0,12
apache_knox.org.apache.knox.gateway.shell.table.KnoxShellTable,18,1,0,18,0,0,0,1,38
apache_knox.org.apache.knox.gateway.shell.table.JDBCKnoxShellTableBuilder,1,0,0,1,0,0,0,0,2
apache_knox.org.apache.knox.gateway.shell.table.KnoxShellTableCallHistory,3,0,0,3,0,0,0,3,9
apache_knox.org.apache.knox.gateway.i18n.messages.loggers.test.TestMessageLoggerFactory,1,0,0,1,0,0,0,0,2
apache_knox.org.apache.knox.gateway.dispatch.DefaultDispatch,3,0,0,2,0,1,0,0,6
apache_knox.org.apache.knox.gateway.dispatch.ConfigurableDispatch,9,0,0,7,0,0,0,0,16
apache_knox.org.apache.knox.gateway.dispatch.CappedBufferHttpEntity,15,0,0,0,0,0,0,0,15
apache_knox.org.apache.knox.gateway.dispatch.GatewayDispatchFilter,0,0,0,0,0,0,0,0,0
apache_knox.org.apache.knox.gateway.dispatch.HadoopAuthCookieStore,1,0,0,1,0,0,0,0,2
apache_knox.org.apache.knox.gateway.dispatch.PartiallyRepeatableHttpEntity,14,0,0,0,0,0,0,0,14
apache_knox.org.apache.knox.gateway.dispatch.DefaultHttpClientFactory,1,0,0,1,0,0,0,0,2
apache_knox.org.apache.knox.gateway.descriptor.GatewayDescriptor,1,0,0,1,0,0,0,0,2
apache_knox.org.apache.knox.gateway.descriptor.GatewayDescriptorFactory,4,0,0,3,0,2,0,0,9
apache_knox.org.apache.knox.gateway.descriptor.xml.XmlGatewayDescriptorImporter,0,0,0,0,0,0,0,0,0
apache_knox.org.apache.knox.gateway.descriptor.xml.XmlGatewayDescriptorExporter,0,0,0,0,0,0,0,0,0
apache_knox.org.apache.knox.gateway.topology.monitor.RemoteConfigurationMonitor,4,0,0,4,0,0,0,0,8
apache_knox.org.apache.knox.gateway.topology.validation.TopologyValidator,1,0,0,1,0,0,0,0,2
apache_knox.org.apache.knox.gateway.topology.builder.TopologyBuilder,4,0,0,4,0,0,0,0,8
apache_knox.org.apache.knox.gateway.topology.builder.PropertyTopologyBuilder,1,0,0,1,0,0,0,0,2
apache_knox.org.apache.knox.gateway.services.factory.AbstractServiceFactory,10,0,0,0,0,0,0,0,10
apache_knox.org.apache.knox.gateway.services.AbstractGatewayServices,3,1,0,3,0,0,0,0,7
apache_knox.org.apache.knox.gateway.services.metrics.impl.DefaultMetricsService,4,0,0,4,0,0,0,0,8
apache_knox.org.apache.knox.gateway.services.security.impl.ZookeeperRemoteAliasService,3,0,0,3,0,1,1,0,8
apache_knox.org.apache.knox.gateway.services.security.impl.DefaultKeystoreService,8,0,0,8,0,1,0,0,17
apache_knox.org.apache.knox.gateway.services.security.impl.RemoteAliasService,4,0,0,4,0,0,0,0,8
apache_knox.org.apache.knox.gateway.services.security.impl.JettySSLService,5,0,0,5,0,0,0,0,10
apache_knox.org.apache.knox.gateway.services.token.state.TokenStateJournal,4,0,0,4,0,0,0,0,8
apache_knox.org.apache.knox.gateway.services.token.impl.DefaultTokenAuthorityService,6,0,0,6,0,0,0,1,13
apache_knox.org.apache.knox.gateway.services.token.impl.JDBCTokenStateService,4,0,0,3,0,0,0,0,7
apache_knox.org.apache.knox.gateway.services.token.impl.AliasBasedTokenStateService,6,0,0,6,0,0,0,0,12
apache_knox.org.apache.knox.gateway.services.token.impl.DefaultTokenStateService,4,0,0,2,0,0,0,0,6
apache_knox.org.apache.knox.gateway.services.security.token.TokenUtils,1,0,0,1,0,0,0,0,2
apache_knox.org.apache.knox.gateway.services.security.token.TokenStateService,2,0,0,1,0,1,0,0,4
apache_knox.org.apache.knox.gateway.services.security.token.impl.JWTToken,4,0,0,4,0,0,0,0,8
apache_knox.org.apache.knox.gateway.services.Service,4,0,0,3,0,1,0,0,8
apache_knox.org.apache.knox.gateway.services.security.token.impl.JWT,1,0,0,1,0,0,0,0,2
apache_knox.org.apache.knox.gateway.services.security.token.impl.TokenMAC,1,0,0,0,0,0,0,0,1
apache_knox.org.apache.knox.gateway.services.token.impl.state.TokenStateJournalFactory,1,0,0,1,0,0,0,0,2
apache_knox.org.apache.knox.gateway.services.token.impl.JournalBasedTokenStateService,2,0,0,2,0,0,0,0,4
apache_knox.org.apache.knox.gateway.websockets.GatewayWebsocketHandler,0,0,0,0,0,0,0,0,0
apache_knox.org.apache.knox.gateway.services.topology.impl.DefaultTopologyService,1,0,0,1,0,0,0,0,2
apache_knox.org.apache.knox.gateway.topology.Param,0,0,0,0,0,0,0,0,0
apache_knox.org.apache.knox.gateway.services.security.CryptoService,3,0,0,3,0,0,0,0,6
apache_knox.org.apache.knox.gateway.services.registry.impl.DefaultServiceDefinitionRegistry,1,0,0,1,0,0,0,0,2
apache_knox.org.apache.knox.gateway.topology.Version,2,0,0,2,0,0,0,0,4
apache_knox.org.apache.knox.gateway.dto.HomePageProfile,2,1,0,0,0,0,0,0,3
apache_knox.org.apache.knox.gateway.security.principal.PrincipalMapper,9,0,0,9,0,7,0,0,25
apache_knox.org.apache.knox.gateway.services.security.token.JWTokenAttributesBuilder,9,0,0,9,0,0,0,0,18
apache_knox.org.apache.knox.gateway.services.hostmap.FileBasedHostMapper,1,0,0,1,0,0,0,0,2
apache_knox.org.apache.knox.gateway.securequery.SecureQueryDecodeProcessor,1,0,0,1,0,0,0,0,2
apache_knox.org.apache.knox.gateway.securequery.SecureQueryEncodeDescriptor,1,0,0,1,0,0,0,0,2
apache_knox.org.apache.knox.gateway.securequery.SecureQueryDeploymentContributor,1,0,0,1,0,0,0,0,2
apache_knox.org.apache.knox.gateway.securequery.SecureQueryDecodeDescriptor,1,0,0,1,0,0,0,0,2
apache_knox.org.apache.knox.gateway.securequery.SecureQueryEncodeProcessor,0,0,0,0,0,0,0,0,0
apache_knox.org.apache.knox.gateway.hadoopauth.deploy.HadoopAuthDeploymentContributor,1,0,0,1,0,0,0,0,2
apache_knox.org.apache.knox.gateway.hadoopauth.filter.HadoopAuthFilter,7,0,0,7,0,0,0,0,14
apache_knox.org.apache.knox.gateway.filter.rewrite.impl.html.HtmlPostfixProcessor,0,0,0,0,0,0,0,0,0
apache_knox.org.apache.knox.gateway.filter.rewrite.impl.html.HtmlPrefixProcessor,0,0,0,0,0,0,0,0,0
apache_knox.org.apache.knox.gateway.filter.rewrite.impl.html.HtmlImportFunctionProcessor,0,0,0,0,0,0,0,0,0
apache_knox.org.apache.knox.gateway.filter.rewrite.impl.html.HtmlInfixProcessor,0,0,0,0,0,0,0,0,0
apache_knox.org.apache.knox.gateway.filter.rewrite.api.UrlRewriteFilterGroupDescriptor,0,0,0,0,0,0,0,0,0
igniterealtime_Openfire.org.jivesoftware.openfire.OfflineMessageStore,1,0,0,0,0,0,0,0,1
igniterealtime_Openfire.org.jivesoftware.openfire.entitycaps.EntityCapabilities,0,0,0,0,0,0,0,8,8
igniterealtime_Openfire.org.jivesoftware.openfire.cluster.ClusterMonitor,0,0,0,0,0,0,0,4,4
igniterealtime_Openfire.org.jivesoftware.openfire.keystore.OpenfireX509TrustManager,1,0,0,0,0,0,0,1,2
igniterealtime_Openfire.org.jivesoftware.openfire.spi.EncryptionArtifactFactory,0,0,0,0,0,0,0,0,0
igniterealtime_Openfire.org.jivesoftware.openfire.handler.IQEntityTimeHandler,2,0,0,1,0,0,0,0,3
igniterealtime_Openfire.org.jivesoftware.util.XMPPDateTimeFormat,1,0,0,0,0,0,1,0,2
igniterealtime_Openfire.org.jivesoftware.openfire.muc.HistoryStrategy,1,0,0,1,0,0,0,0,2
igniterealtime_Openfire.org.jivesoftware.openfire.muc.MUCRole,1,0,0,1,0,0,0,0,2
igniterealtime_Openfire.org.jivesoftware.openfire.muc.MUCRoom,1,0,0,1,0,0,0,0,2
igniterealtime_Openfire.org.jivesoftware.openfire.archive.Archiver,6,0,0,0,0,2,0,0,8
igniterealtime_Openfire.org.jivesoftware.openfire.auth.JDBCAuthProvider,1,0,0,0,0,0,0,0,1
igniterealtime_Openfire.org.jivesoftware.openfire.stanzaid.StanzaIDUtil,4,0,0,0,0,3,0,0,7
igniterealtime_Openfire.org.jivesoftware.openfire.user.UserManager,3,0,0,2,0,0,0,0,5
igniterealtime_Openfire.org.jivesoftware.openfire.container.PluginManager,0,0,0,0,0,0,0,0,0
igniterealtime_Openfire.org.jivesoftware.openfire.pubsub.DefaultNodeConfiguration,2,0,0,2,0,0,0,0,4
igniterealtime_Openfire.org.jivesoftware.openfire.admin.GroupBasedAdminProvider,0,0,0,0,0,0,0,0,0
igniterealtime_Openfire.org.jivesoftware.openfire.group.GroupManager,2,0,0,0,0,2,0,0,4
igniterealtime_Openfire.org.jivesoftware.util.StringUtils,4,0,0,1,0,0,0,0,5
igniterealtime_Openfire.org.jivesoftware.openfire.group.GroupJID,1,0,0,1,0,0,0,0,2
igniterealtime_Openfire.org.jivesoftware.openfire.net.DNSUtil,8,0,0,0,0,0,0,0,8
igniterealtime_Openfire.org.jivesoftware.openfire.ldap.LdapManager,9,0,0,1,0,0,0,0,10
igniterealtime_Openfire.org.jivesoftware.openfire.nio.XMLLightweightParser,6,0,0,6,0,0,0,0,12
igniterealtime_Openfire.org.jivesoftware.util.JavaSpecVersion,0,0,0,0,0,0,0,0,0
igniterealtime_Openfire.org.jivesoftware.util.SAXReaderUtil,2,0,0,0,0,0,0,0,2
igniterealtime_Openfire.org.jivesoftware.util.Encryptor,6,0,0,6,0,0,0,0,12
igniterealtime_Openfire.org.jivesoftware.util.ListPager,5,0,0,5,0,0,0,0,10
igniterealtime_Openfire.org.jivesoftware.util.Version,10,0,0,10,0,0,0,0,20
igniterealtime_Openfire.org.jivesoftware.util.CertificateManager,8,0,0,0,0,0,0,0,8
igniterealtime_Openfire.org.jivesoftware.openfire.entitycaps.EntityCapabilitiesManager,0,0,0,0,0,0,0,0,0
igniterealtime_Openfire.org.jivesoftware.util.CacheableOptional,2,0,0,1,0,0,1,0,4
igniterealtime_Openfire.org.jivesoftware.util.GraphicsUtils,0,0,0,0,0,0,0,0,0
igniterealtime_Openfire.org.jivesoftware.admin.AdminConsole,4,2,0,4,0,0,1,0,11
igniterealtime_Openfire.org.jivesoftware.util.WebXmlUtils,13,0,0,13,0,0,0,0,26
igniterealtime_Openfire.org.jivesoftware.util.LocaleUtils,0,0,0,0,0,0,0,0,0
igniterealtime_Openfire.org.jivesoftware.util.cache.DefaultLocalCacheStrategy,2,0,0,0,0,0,0,0,2
igniterealtime_Openfire.org.jivesoftware.util.SystemProperty,17,0,0,16,0,0,0,0,33
igniterealtime_Openfire.org.jivesoftware.util.JiveGlobals,2,0,0,0,0,0,0,0,2
igniterealtime_Openfire.org.jivesoftware.util.XMLProperties,3,0,0,1,0,0,0,0,4
igniterealtime_Openfire.org.jivesoftware.util.cache.DefaultExternalizableUtil,4,0,0,4,0,0,0,0,8
igniterealtime_Openfire.org.jivesoftware.openfire.cluster.NodeID,3,0,0,0,0,0,0,0,3
igniterealtime_Openfire.org.jivesoftware.admin.AuthCheckFilter,1,0,0,0,0,0,0,4,5
igniterealtime_Openfire.org.jivesoftware.admin.SiteMinderServletRequestAuthenticator,0,0,0,0,0,0,0,0,0
igniterealtime_Openfire.org.jivesoftware.admin.LoginLimitManager,0,0,0,0,0,0,0,3,3
stickfigure_gwizard.org.gwizard.swagger.SwaggerServletContextListener,1,0,0,0,0,0,0,0,1
AzureAD_azure-activedirectory-library-for-java.com.microsoft.aad.adal4j.AuthenticationContext,2,0,0,0,0,2,0,0,4
AzureAD_azure-activedirectory-library-for-java.com.microsoft.aad.adal4j.AuthenticationAuthority,2,0,0,2,0,0,0,0,4
AzureAD_azure-activedirectory-library-for-java.com.microsoft.aad.adal4j.MexParser,0,0,0,0,0,0,0,0,0
AzureAD_azure-activedirectory-library-for-java.com.microsoft.aad.adal4j.AuthenticationCallback,0,0,0,0,0,1,0,1,2
AzureAD_azure-activedirectory-library-for-java.com.microsoft.aad.adal4j.WSTrustResponse,0,0,0,0,0,0,0,0,0
AzureAD_azure-activedirectory-library-for-java.com.microsoft.aad.adal4j.AdalOAuthAuthorizationGrant,1,0,0,0,0,0,0,0,1
AzureAD_azure-activedirectory-library-for-java.com.microsoft.aad.adal4j.HttpHelper,1,0,0,1,0,0,0,0,2
AzureAD_azure-activedirectory-library-for-java.com.microsoft.aad.adal4j.AdalTokenRequest,5,0,0,2,0,2,0,0,9
AzureAD_azure-activedirectory-library-for-java.com.microsoft.aad.adal4j.UserInfo,1,0,0,1,0,0,0,0,2
AzureAD_azure-activedirectory-library-for-java.com.microsoft.aad.adal4j.ClientDataHttpHeaders,0,0,0,0,0,0,0,0,0
AzureAD_azure-activedirectory-library-for-java.com.microsoft.aad.adal4j.AsymmetricKeyCredential,2,0,0,0,0,0,0,0,2
AzureAD_azure-activedirectory-library-for-java.com.microsoft.aad.adal4j.WSTrustRequest,1,0,0,0,0,0,0,0,1
AzureAD_azure-activedirectory-library-for-java.com.microsoft.aad.adal4j.AdalAccessTokenResponse,1,0,0,1,0,0,0,0,2
seagate_kinetic-java.com.seagate.kinetic.common.lib.Hmac,4,1,0,2,0,2,0,0,9
seagate_kinetic-java.kinetic.client.Entry,1,0,0,1,0,0,0,0,2
seagate_kinetic-java.com.seagate.kinetic.client.internal.DefaultKineticClient,30,1,0,30,0,0,0,0,61
seagate_kinetic-java.kinetic.admin.Domain,6,0,0,1,0,8,0,0,15
seagate_kinetic-java.kinetic.admin.ACL,6,0,0,1,0,8,0,0,15
seagate_kinetic-java.com.seagate.kinetic.common.lib.KineticMessage,7,0,0,0,0,7,0,0,14
seagate_kinetic-java.kinetic.admin.KineticAdminClientFactory,2,0,0,0,0,2,0,0,4
seagate_kinetic-java.kinetic.client.KineticClientFactory,1,0,0,1,0,0,0,1,3
seagate_kinetic-java.kinetic.admin.KineticLog,13,0,0,12,0,13,0,0,38
seagate_kinetic-java.kinetic.admin.Device,1,0,0,0,0,1,0,0,2
seagate_kinetic-java.kinetic.client.EntryMetadata,0,0,0,0,0,0,0,0,0
seagate_kinetic-java.kinetic.admin.KineticAdminClient,2,0,0,0,0,2,0,0,4
KleeGroup_vertigo.io.vertigo.core.analytics.AnalyticsManager,2,0,0,0,0,2,0,6,10
KleeGroup_vertigo.io.vertigo.core.analytics.health.HealthMeasure,4,0,0,4,0,0,0,0,8
KleeGroup_vertigo.io.vertigo.core.locale.MessageText,2,0,0,0,0,0,0,0,2
KleeGroup_vertigo.io.vertigo.core.locale.LocaleManager,6,0,0,2,0,0,0,0,8
KleeGroup_vertigo.io.vertigo.core.resource.ResourceManager,0,0,0,0,0,0,0,0,0
KleeGroup_vertigo.io.vertigo.core.util.Selector,0,0,0,0,0,0,0,0,0
KleeGroup_vertigo.io.vertigo.core.util.ClassUtil,16,0,0,2,0,0,0,0,18
KleeGroup_vertigo.io.vertigo.core.util.StringUtil,20,0,0,4,0,0,0,0,24
KleeGroup_vertigo.io.vertigo.core.util.BeanUtil,0,0,0,0,0,0,0,0,0
KleeGroup_vertigo.io.vertigo.core.util.MapBuilder,2,0,0,2,0,0,0,0,4
KleeGroup_vertigo.io.vertigo.core.daemon.DaemonManager,2,0,0,2,0,0,0,0,4
KleeGroup_vertigo.io.vertigo.core.param.Param,0,0,0,0,0,0,0,0,0
KleeGroup_vertigo.io.vertigo.core.param.ParamManager,0,0,0,0,0,0,0,0,0
KleeGroup_vertigo.io.vertigo.core.node.Node,2,0,0,2,0,0,0,0,4
KleeGroup_vertigo.io.vertigo.core.node.config.yaml.YamlNodeConfigBuilder,6,0,0,6,0,0,0,10,22
KleeGroup_vertigo.io.vertigo.core.node.AutoCloseableNode,4,0,0,0,0,0,0,0,4
KleeGroup_vertigo.io.vertigo.core.node.config.NodeConfigBuilder,4,0,0,4,0,0,0,2,10
KleeGroup_vertigo.io.vertigo.core.node.component.di.DIReactor,16,0,0,16,0,0,0,0,32
KleeGroup_vertigo.io.vertigo.core.lang.Assertion,0,0,0,0,0,0,0,18,18
KleeGroup_vertigo.io.vertigo.core.lang.Either,2,0,0,2,0,0,0,0,4
KleeGroup_vertigo.io.vertigo.core.lang.Tuple,2,0,0,2,0,0,0,0,4
KleeGroup_vertigo.io.vertigo.core.node.definition.DefinitionSpace,2,0,0,2,0,0,0,0,4
Flow_nbt.com.flowpowered.nbt.CompoundMap,0,0,0,0,0,0,0,3,3
Flow_nbt.com.flowpowered.nbt.stream.EndianSwitchableOutputStream,1,0,0,1,0,0,0,0,2
Flow_nbt.com.flowpowered.nbt.holder.FieldValue,1,0,0,0,0,0,0,0,1
iluwatar_java-design-patterns.com.iluwatar.aggregator.microservices.Aggregator,1,0,0,1,0,0,0,0,2
iluwatar_java-design-patterns.com.iluwatar.information.microservice.InformationController,0,0,0,0,0,0,0,0,0
iluwatar_java-design-patterns.com.iluwatar.inventory.microservice.InventoryController,0,0,0,0,0,0,0,0,0
iluwatar_java-design-patterns.com.iluwatar.promise.PromiseSupport,5,0,0,5,0,2,0,0,12
iluwatar_java-design-patterns.com.iluwatar.promise.Promise,0,0,0,0,0,0,0,1,1
iluwatar_java-design-patterns.com.iluwatar.masterworker.ArrayInput,0,0,0,0,0,0,0,0,0
iluwatar_java-design-patterns.com.iluwatar.masterworker.ArrayUtilityMethods,0,0,0,0,0,0,0,0,0
iluwatar_java-design-patterns.com.iluwatar.masterworker.system.MasterWorker,0,0,0,0,0,0,0,0,0
iluwatar_java-design-patterns.com.iluwatar.masterworker.system.systemworkers.ArrayTransposeWorker,0,0,0,0,0,0,0,0,0
iluwatar_java-design-patterns.com.iluwatar.gameloop.VariableStepGameLoop,0,0,0,0,0,0,0,0,0
iluwatar_java-design-patterns.com.iluwatar.gameloop.GameController,0,0,0,0,0,0,0,0,0
iluwatar_java-design-patterns.com.iluwatar.gameloop.FixedStepGameLoop,0,0,0,0,0,0,0,0,0
iluwatar_java-design-patterns.com.iluwatar.gameloop.FrameBasedGameLoop,0,0,0,0,0,0,0,0,0
iluwatar_java-design-patterns.com.iluwatar.gameloop.GameLoop,0,0,0,0,0,0,0,0,0
iluwatar_java-design-patterns.com.iluwatar.monad.Validator,0,0,0,0,0,0,0,0,0
iluwatar_java-design-patterns.com.iluwatar.throttling.CallsCount,0,0,0,0,0,0,0,0,0
iluwatar_java-design-patterns.com.iluwatar.templatemethod.StealingMethod,3,0,0,0,0,0,0,0,3
iluwatar_java-design-patterns.com.iluwatar.templatemethod.HalflingThief,0,0,0,0,0,0,0,2,2
iluwatar_java-design-patterns.com.iluwatar.domainmodel.Product,1,0,0,0,0,0,0,1,2
iluwatar_java-design-patterns.com.iluwatar.domainmodel.ProductDao,3,0,0,0,0,0,0,0,3
iluwatar_java-design-patterns.com.iluwatar.domainmodel.CustomerDao,4,0,0,0,0,0,0,0,4
iluwatar_java-design-patterns.com.iluwatar.domainmodel.Customer,2,0,0,0,0,0,0,1,3
iluwatar_java-design-patterns.com.iluwatar.chain.OrcKing,0,0,0,0,0,0,0,0,0
iluwatar_java-design-patterns.com.iluwatar.mediator.PartyImpl,0,0,0,0,0,0,0,1,1
iluwatar_java-design-patterns.com.iluwatar.tls.Result,0,0,0,0,0,0,0,0,0
iluwatar_java-design-patterns.com.iluwatar.updatemethod.World,0,0,0,0,0,0,0,0,0
iluwatar_java-design-patterns.com.iluwatar.updatemethod.Skeleton,2,0,0,0,0,0,0,0,2
iluwatar_java-design-patterns.com.iluwatar.updatemethod.Statue,0,0,0,0,0,0,0,0,0
iluwatar_java-design-patterns.com.iluwatar.factory.CoinFactory,0,0,0,0,0,0,0,0,0
iluwatar_java-design-patterns.com.iluwatar.spatialpartition.Rect,2,0,0,0,0,0,0,0,2
iluwatar_java-design-patterns.com.iluwatar.spatialpartition.Bubble,4,0,0,0,0,0,0,0,4
iluwatar_java-design-patterns.com.iluwatar.spatialpartition.SpatialPartitionBubbles,1,0,0,1,0,0,0,0,2
iluwatar_java-design-patterns.com.iluwatar.repository.PersonRepository,4,0,0,0,0,0,0,0,4
iluwatar_java-design-patterns.com.iluwatar.event.sourcing.processor.DomainEventProcessor,1,0,0,1,0,0,0,0,2
iluwatar_java-design-patterns.com.iluwatar.iterator.bst.BstIterator,2,0,0,2,0,0,0,0,4
iluwatar_java-design-patterns.com.iluwatar.versionnumber.BookRepository,2,0,0,2,0,1,0,0,5
iluwatar_java-design-patterns.com.iluwatar.datatransfer.customer.CustomerResource,2,0,0,1,0,0,0,0,3
iluwatar_java-design-patterns.com.iluwatar.state.Mammoth,2,0,0,1,0,0,0,0,3
iluwatar_java-design-patterns.com.iluwatar.doubledispatch.Rectangle,1,0,0,0,0,0,0,0,1
iluwatar_java-design-patterns.com.iluwatar.doubledispatch.GameObject,4,0,0,4,0,0,0,0,8
iluwatar_java-design-patterns.com.iluwatar.eda.event.AbstractEvent,0,0,0,0,0,0,0,0,0
iluwatar_java-design-patterns.com.iluwatar.twin.BallItem,1,0,0,0,0,0,0,1,2
iluwatar_java-design-patterns.com.iluwatar.twin.GameItem,1,0,0,0,0,0,0,0,1
iluwatar_java-design-patterns.com.iluwatar.saga.choreography.ServiceDiscoveryService,1,0,0,1,0,0,0,0,2
iluwatar_java-design-patterns.com.iluwatar.datamapper.StudentDataMapperImpl,1,0,0,1,0,0,0,0,2
iluwatar_java-design-patterns.com.iluwatar.abstractdocument.domain.HasType,1,0,0,1,0,0,0,0,2
iluwatar_java-design-patterns.com.iluwatar.abstractdocument.domain.HasModel,1,0,0,1,0,0,0,0,2
iluwatar_java-design-patterns.com.iluwatar.abstractdocument.AbstractDocument,2,0,0,0,0,0,0,0,2
iluwatar_java-design-patterns.com.iluwatar.command.Wizard,0,0,0,0,0,0,0,1,1
iluwatar_java-design-patterns.com.iluwatar.flyweight.AlchemistShop,1,0,0,1,0,0,0,0,2
iluwatar_java-design-patterns.com.iluwatar.servicelocator.ServiceLocator,2,0,0,1,0,0,0,0,3
iluwatar_java-design-patterns.com.iluwatar.typeobject.CandyGame,0,0,0,0,0,0,0,0,0
iluwatar_java-design-patterns.com.iluwatar.typeobject.Cell,0,0,0,0,0,0,0,0,0
iluwatar_java-design-patterns.com.iluwatar.memento.Star,2,0,0,2,0,0,0,0,4
iluwatar_java-design-patterns.com.iluwatar.model.view.controller.GiantModel,3,0,0,3,0,0,0,0,6
iluwatar_java-design-patterns.com.iluwatar.model.view.controller.GiantView,1,0,0,0,0,0,0,0,1
iluwatar_java-design-patterns.com.iluwatar.model.view.controller.GiantController,0,0,0,0,0,0,0,4,4
iluwatar_java-design-patterns.com.iluwatar.specialcase.MaintenanceLock,1,0,0,1,0,0,0,0,2
iluwatar_java-design-patterns.com.iluwatar.specialcase.ApplicationServices,4,0,0,4,0,0,0,0,8
iluwatar_java-design-patterns.com.iluwatar.subclasssandbox.Superpower,0,0,0,0,0,0,0,0,0
iluwatar_java-design-patterns.com.iluwatar.monitor.Bank,1,0,0,1,0,0,0,0,2
iluwatar_java-design-patterns.com.iluwatar.collectionpipeline.ImperativeProgramming,0,0,0,0,0,0,0,0,0
iluwatar_java-design-patterns.com.iluwatar.collectionpipeline.FunctionalProgramming,2,0,0,2,0,0,0,0,4
iluwatar_java-design-patterns.com.iluwatar.monostate.LoadBalancer,1,0,0,1,0,0,0,1,3
iluwatar_java-design-patterns.com.iluwatar.nullobject.Node,3,0,0,2,0,0,0,0,5
iluwatar_java-design-patterns.com.iluwatar.nullobject.NullNode,2,0,0,1,0,0,0,0,3
iluwatar_java-design-patterns.com.iluwatar.module.FileLoggerModule,0,0,0,0,0,0,0,0,0
iluwatar_java-design-patterns.com.iluwatar.strategy.DragonSlayer,0,0,0,0,0,0,0,2,2
iluwatar_java-design-patterns.com.iluwatar.multiton.Nazgul,1,0,0,1,0,0,0,0,2
iluwatar_java-design-patterns.com.iluwatar.filterer.threat.SimpleProbabilisticThreatAwareSystem,1,0,0,1,0,0,0,0,2
iluwatar_java-design-patterns.com.iluwatar.filterer.threat.SimpleThreatAwareSystem,1,0,0,1,0,0,0,0,2
iluwatar_java-design-patterns.com.iluwatar.composite.Messenger,0,0,0,0,0,0,0,2,2
iluwatar_java-design-patterns.com.iluwatar.threadpool.Task,0,0,0,0,0,0,0,0,0
iluwatar_java-design-patterns.com.iluwatar.threadpool.Worker,0,0,0,0,0,0,0,1,1
iluwatar_java-design-patterns.com.iluwatar.decorator.SimpleTroll,1,0,0,1,0,0,0,0,2
iluwatar_java-design-patterns.com.iluwatar.decorator.ClubbedTroll,0,0,0,0,0,0,0,0,0
iluwatar_java-design-patterns.com.iluwatar.guarded.suspension.GuardedQueue,0,0,0,0,0,0,0,0,0
iluwatar_java-design-patterns.com.iluwatar.reader.writer.lock.ReaderWriterLock,4,0,0,2,0,0,0,0,6
iluwatar_java-design-patterns.com.iluwatar.model.view.viewmodel.BookViewModel,2,0,0,2,0,0,0,0,4
iluwatar_java-design-patterns.com.iluwatar.callback.Task,1,0,0,0,0,0,0,0,1
iluwatar_java-design-patterns.com.iluwatar.doublebuffer.FrameBuffer,3,0,0,0,0,3,0,0,6
iluwatar_java-design-patterns.com.iluwatar.doublebuffer.Scene,2,0,0,0,0,2,0,0,4
iluwatar_java-design-patterns.com.iluwatar.servant.Queen,0,0,0,0,0,0,0,0,0
iluwatar_java-design-patterns.com.iluwatar.servant.Servant,1,0,0,0,0,0,0,3,4
iluwatar_java-design-patterns.com.iluwatar.servant.King,0,0,0,0,0,0,0,0,0
iluwatar_java-design-patterns.com.iluwatar.delegation.simple.PrinterController,0,0,0,0,0,0,0,0,0
iluwatar_java-design-patterns.com.iluwatar.queue.load.leveling.MessageQueue,0,0,0,0,0,0,0,0,0
iluwatar_java-design-patterns.com.iluwatar.serverless.baas.api.FindPersonApiHandler,0,0,0,0,0,0,0,1,1
iluwatar_java-design-patterns.com.iluwatar.serverless.baas.api.SavePersonApiHandler,2,0,0,0,0,0,0,0,2
iluwatar_java-design-patterns.com.iluwatar.serverless.faas.api.LambdaInfoApiHandler,0,0,0,0,0,0,0,0,0
iluwatar_java-design-patterns.com.iluwatar.adapter.Captain,0,0,0,0,0,0,0,1,1
iluwatar_java-design-patterns.com.iluwatar.databus.DataBus,0,0,0,0,0,0,0,2,2
iluwatar_java-design-patterns.com.iluwatar.databus.members.MessageCollectorMember,0,0,0,0,0,0,0,0,0
iluwatar_java-design-patterns.com.iluwatar.databus.members.StatusMember,1,0,0,0,0,0,0,0,1
iluwatar_java-design-patterns.com.iluwatar.trampoline.TrampolineApp,0,0,0,0,0,0,0,0,0
iluwatar_java-design-patterns.com.iluwatar.leaderfollowers.WorkCenter,2,0,0,2,0,0,0,0,4
iluwatar_java-design-patterns.com.iluwatar.leaderfollowers.TaskSet,1,0,0,1,0,0,0,0,2
iluwatar_java-design-patterns.com.iluwatar.leaderfollowers.TaskHandler,0,0,0,0,0,0,0,0,0
iluwatar_java-design-patterns.com.iluwatar.caching.App,0,0,0,0,0,0,0,0,0
iluwatar_java-design-patterns.com.iluwatar.caching.database.MongoDb,0,0,0,0,0,0,0,0,0
iluwatar_java-design-patterns.com.iluwatar.producer.consumer.Consumer,0,0,0,0,0,0,0,1,1
iluwatar_java-design-patterns.com.iluwatar.combinator.Finder,4,0,0,1,0,0,0,0,5
iluwatar_java-design-patterns.com.iluwatar.combinator.Finders,1,0,0,1,0,0,0,0,2
iluwatar_java-design-patterns.com.iluwatar.ambassador.Client,0,0,0,0,0,0,0,0,0
iluwatar_java-design-patterns.com.iluwatar.ambassador.RemoteService,0,0,0,0,0,0,0,0,0
iluwatar_java-design-patterns.com.iluwatar.ambassador.ServiceAmbassador,0,0,0,0,0,0,0,0,0
iluwatar_java-design-patterns.com.iluwatar.fanout.fanin.SquareNumberRequest,0,0,0,0,0,0,0,0,0
iluwatar_java-design-patterns.com.iluwatar.fanout.fanin.FanOutFanIn,0,0,0,0,0,0,0,0,0
iluwatar_java-design-patterns.com.iluwatar.acyclicvisitor.Hayes,0,0,0,0,0,0,0,2,2
iluwatar_java-design-patterns.com.iluwatar.acyclicvisitor.ConfigureForDosVisitor,0,0,0,0,0,0,0,0,0
iluwatar_java-design-patterns.com.iluwatar.acyclicvisitor.Zoom,0,0,0,0,0,0,0,2,2
iluwatar_java-design-patterns.com.iluwatar.acyclicvisitor.ConfigureForUnixVisitor,0,0,0,0,0,0,0,0,0
iluwatar_java-design-patterns.com.iluwatar.commander.Commander,2,0,0,0,0,0,0,0,2
iluwatar_java-design-patterns.com.iluwatar.factorykit.WeaponFactory,0,0,0,0,0,0,0,3,3
iluwatar_java-design-patterns.com.iluwatar.hexagonal.banking.MongoBank,1,0,0,1,0,0,0,0,2
iluwatar_java-design-patterns.com.iluwatar.hexagonal.banking.WireTransfers,1,0,0,1,0,0,0,0,2
iluwatar_java-design-patterns.com.iluwatar.hexagonal.eventlog.MongoEventLog,1,0,0,1,0,0,0,0,2
iluwatar_java-design-patterns.com.iluwatar.hexagonal.domain.LotteryAdministration,1,1,0,1,0,0,0,0,3
iluwatar_java-design-patterns.com.iluwatar.hexagonal.domain.LotteryNumbers,3,0,0,1,0,0,0,0,4
iluwatar_java-design-patterns.com.iluwatar.hexagonal.database.InMemoryTicketRepository,1,0,0,1,0,0,0,0,2
iluwatar_java-design-patterns.com.iluwatar.hexagonal.database.MongoTicketRepository,3,0,0,2,0,0,0,0,5
iluwatar_java-design-patterns.com.iluwatar.flux.dispatcher.Dispatcher,2,0,0,1,0,0,0,0,3
iluwatar_java-design-patterns.com.iluwatar.flux.store.ContentStore,0,0,0,0,0,0,0,0,0
iluwatar_java-design-patterns.com.iluwatar.flux.store.MenuStore,0,0,0,0,0,0,0,0,0
iluwatar_java-design-patterns.com.iluwatar.flux.view.MenuView,0,0,0,0,0,0,0,2,2
iluwatar_java-design-patterns.com.iluwatar.flux.view.ContentView,0,0,0,0,0,0,0,1,1
iluwatar_java-design-patterns.com.iluwatar.pageobject.LoginPage,0,0,0,0,0,0,0,0,0
iluwatar_java-design-patterns.com.iluwatar.pageobject.AlbumPage,0,0,0,0,0,0,0,0,0
iluwatar_java-design-patterns.com.iluwatar.pageobject.AlbumListPage,0,0,0,0,0,0,0,0,0
iluwatar_java-design-patterns.com.iluwatar.tolerantreader.RainbowFishSerializer,2,0,0,2,0,0,0,0,4
iluwatar_java-design-patterns.com.iluwatar.cqrs.queries.IQueryService,3,0,0,0,0,0,0,0,3
iluwatar_java-design-patterns.com.iluwatar.singleton.ThreadSafeDoubleCheckLocking,0,0,0,0,0,0,0,0,0
iluwatar_java-design-patterns.com.iluwatar.eip.aggregator.routes.MessageAggregationStrategy,1,0,0,0,0,0,0,0,1
iluwatar_java-design-patterns.com.iluwatar.priority.queue.PriorityMessageQueue,2,0,0,2,0,0,0,0,4
iluwatar_java-design-patterns.com.iluwatar.priority.queue.QueueManager,0,0,0,0,0,0,0,0,0
iluwatar_java-design-patterns.com.iluwatar.balking.WashingMachine,1,0,0,1,0,0,0,0,2
iluwatar_java-design-patterns.com.iluwatar.circuitbreaker.DefaultCircuitBreaker,1,0,0,1,0,0,0,0,2
iluwatar_java-design-patterns.com.iluwatar.circuitbreaker.MonitoringService,3,0,0,3,0,0,0,0,6
iluwatar_java-design-patterns.com.iluwatar.circuitbreaker.DelayedRemoteService,0,0,0,0,0,0,0,0,0
iluwatar_java-design-patterns.com.iluwatar.property.Character,5,0,0,5,0,0,0,0,10
iluwatar_java-design-patterns.com.iluwatar.registry.CustomerRegistry,1,0,0,1,0,0,0,0,2
iluwatar_java-design-patterns.com.iluwatar.featuretoggle.user.UserGroup,0,0,0,0,0,0,0,0,0
iluwatar_java-design-patterns.com.iluwatar.featuretoggle.pattern.Service,0,0,0,0,0,0,0,0,0
iluwatar_java-design-patterns.com.iluwatar.featuretoggle.pattern.propertiesversion.PropertiesFeatureToggleVersion,2,0,0,0,0,0,0,0,2
iluwatar_java-design-patterns.com.iluwatar.event.asynchronous.EventManager,4,0,0,4,0,0,0,0,8
iluwatar_java-design-patterns.com.iluwatar.arrangeactassert.Cash,4,0,0,4,0,0,0,0,8
iluwatar_java-design-patterns.com.iluwatar.visitor.Unit,0,0,0,0,0,0,0,1,1
iluwatar_java-design-patterns.com.iluwatar.visitor.UnitVisitor,3,3,0,0,0,0,0,0,6
iluwatar_java-design-patterns.com.iluwatar.facade.DwarvenGoldmineFacade,1,0,0,1,0,0,0,0,2
iluwatar_java-design-patterns.com.iluwatar.event.queue.Audio,2,0,0,2,0,0,0,0,4
iluwatar_java-design-patterns.com.iluwatar.intercepting.filter.FilterManager,0,0,0,0,0,0,0,0,0
iluwatar_java-design-patterns.com.iluwatar.intercepting.filter.Order,0,0,0,0,0,0,0,0,0
iluwatar_java-design-patterns.com.iluwatar.roleobject.BorrowerRole,0,0,0,0,0,0,0,0,0
iluwatar_java-design-patterns.com.iluwatar.roleobject.InvestorRole,0,0,0,0,0,0,0,0,0
iluwatar_java-design-patterns.com.iluwatar.roleobject.CustomerCore,4,0,0,3,0,0,0,0,7
iluwatar_java-design-patterns.com.iluwatar.proxy.Wizard,0,0,0,0,0,0,0,0,0
iluwatar_java-design-patterns.com.iluwatar.parameter.object.SearchService,1,0,0,1,0,0,0,0,2
iluwatar_java-design-patterns.com.iluwatar.parameter.object.ParameterObject,0,0,0,0,0,0,0,0,0
iluwatar_java-design-patterns.com.iluwatar.fluentinterface.fluentiterable.FluentIterable,10,0,0,4,0,0,0,0,14
iluwatar_java-design-patterns.com.iluwatar.builder.Hero,1,0,0,1,0,0,0,0,2
iluwatar_java-design-patterns.domainapp.dom.modules.simple.SimpleObjects,1,0,0,1,0,0,0,0,2
iluwatar_java-design-patterns.domainapp.dom.modules.simple.SimpleObject,1,0,0,1,0,0,0,2,4
iluwatar_java-design-patterns.domainapp.fixture.scenarios.RecreateSimpleObjects,1,0,0,1,0,0,0,0,2
iluwatar_java-design-patterns.com.iluwatar.sharding.ShardManager,2,0,0,1,0,2,0,0,5
iluwatar_java-design-patterns.com.iluwatar.sharding.LookupShardManager,1,0,0,0,0,1,0,0,2
iluwatar_java-design-patterns.com.iluwatar.sharding.RangeShardManager,0,0,0,0,0,0,0,0,0
iluwatar_java-design-patterns.com.iluwatar.sharding.Shard,2,0,0,0,0,2,0,0,4
iluwatar_java-design-patterns.com.iluwatar.sharding.HashShardManager,0,0,0,0,0,0,0,0,0
iluwatar_java-design-patterns.com.iluwatar.retry.RetryExponentialBackoff,0,0,0,0,0,3,0,0,3
iluwatar_java-design-patterns.com.iluwatar.retry.Retry,0,0,0,0,0,3,0,0,3
iluwatar_java-design-patterns.com.iluwatar.retry.FindCustomer,0,0,0,0,0,0,0,0,0
iluwatar_java-design-patterns.com.iluwatar.specification.selector.MassSmallerThanOrEqSelector,1,0,0,0,0,0,0,0,1
iluwatar_java-design-patterns.com.iluwatar.specification.selector.ColorSelector,1,0,0,0,0,0,0,0,1
iluwatar_java-design-patterns.com.iluwatar.specification.selector.SizeSelector,1,0,0,0,0,0,0,0,1
iluwatar_java-design-patterns.com.iluwatar.specification.selector.AbstractSelector,1,0,0,0,0,0,0,0,1
iluwatar_java-design-patterns.com.iluwatar.specification.selector.MovementSelector,1,0,0,0,0,0,0,0,1
iluwatar_java-design-patterns.com.iluwatar.leaderelection.bully.BullyMessageManager,3,0,0,2,0,3,0,0,8
iluwatar_java-design-patterns.com.iluwatar.leaderelection.AbstractInstance,4,0,0,0,0,4,0,0,8
iluwatar_java-design-patterns.com.iluwatar.leaderelection.ring.RingMessageManager,3,0,0,0,0,3,0,0,6
iluwatar_java-design-patterns.com.iluwatar.halfsynchalfasync.AsyncTask,0,0,0,0,0,0,0,2,2
iluwatar_java-design-patterns.com.iluwatar.lockableobject.domain.Creature,3,0,0,2,0,0,0,0,5
iluwatar_java-design-patterns.com.iluwatar.lockableobject.Lockable,1,0,0,1,0,0,0,0,2
iluwatar_java-design-patterns.com.iluwatar.lockableobject.SwordOfAragorn,1,0,0,1,0,0,0,0,2
iluwatar_java-design-patterns.com.iluwatar.factory.method.OrcBlacksmith,0,0,0,0,0,0,0,2,2
iluwatar_java-design-patterns.com.iluwatar.factory.method.ElfBlacksmith,0,0,0,0,0,0,0,2,2
iluwatar_java-design-patterns.com.iluwatar.abstractfactory.App,5,0,0,5,0,0,0,0,10
iluwatar_java-design-patterns.com.iluwatar.dirtyflag.DataFetcher,0,0,0,0,0,0,0,0,0
iluwatar_java-design-patterns.com.iluwatar.mute.Mute,0,0,0,0,0,0,0,0,0
iluwatar_java-design-patterns.units.Unit,1,0,0,0,0,0,0,0,1
iluwatar_java-design-patterns.units.SoldierUnit,1,0,0,0,0,0,0,0,1
iluwatar_java-design-patterns.units.CommanderUnit,1,0,0,0,0,0,0,0,1
iluwatar_java-design-patterns.units.SergeantUnit,1,0,0,0,0,0,0,0,1
iluwatar_java-design-patterns.concreteextensions.Soldier,1,0,0,0,0,0,0,0,1
iluwatar_java-design-patterns.concreteextensions.Commander,1,0,0,0,0,0,0,0,1
iluwatar_java-design-patterns.concreteextensions.Sergeant,1,0,0,0,0,0,0,0,1
iluwatar_java-design-patterns.com.iluwatar.partialresponse.FieldJsonMapper,0,0,0,0,0,0,0,0,0
iluwatar_java-design-patterns.com.iluwatar.bytecode.VirtualMachine,3,0,0,0,0,0,0,0,3
iluwatar_java-design-patterns.com.iluwatar.bytecode.util.InstructionConverterUtil,1,0,0,0,0,0,0,0,1
iluwatar_java-design-patterns.com.iluwatar.poison.pill.Consumer,1,0,0,1,0,0,0,0,2
iluwatar_java-design-patterns.com.iluwatar.poison.pill.SimpleMessage,1,0,0,1,0,0,0,0,2
iluwatar_java-design-patterns.com.iluwatar.poison.pill.Producer,2,0,0,1,0,1,0,0,4
iluwatar_java-design-patterns.com.iluwatar.compositeentity.ConsoleCoarseGrainedObject,2,0,0,2,0,0,0,0,4
iluwatar_java-design-patterns.com.iluwatar.stepbuilder.CharacterStepBuilder,6,0,0,6,0,0,0,0,12
iluwatar_java-design-patterns.com.iluwatar.separatedinterface.taxes.ForeignTaxCalculator,0,0,0,0,0,0,0,0,0
iluwatar_java-design-patterns.com.iluwatar.separatedinterface.taxes.DomesticTaxCalculator,0,0,0,0,0,0,0,0,0
iluwatar_java-design-patterns.com.iluwatar.separatedinterface.invoice.InvoiceGenerator,0,0,0,0,0,0,0,0,0
iluwatar_java-design-patterns.com.iluwatar.layers.service.CakeBakingServiceImpl,5,0,0,5,0,0,0,0,10
iluwatar_java-design-patterns.com.iluwatar.layers.view.CakeViewImpl,1,0,0,1,0,0,0,0,2
iluwatar_java-design-patterns.com.iluwatar.layers.entity.Cake,4,0,0,4,0,0,0,0,8
iluwatar_java-design-patterns.com.iluwatar.compositeview.AppServlet,0,0,0,0,0,0,0,1,1
iluwatar_java-design-patterns.com.iluwatar.observer.Weather,1,0,0,1,0,0,0,1,3
iluwatar_java-design-patterns.com.iluwatar.observer.generic.GWeather,1,0,0,0,0,0,0,1,2
iluwatar_java-design-patterns.com.iluwatar.servicelayer.common.DaoBaseImpl,3,0,0,2,0,0,0,0,5
iluwatar_java-design-patterns.com.iluwatar.servicelayer.common.BaseEntity,2,0,0,2,0,0,0,0,4
iluwatar_java-design-patterns.com.iluwatar.servicelayer.magic.MagicServiceImpl,2,0,0,0,0,0,0,3,5
iluwatar_java-design-patterns.com.iluwatar.dependency.injection.SimpleWizard,1,0,0,0,0,0,0,0,1
iluwatar_java-design-patterns.com.iluwatar.dependency.injection.GuiceWizard,1,0,0,0,0,0,0,0,1
iluwatar_java-design-patterns.com.iluwatar.dependency.injection.AdvancedWizard,1,0,0,0,0,0,0,0,1
iluwatar_java-design-patterns.com.iluwatar.dependency.injection.AdvancedSorceress,1,0,0,0,0,0,0,0,1
iluwatar_java-design-patterns.com.iluwatar.model.view.presenter.FileLoader,0,0,0,0,0,0,0,0,0
iluwatar_java-design-patterns.com.iluwatar.model.view.presenter.FileSelectorPresenter,4,0,0,4,0,0,0,0,8
iluwatar_java-design-patterns.com.iluwatar.tablemodule.UserTableModule,0,0,0,0,0,0,0,0,0
iluwatar_java-design-patterns.com.iluwatar.objectmother.RoyaltyObjectMother,2,0,0,2,0,0,0,0,4
iluwatar_java-design-patterns.com.iluwatar.activeobject.ActiveCreature,1,0,0,1,0,0,0,0,2
iluwatar_java-design-patterns.com.iluwatar.reactor.app.App,2,0,0,2,0,0,0,0,4
iluwatar_java-design-patterns.com.iluwatar.presentation.DisplayedAlbums,0,0,0,0,0,0,0,0,0
iluwatar_java-design-patterns.com.iluwatar.presentation.View,2,0,0,2,0,0,0,0,4
iluwatar_java-design-patterns.com.iluwatar.presentation.PresentationModel,0,0,0,0,0,0,0,0,0
iluwatar_java-design-patterns.com.iluwatar.unitofwork.ArmsDealer,0,0,0,0,0,0,0,6,6
iluwatar_java-design-patterns.com.iluwatar.business.delegate.MobileClient,0,0,0,0,0,0,0,1,1
iluwatar_java-design-patterns.com.iluwatar.transactionscript.Hotel,1,0,0,1,0,0,0,0,2
iluwatar_java-design-patterns.com.iluwatar.transactionscript.HotelDaoImpl,0,0,0,0,0,0,0,0,0
iluwatar_java-design-patterns.com.iluwatar.privateclassdata.ImmutableStew,1,0,0,0,0,0,0,0,1
iluwatar_java-design-patterns.com.iluwatar.privateclassdata.Stew,2,0,0,1,0,0,0,0,3
iluwatar_java-design-patterns.com.iluwatar.image.microservice.ImageController,0,0,0,0,0,0,0,0,0
iluwatar_java-design-patterns.com.iluwatar.api.gateway.ApiGateway,1,0,0,1,0,0,0,0,2
iluwatar_java-design-patterns.com.iluwatar.price.microservice.PriceController,0,0,0,0,0,0,0,0,0
iluwatar_java-design-patterns.com.iluwatar.event.aggregator.KingJoffrey,1,0,0,0,0,0,0,0,1
iluwatar_java-design-patterns.com.iluwatar.event.aggregator.KingsHand,0,0,0,0,0,0,0,1,1
zafarkhaja_jsemver.com.github.zafarkhaja.semver.VersionParser,1,1,0,1,0,2,0,0,5
zafarkhaja_jsemver.com.github.zafarkhaja.semver.util.Stream,9,0,0,4,0,0,0,0,13
zafarkhaja_jsemver.com.github.zafarkhaja.semver.Parser,1,0,0,1,0,1,0,0,3
zafarkhaja_jsemver.com.github.zafarkhaja.semver.expr.Not,1,0,0,0,0,0,0,0,1
zafarkhaja_jsemver.com.github.zafarkhaja.semver.expr.Lexer,0,0,0,0,0,0,0,0,0
zafarkhaja_jsemver.com.github.zafarkhaja.semver.expr.Less,1,0,0,1,0,0,0,0,2
zafarkhaja_jsemver.com.github.zafarkhaja.semver.expr.Or,0,0,0,0,0,0,0,0,0
zafarkhaja_jsemver.com.github.zafarkhaja.semver.expr.Greater,1,0,0,1,0,0,0,0,2
zafarkhaja_jsemver.com.github.zafarkhaja.semver.expr.NotEqual,1,0,0,1,0,0,0,0,2
zafarkhaja_jsemver.com.github.zafarkhaja.semver.expr.And,0,0,0,0,0,0,0,0,0
zafarkhaja_jsemver.com.github.zafarkhaja.semver.expr.Equal,1,0,0,1,0,0,0,0,2
zafarkhaja_jsemver.com.github.zafarkhaja.semver.expr.CompositeExpression,9,0,0,3,0,0,0,0,12
zafarkhaja_jsemver.com.github.zafarkhaja.semver.expr.ExpressionParser,14,0,0,14,0,0,0,0,28
zafarkhaja_jsemver.com.github.zafarkhaja.semver.expr.GreaterOrEqual,1,0,0,1,0,0,0,0,2
zafarkhaja_jsemver.com.github.zafarkhaja.semver.expr.LessOrEqual,1,0,0,1,0,0,0,0,2
spring-projects_spring-sync.org.springframework.sync.DiffTest,14,0,0,0,0,0,0,0,14
spring-projects_spring-sync.org.springframework.sync.JsonPatchTest,3,0,0,0,0,2,0,0,5
dschulten_hydra-java.de.escalon.hypermedia.hydra.serialize.LdContext,1,0,0,0,0,0,0,0,1
WhisperSystems_PushServer.org.whispersystems.pushserver.entities.UnregisteredEventList,2,0,0,2,0,0,0,0,4
ic3fox_jawr-main-repo.net.jawr.web.test.utils.Utils,9,0,0,2,0,0,0,0,11
ic3fox_jawr-main-repo.net.jawr.web.test.AbstractPageTest,65,1,0,59,0,0,1,77,203
ic3fox_jawr-main-repo.net.jawr.web.resource.bundle.generator.GeneratorMappingHelper,11,0,0,11,0,0,0,0,22
ic3fox_jawr-main-repo.net.jawr.web.resource.handler.reader.ResourceBrowser,3,3,0,2,0,0,0,15,23
ic3fox_jawr-main-repo.net.jawr.web.resource.bundle.variant.resolver.BrowserResolver,0,0,0,0,0,0,0,0,0
ic3fox_jawr-main-repo.net.jawr.web.resource.bundle.JoinableResourceBundlePropertySerializer,1,0,0,1,0,0,0,0,2
ic3fox_jawr-main-repo.net.jawr.web.resource.bundle.generator.GeneratorRegistry,22,7,0,20,0,2,0,0,51
ic3fox_jawr-main-repo.net.jawr.web.resource.bundle.JoinableResourceBundleImpl,6,0,0,6,0,0,0,0,12
ic3fox_jawr-main-repo.net.jawr.web.resource.bundle.JoinableResourceBundle,3,1,0,2,0,0,0,1,7
ic3fox_jawr-main-repo.net.jawr.web.resource.bundle.factory.util.PathNormalizer,9,0,0,1,0,0,0,0,10
ic3fox_jawr-main-repo.net.jawr.web.resource.bundle.factory.util.PropsFilePropertiesSource,0,0,0,0,0,0,0,0,0
ic3fox_jawr-main-repo.net.jawr.web.resource.bundle.factory.mapper.OrphanResourceBundlesMapper,1,0,0,1,0,1,0,0,3
ic3fox_jawr-main-repo.net.jawr.web.config.JawrConfig,17,4,0,11,0,5,0,4,41
ic3fox_jawr-main-repo.net.jawr.web.resource.bundle.generator.AbstractCachedGenerator,11,1,0,11,0,0,2,0,25
ic3fox_jawr-main-repo.net.jawr.web.resource.bundle.global.postprocessor.google.closure.ClosureGlobalPostProcessor,0,0,0,0,0,0,0,4,4
ic3fox_jawr-main-repo.net.jawr.web.resource.bundle.renderer.JavascriptHTMLBundleLinkRenderer,11,0,0,11,0,0,0,0,22
ic3fox_jawr-main-repo.net.jawr.web.resource.bundle.handler.ClientSideHandlerGeneratorImpl,0,0,0,0,0,0,0,0,0
ic3fox_jawr-main-repo.net.jawr.web.resource.bundle.css.CssImageUrlRewriter,0,0,0,0,0,0,0,0,0
ic3fox_jawr-main-repo.net.jawr.web.resource.bundle.css.CssDebugUrlRewriter,0,0,0,0,0,0,0,0,0
ic3fox_jawr-main-repo.net.jawr.web.resource.bundle.generator.resolver.WebJarsLocatorPathResolver,0,0,0,0,0,0,0,0,0
ic3fox_jawr-main-repo.net.jawr.web.resource.handler.reader.ResourceReaderHandler,4,0,0,4,0,0,0,0,8
ic3fox_jawr-main-repo.net.jawr.web.resource.bundle.generator.GeneratorContext,12,0,0,12,0,0,1,0,25
ic3fox_jawr-main-repo.net.jawr.web.resource.bundle.generator.classpath.ClassPathCSSGenerator,2,0,0,0,0,0,0,0,2
ic3fox_jawr-main-repo.net.jawr.web.resource.bundle.generator.classpath.ClasspathJSGenerator,2,0,0,0,0,0,0,0,2
ic3fox_jawr-main-repo.net.jawr.web.resource.bundle.generator.classpath.ClassPathBinaryResourceGenerator,1,0,0,0,0,0,0,0,1
ic3fox_jawr-main-repo.net.jawr.web.resource.bundle.generator.classpath.ClassPathGeneratorHelper,3,0,0,0,0,0,0,0,3
ic3fox_jawr-main-repo.net.jawr.web.resource.bundle.generator.IECssBundleGenerator,0,0,0,0,0,0,0,0,0
ic3fox_jawr-main-repo.net.jawr.web.resource.bundle.postprocess.BundleProcessingStatus,0,0,0,0,0,0,0,0,0
ic3fox_jawr-main-repo.net.jawr.web.resource.bundle.postprocess.AbstractChainedResourceBundlePostProcessor,2,1,0,0,0,1,0,0,4
ic3fox_jawr-main-repo.net.jawr.web.resource.bundle.postprocess.impl.js.uglify.UglifyJS,0,4,0,0,0,0,0,0,4
ic3fox_jawr-main-repo.net.jawr.web.util.ServletContextUtils,0,0,0,0,0,0,0,0,0
ic3fox_jawr-main-repo.net.jawr.web.resource.handler.reader.grails.GrailsServletContextResourceReader,0,0,0,0,0,0,0,0,0
ic3fox_jawr-main-repo.net.jawr.web.bundle.processor.BundleProcessor,0,0,0,0,0,0,0,5,5
red5_red5-websocket.org.red5.net.websocket.WebSocketPlugin,0,0,0,0,0,0,0,2,2
red5_red5-websocket.org.red5.net.websocket.model.WSMessage,5,0,0,5,0,0,0,0,10
red5_red5-websocket.org.red5.net.websocket.model.Packet,2,0,0,2,0,0,0,0,4
tkurz_sesame-vocab-builder.com.github.tkurz.sesame.vocab.VocabBuilder,4,0,0,0,0,1,0,0,5
opendaylight_controller.org.opendaylight.controller.cluster.datastore.shardmanager.TestShardManager,6,0,0,0,0,0,0,0,6
google_google-api-java-client.com.google.api.client.googleapis.mtls.MtlsProvider,1,0,0,0,0,1,0,0,2
google_google-api-java-client.com.google.api.client.googleapis.auth.oauth2.GoogleCredential,1,0,0,0,0,1,0,0,2
audit4j_audit4j-core.org.audit4j.core.ConcurrentConfigurationContext,5,0,0,5,0,0,0,6,16
audit4j_audit4j-core.org.audit4j.core.ConfigProvider,0,0,0,0,0,0,0,0,0
audit4j_audit4j-core.org.audit4j.core.annotation.DeIdentifyUtil,0,0,0,0,0,0,0,0,0
audit4j_audit4j-core.org.audit4j.core.ValidationManager,0,0,0,0,0,1,0,0,1
audit4j_audit4j-core.org.audit4j.core.dto.AnnotationAuditEvent,0,0,0,0,0,0,0,1,1
audit4j_audit4j-core.org.audit4j.core.extra.scannotation.AnnotationDB,0,0,0,0,0,0,0,0,0
audit4j_audit4j-core.org.audit4j.core.annotation.AuditAnnotationAttributes,0,0,0,0,0,0,0,0,0
audit4j_audit4j-core.org.audit4j.core.dto.EventBuilder,1,0,0,1,0,0,0,1,3
audit4j_audit4j-core.org.audit4j.core.dto.Event,1,0,0,1,0,0,0,3,5
audit4j_audit4j-core.org.audit4j.core.dto.AuditEvent,6,0,0,6,0,0,0,9,21
audit4j_audit4j-core.org.audit4j.core.dto.Field,3,0,0,3,0,0,0,3,9
audit4j_audit4j-core.org.audit4j.core.exception.ConfigurationException,2,0,0,0,0,0,0,0,2
audit4j_audit4j-core.org.audit4j.core.exception.ValidationException,1,0,0,0,0,0,0,0,1
audit4j_audit4j-core.org.audit4j.core.web.ServletContexConfigSupport,1,0,0,1,0,0,0,0,2
audit4j_audit4j-core.org.audit4j.core.io.BatchProcessStream,3,0,0,2,0,0,0,0,5
audit4j_audit4j-core.org.audit4j.core.layout.SimpleLayout,0,0,0,0,0,0,0,2,2
audit4j_audit4j-core.org.audit4j.core.layout.CustomizableLayout,0,0,0,0,0,0,0,0,0
audit4j_audit4j-core.org.audit4j.core.ObjectSerializer,0,0,0,0,0,0,0,3,3
audit4j_audit4j-core.org.audit4j.core.util.EncryptionUtil,1,0,0,1,0,0,0,0,2
audit4j_audit4j-core.org.audit4j.core.util.EnvUtil,0,0,0,0,0,0,0,0,0
audit4j_audit4j-core.org.audit4j.core.util.JavaVersion,0,0,0,0,0,0,0,0,0
audit4j_audit4j-core.org.audit4j.core.AuditManager,0,0,0,0,0,0,0,12,12
audit4j_audit4j-core.org.audit4j.core.IAuditManager,0,0,0,0,0,0,0,2,2
audit4j_audit4j-core.org.audit4j.core.command.impl.MetadataCommand,0,0,0,0,0,0,0,0,0
OpenHFT_Chronicle-Bytes.net.openhft.chronicle.bytes.internal.NativeBytesStore,5,0,0,4,0,1,0,0,10
OpenHFT_Chronicle-Bytes.net.openhft.chronicle.bytes.Bytes,37,3,0,33,0,8,0,13,94
OpenHFT_Chronicle-Bytes.net.openhft.chronicle.bytes.NativeBytes,21,1,0,21,0,0,0,3,46
OpenHFT_Chronicle-Bytes.net.openhft.chronicle.bytes.BytesStore,26,1,0,16,0,0,0,2,45
OpenHFT_Chronicle-Bytes.net.openhft.chronicle.bytes.ByteStringParser,16,1,0,14,0,0,0,0,31
OpenHFT_Chronicle-Bytes.net.openhft.chronicle.bytes.StreamingDataInput,9,0,0,8,0,0,0,0,17
OpenHFT_Chronicle-Bytes.net.openhft.chronicle.bytes.RandomCommon,5,0,0,5,0,0,0,2,12
OpenHFT_Chronicle-Bytes.net.openhft.chronicle.bytes.ByteStringAppender,1,0,0,1,0,0,0,0,2
OpenHFT_Chronicle-Bytes.net.openhft.chronicle.bytes.MappedBytes,16,0,0,4,0,3,0,3,26
OpenHFT_Chronicle-Bytes.net.openhft.chronicle.bytes.MappedFile,4,0,0,2,0,1,0,0,7
OpenHFT_Chronicle-Bytes.net.openhft.chronicle.bytes.MappedBytesStore,1,0,0,1,0,0,0,0,2
OpenHFT_Chronicle-Bytes.net.openhft.chronicle.bytes.StreamingDataOutput,10,0,0,10,0,1,0,2,23
OpenHFT_Chronicle-Bytes.net.openhft.chronicle.bytes.BytesMarshallable,6,0,0,6,0,0,0,0,12
OpenHFT_Chronicle-Bytes.net.openhft.chronicle.bytes.DistributedUniqueTimeProvider,3,0,0,1,0,0,0,0,4
OpenHFT_Chronicle-Bytes.net.openhft.chronicle.bytes.HexDumpBytes,1,0,0,1,0,0,0,0,2
OpenHFT_Chronicle-Bytes.net.openhft.chronicle.bytes.RandomDataOutput,12,0,0,11,0,0,0,19,42
OpenHFT_Chronicle-Bytes.net.openhft.chronicle.bytes.util.AbstractInterner,1,0,0,0,0,0,0,0,1
OpenHFT_Chronicle-Bytes.net.openhft.chronicle.bytes.CommonMarshallable,0,0,0,0,0,0,0,0,0
OpenHFT_Chronicle-Bytes.net.openhft.chronicle.bytes.internal.HeapBytesStore,1,0,0,0,0,0,0,0,1
OpenHFT_Chronicle-Bytes.net.openhft.chronicle.bytes.PointerBytesStore,0,0,0,0,0,0,0,0,0
OpenHFT_Chronicle-Bytes.net.openhft.chronicle.bytes.internal.BytesFieldInfo,1,0,0,1,0,0,0,0,2
OpenHFT_Chronicle-Bytes.net.openhft.chronicle.bytes.RandomDataInput,1,0,0,0,0,0,0,0,1
OpenHFT_Chronicle-Bytes.net.openhft.chronicle.bytes.ref.BinaryLongArrayReference,2,0,0,2,0,0,0,0,4
OpenHFT_Chronicle-Bytes.net.openhft.chronicle.bytes.ref.TextIntArrayReference,1,0,0,1,0,0,0,0,2
OpenHFT_Chronicle-Bytes.net.openhft.chronicle.bytes.ref.TextLongArrayReference,1,0,0,1,0,0,0,0,2
OpenHFT_Chronicle-Bytes.net.openhft.chronicle.bytes.ref.BinaryIntArrayReference,3,0,0,3,0,1,0,0,7
OpenHFT_Chronicle-Bytes.net.openhft.chronicle.bytes.util.StringInternerBytes,0,0,0,0,0,0,0,0,0
OpenHFT_Chronicle-Bytes.net.openhft.chronicle.bytes.util.Compression,1,0,0,1,0,0,0,0,2
matiwinnetou_spring-soy-view.pl.matisoft.soy.compile.DefaultTofuCompiler,3,0,0,3,0,0,0,0,6
matiwinnetou_spring-soy-view.pl.matisoft.soy.locale.DefaultLocaleProvider,0,0,0,0,0,0,0,0,0
matiwinnetou_spring-soy-view.pl.matisoft.soy.locale.EmptyLocaleProvider,0,0,0,0,0,0,0,0,0
matiwinnetou_spring-soy-view.pl.matisoft.soy.locale.AcceptHeaderLocaleProvider,1,0,0,0,0,0,0,0,1
matiwinnetou_spring-soy-view.pl.matisoft.soy.render.EmptyTemplateRenderer,0,0,0,0,0,0,0,1,1
matiwinnetou_spring-soy-view.pl.matisoft.soy.render.DefaultTemplateRenderer,0,0,0,0,0,0,0,3,3
matiwinnetou_spring-soy-view.pl.matisoft.soy.global.compile.EmptyCompileTimeGlobalModelResolver,0,0,0,0,0,0,0,0,0
matiwinnetou_spring-soy-view.pl.matisoft.soy.global.compile.DefaultCompileTimeGlobalModelResolver,2,0,0,2,0,0,0,0,4
matiwinnetou_spring-soy-view.pl.matisoft.soy.global.runtime.resolvers.RequestParametersDataResolver,1,0,0,0,0,0,0,0,1
matiwinnetou_spring-soy-view.pl.matisoft.soy.global.runtime.resolvers.CookieDataResolver,1,0,0,0,0,0,0,0,1
matiwinnetou_spring-soy-view.pl.matisoft.soy.global.runtime.resolvers.RequestHeadersDataResolver,1,0,0,0,0,0,0,0,1
matiwinnetou_spring-soy-view.pl.matisoft.soy.data.DefaultToSoyDataConverter,7,0,0,0,0,0,0,0,7
matiwinnetou_spring-soy-view.pl.matisoft.soy.data.adjust.EmptyModelAdjuster,0,0,0,0,0,0,0,0,0
matiwinnetou_spring-soy-view.pl.matisoft.soy.data.adjust.SpringModelAdjuster,0,0,0,0,0,0,0,0,0
matiwinnetou_spring-soy-view.pl.matisoft.soy.DefaultContentNegotiator,0,0,0,0,0,0,0,0,0
matiwinnetou_spring-soy-view.pl.matisoft.soy.template.ClasspathTemplateFilesResolver,7,0,0,1,0,0,0,0,8
matiwinnetou_spring-soy-view.pl.matisoft.soy.template.DefaultTemplateFilesResolver,6,0,0,6,0,0,0,0,12
matiwinnetou_spring-soy-view.pl.matisoft.soy.template.EmptyTemplateFilesResolver,0,0,0,0,0,0,0,0,0
matiwinnetou_spring-soy-view.pl.matisoft.soy.bundle.EmptySoyMsgBundleResolver,0,0,0,0,0,0,0,0,0
matiwinnetou_spring-soy-view.pl.matisoft.soy.bundle.DefaultSoyMsgBundleResolver,2,0,0,2,0,1,0,0,5
matiwinnetou_spring-soy-view.pl.matisoft.soy.global.runtime.EmptyGlobalRuntimeModelResolver,0,0,0,0,0,0,0,0,0
matiwinnetou_spring-soy-view.pl.matisoft.soy.locale.LocaleProvider,2,0,0,2,0,0,1,0,5
tim-group_test-driven-detectors4findbugs.com.youdevise.fbplugins.tdd4fb.AuxCodeBaseLocatorProvider,0,0,0,0,0,0,0,0,0
tim-group_test-driven-detectors4findbugs.com.youdevise.fbplugins.tdd4fb.TestingBugReporter,1,0,0,0,0,0,0,0,1
tim-group_test-driven-detectors4findbugs.com.youdevise.fbplugins.tdd4fb.DetectorRunner,0,0,0,0,0,0,0,2,2
tim-group_test-driven-detectors4findbugs.com.youdevise.fbplugins.tdd4fb.DetectorAssert,2,0,0,2,0,0,0,3,7
tim-group_test-driven-detectors4findbugs.com.youdevise.fbplugins.tdd4fb.BugsReportedAsserter,0,0,0,0,0,0,0,4,4
snazy_ohc.org.caffinitas.ohc.OHCacheBuilder,19,1,0,17,0,3,0,1,41
snazy_ohc.org.caffinitas.ohc.chunked.KeyBuffer,0,0,0,0,0,0,0,0,0
snazy_ohc.org.caffinitas.ohc.chunked.Util,2,0,0,1,0,0,0,0,3
snazy_ohc.org.caffinitas.ohc.chunked.Uns,1,0,0,1,0,0,0,0,2
snazy_ohc.org.caffinitas.ohc.OHCache,18,0,0,18,0,0,0,0,36
snazy_ohc.org.caffinitas.ohc.OHCacheStats,4,0,0,4,0,0,0,0,8
snazy_ohc.org.caffinitas.ohc.linked.HashEntries,8,0,0,8,0,0,0,0,16
snazy_ohc.org.caffinitas.ohc.linked.Timeouts,1,0,0,1,0,0,0,0,2
snazy_ohc.org.caffinitas.ohc.linked.LongArrayList,1,0,0,1,0,0,0,0,2
snazy_ohc.org.caffinitas.ohc.linked.Util,2,0,0,0,0,0,0,0,2
snazy_ohc.org.caffinitas.ohc.linked.FrequencySketch,5,1,0,4,0,0,0,0,10
snazy_ohc.org.caffinitas.ohc.linked.Uns,7,0,0,7,0,0,0,1,15
jimmoores_quandl4j.com.jimmoores.quandl.generic.GenericQuandlSessionInterface,0,0,0,0,0,0,0,0,0
jimmoores_quandl4j.com.jimmoores.quandl.DataSetRequest,4,0,0,0,0,0,0,0,4
jimmoores_quandl4j.com.jimmoores.quandl.MetaDataResult,2,0,0,2,0,0,0,0,4
jimmoores_quandl4j.com.jimmoores.quandl.SearchResult,2,0,0,2,0,0,0,0,4
jimmoores_quandl4j.com.jimmoores.quandl.HeaderDefinition,2,0,0,0,0,0,0,0,2
jimmoores_quandl4j.com.jimmoores.quandl.Row,10,0,0,10,0,0,0,0,20
jimmoores_quandl4j.com.jimmoores.quandl.QuandlSession,0,0,0,0,0,0,0,0,0
jimmoores_quandl4j.com.jimmoores.quandl.QuandlCodeRequest,3,0,0,2,0,0,0,0,5
reinert_requestor.io.reinert.requestor.gwt.serialization.JsonStringSerializer,0,0,0,0,0,0,0,0,0
reinert_requestor.io.reinert.requestor.core.payload.SerializedPayload,9,0,0,9,0,0,0,0,18
reinert_requestor.io.reinert.requestor.gwt.serialization.JsonBooleanSerializer,1,0,0,0,0,0,0,0,1
reinert_requestor.io.reinert.requestor.core.serialization.DeserializationContext,12,0,0,12,0,0,0,0,24
reinert_requestor.io.reinert.requestor.core.serialization.Deserializer,2,0,0,2,0,0,0,0,4
reinert_requestor.io.reinert.requestor.core.serialization.Serializer,2,0,0,2,0,0,0,0,4
reinert_requestor.io.reinert.requestor.core.Provider,0,0,0,0,0,0,0,0,0
reinert_requestor.io.reinert.requestor.core.FilterManagerImpl,1,0,0,1,0,0,0,0,2
reinert_requestor.io.reinert.requestor.core.InterceptorManagerImpl,1,0,0,1,0,0,0,0,2
reinert_requestor.io.reinert.requestor.core.Store,2,0,0,2,0,0,0,0,4
reinert_requestor.io.reinert.requestor.core.LeafStore,5,0,0,5,0,0,0,0,10
reinert_requestor.io.reinert.requestor.core.uri.UriParser,6,0,0,6,0,0,0,0,12
reinert_requestor.io.reinert.requestor.core.uri.UriBuilder,1,0,0,1,0,0,0,0,2
reinert_requestor.io.reinert.requestor.core.header.Header,1,0,0,1,0,0,0,0,2
reinert_requestor.io.reinert.requestor.core.header.MultivaluedHeader,1,0,0,1,0,0,0,0,2
Jimmy-Shi_bean-query.cn.jimmyshi.beanquery.selectors.PropertySelector,2,0,0,0,0,0,0,0,2
Jimmy-Shi_bean-query.cn.jimmyshi.beanquery.selectors.CompositeSelector,1,0,0,1,0,0,0,0,2
Jimmy-Shi_bean-query.cn.jimmyshi.beanquery.selectors.BeanSelector,0,0,0,0,0,0,0,0,0
Jimmy-Shi_bean-query.cn.jimmyshi.beanquery.selectors.DefaultSelector,8,0,0,0,0,0,0,0,8
Jimmy-Shi_bean-query.cn.jimmyshi.beanquery.selectors.KeyValueMapSelector,0,0,0,0,0,0,0,0,0
Jimmy-Shi_bean-query.cn.jimmyshi.beanquery.DefaultNullValuePropertyValueGetter,0,0,0,0,0,0,0,0,0
Jimmy-Shi_bean-query.cn.jimmyshi.beanquery.BeanPropertyMatcher,1,0,0,0,0,0,0,0,1
Jimmy-Shi_bean-query.cn.jimmyshi.beanquery.comparators.PropertyComparator,0,0,0,0,0,0,0,0,0
Jimmy-Shi_bean-query.cn.jimmyshi.beanquery.comparators.DefaultSortOrderableComparator,0,0,0,0,0,0,0,0,0
Jimmy-Shi_bean-query.cn.jimmyshi.beanquery.comparators.ComparableObjectComparator,0,0,0,0,0,0,0,0,0
Jimmy-Shi_bean-query.cn.jimmyshi.beanquery.BeanQuery,4,0,0,1,0,0,0,0,5
MyRobotLab_myrobotlab.org.myrobotlab.programab.OOBPayload,1,0,0,1,0,0,0,0,2
MyRobotLab_myrobotlab.org.myrobotlab.document.transformer.AbstractStage,0,0,0,0,0,0,0,1,1
MyRobotLab_myrobotlab.org.myrobotlab.service.Runtime,13,1,0,12,0,0,0,11,37
MyRobotLab_myrobotlab.org.myrobotlab.service.UltrasonicSensor,0,0,0,0,0,0,0,1,1
MyRobotLab_myrobotlab.org.myrobotlab.service.Arduino,7,1,0,7,0,0,0,5,20
MyRobotLab_myrobotlab.org.myrobotlab.service.abstracts.AbstractMicrocontroller,0,0,0,0,0,0,0,0,0
MyRobotLab_myrobotlab.org.myrobotlab.service.TestCatcher,0,0,0,0,0,0,0,0,0
MyRobotLab_myrobotlab.org.myrobotlab.service.Adafruit16CServoDriver,0,0,0,0,0,0,0,1,1
MyRobotLab_myrobotlab.org.myrobotlab.process.InProcessCli,1,0,0,1,0,0,0,0,2
MyRobotLab_myrobotlab.org.myrobotlab.service.HttpClient,1,1,0,1,0,0,0,0,3
MyRobotLab_myrobotlab.org.myrobotlab.service.InMoov2Arm,1,0,0,1,0,0,0,1,3
MyRobotLab_myrobotlab.org.myrobotlab.service.abstracts.AbstractServo,3,0,0,3,0,0,0,0,6
MyRobotLab_myrobotlab.org.myrobotlab.service.Servo,1,0,0,1,0,0,0,0,2
MyRobotLab_myrobotlab.org.myrobotlab.service.WorkE,0,0,0,0,0,0,0,1,1
MyRobotLab_myrobotlab.org.myrobotlab.service.HtmlFilter,0,0,0,0,0,0,0,0,0
MyRobotLab_myrobotlab.org.myrobotlab.service.InverseKinematics3D,0,0,0,0,0,0,0,1,1
MyRobotLab_myrobotlab.org.myrobotlab.service.ProgramAB,3,0,0,3,0,0,0,0,6
MyRobotLab_myrobotlab.org.myrobotlab.framework.repo.ServiceData,3,0,0,3,0,1,0,2,9
MyRobotLab_myrobotlab.org.myrobotlab.service.OpenCV,4,1,0,4,0,0,0,1,10
MyRobotLab_myrobotlab.org.myrobotlab.service.NeoPixel,0,0,0,0,0,0,0,5,5
MyRobotLab_myrobotlab.org.myrobotlab.codec.CodecUtils,1,0,0,1,0,0,0,0,2
MyRobotLab_myrobotlab.org.myrobotlab.service.JMonkeyEngine,0,0,0,0,0,0,0,1,1
MyRobotLab_myrobotlab.org.myrobotlab.arduino.ArduinoUtils,0,1,0,0,0,0,0,0,1
MyRobotLab_myrobotlab.org.myrobotlab.service.Serial,7,0,0,5,0,0,0,0,12
MyRobotLab_myrobotlab.org.myrobotlab.framework.Service,2,0,0,2,0,0,0,0,4
MyRobotLab_myrobotlab.org.myrobotlab.service.data.Locale,1,0,0,1,0,0,0,0,2
MyRobotLab_myrobotlab.org.myrobotlab.document.connector.AbstractConnector,0,0,0,0,0,0,0,0,0
MyRobotLab_myrobotlab.org.myrobotlab.opencv.ImageFileFrameGrabber,0,0,0,0,0,0,0,0,0
MyRobotLab_myrobotlab.org.myrobotlab.math.interfaces.Mapper,2,0,0,2,0,0,0,0,4
MyRobotLab_myrobotlab.org.myrobotlab.math.MapperLinear,2,0,0,2,0,0,0,0,4
MyRobotLab_myrobotlab.org.myrobotlab.math.MapperBase,1,0,0,1,0,0,0,1,3
MyRobotLab_myrobotlab.org.myrobotlab.io.FileIO,3,0,0,1,0,2,0,2,8
MyRobotLab_myrobotlab.org.myrobotlab.logging.LoggingFactory,0,0,0,0,0,0,0,1,1
MyRobotLab_myrobotlab.org.myrobotlab.serial.Port,1,0,0,1,0,0,0,0,2
MyRobotLab_myrobotlab.org.myrobotlab.framework.CmdOptions,1,0,0,1,0,0,0,0,2
MyRobotLab_myrobotlab.org.myrobotlab.framework.MethodCache,2,0,0,2,0,0,0,0,4
MyRobotLab_myrobotlab.org.myrobotlab.framework.repo.Repo,1,0,0,1,0,0,0,1,3
MyRobotLab_myrobotlab.org.myrobotlab.process.Launcher,1,0,0,1,0,0,0,0,2
MyRobotLab_myrobotlab.org.myrobotlab.arduino.Msg,2,0,0,2,0,0,0,0,4
MyRobotLab_myrobotlab.org.myrobotlab.kinematics.DHRobotArm,0,0,0,0,0,0,0,1,1
MyRobotLab_myrobotlab.org.myrobotlab.kinematics.DruppIKSolver,1,0,0,0,0,0,0,0,1
MyRobotLab_myrobotlab.org.myrobotlab.string.StringUtil,0,0,0,0,0,0,0,0,0
darcy-framework_darcy-ui.com.redhat.darcy.util.ReflectionUtil,0,0,0,0,0,0,0,0,0
darcy-framework_darcy-ui.com.redhat.darcy.util.LazyList,0,0,0,0,0,0,0,17,17
darcy-framework_darcy-ui.com.redhat.darcy.ui.By,24,0,0,13,0,0,0,24,61
darcy-framework_darcy-ui.com.redhat.darcy.ui.AbstractView,0,0,0,0,0,0,0,4,4
darcy-framework_darcy-ui.com.redhat.darcy.ui.api.elements.HasAttributes,1,0,0,1,0,0,0,0,2
darcy-framework_darcy-ui.com.redhat.darcy.ui.api.elements.Element,0,0,0,0,0,0,0,0,0
darcy-framework_darcy-ui.com.redhat.darcy.ui.AbstractViewElement,0,0,0,0,0,0,0,0,0
darcy-framework_darcy-ui.com.redhat.darcy.ui.api.View,0,0,0,0,0,0,0,0,0
darcy-framework_darcy-ui.com.redhat.darcy.ui.api.elements.Findable,0,0,0,0,0,0,0,0,0
darcy-framework_darcy-ui.com.redhat.darcy.ui.Elements,2,0,0,2,0,0,0,0,4
darcy-framework_darcy-ui.com.redhat.darcy.ui.internal.ViewList,1,0,0,1,0,0,0,0,2
darcy-framework_darcy-ui.com.redhat.darcy.ui.internal.ElementHandler,0,0,0,0,0,0,0,4,4
darcy-framework_darcy-ui.com.redhat.darcy.ui.internal.ChainedViewFactory,0,0,0,0,0,0,0,1,1
darcy-framework_darcy-ui.com.redhat.darcy.ui.api.elements.Requireable,0,0,0,0,0,0,0,0,0
darcy-framework_darcy-ui.com.redhat.darcy.ui.api.ElementSelection,0,0,0,0,0,0,0,0,0
optimaize_language-detector.com.optimaize.langdetect.LanguageDetector,0,0,0,0,0,0,0,0,0
optimaize_language-detector.com.optimaize.langdetect.NgramFrequencyData,0,0,0,0,0,0,0,0,0
optimaize_language-detector.com.optimaize.langdetect.DetectedLanguage,2,0,0,2,0,0,0,0,4
optimaize_language-detector.com.optimaize.langdetect.cybozu.util.TagExtractor,3,0,0,2,0,0,0,2,7
optimaize_language-detector.com.optimaize.langdetect.cybozu.util.CharNormalizer,2,0,0,0,0,0,0,0,2
optimaize_language-detector.com.optimaize.langdetect.cybozu.util.LangProfile,2,0,0,2,0,0,0,0,4
optimaize_language-detector.com.optimaize.langdetect.cybozu.util.NGram,1,0,0,1,0,0,0,0,2
optimaize_language-detector.com.optimaize.langdetect.ngram.NgramFilter,6,0,0,0,0,0,0,0,6
optimaize_language-detector.com.optimaize.langdetect.ngram.NgramExtractor,6,0,0,4,0,0,0,1,11
optimaize_language-detector.com.optimaize.langdetect.ngram.OldNgramExtractor,1,0,0,0,0,0,0,2,3
optimaize_language-detector.com.optimaize.langdetect.text.TextObject,0,0,0,0,0,0,0,0,0
optimaize_language-detector.com.optimaize.langdetect.text.MultiTextFilter,0,0,0,0,0,0,0,0,0
optimaize_language-detector.com.optimaize.langdetect.text.RemoveMinorityScriptsTextFilter,1,0,0,1,0,0,0,0,2
optimaize_language-detector.com.optimaize.langdetect.profiles.util.LanguageProfileValidator,0,0,0,0,0,0,0,0,0
optimaize_language-detector.com.optimaize.langdetect.profiles.LanguageProfileReader,0,0,0,0,0,0,0,1,1
optimaize_language-detector.com.optimaize.langdetect.profiles.LanguageProfileBuilder,3,0,0,3,0,0,0,0,6
optimaize_language-detector.com.optimaize.langdetect.frma.IOUtils,0,0,0,0,0,0,0,3,3
optimaize_language-detector.com.optimaize.langdetect.frma.GenProfile,1,0,0,1,0,0,0,0,2
andsel_moquette.io.moquette.interception.BrokerInterceptor,0,0,0,0,0,0,0,1,1
andsel_moquette.io.moquette.persistence.H2PersistentQueue,4,0,0,4,0,0,0,0,8
andsel_moquette.io.moquette.broker.Session,2,0,0,2,0,0,0,2,6
andsel_moquette.io.moquette.broker.PostOffice,2,0,0,1,0,0,0,1,4
andsel_moquette.io.moquette.broker.MQTTConnection,26,0,0,14,0,0,0,3,43
andsel_moquette.io.moquette.broker.SessionRegistry,2,0,0,2,0,0,0,0,4
andsel_moquette.io.moquette.broker.subscriptions.Topic,3,0,0,3,0,0,0,0,6
andsel_moquette.io.moquette.broker.MemoryRetainedRepository,3,0,0,3,0,0,0,0,6
andsel_moquette.io.moquette.broker.BrokerConfiguration,5,0,0,5,0,0,0,0,10
andsel_moquette.io.moquette.broker.NettyUtils,0,0,0,0,0,0,0,0,0
andsel_moquette.io.moquette.broker.security.AuthorizationsCollector,6,0,0,6,0,0,0,0,12
andsel_moquette.io.moquette.broker.security.DBAuthenticator,0,0,0,0,0,0,0,0,0
andsel_moquette.io.moquette.broker.security.IAuthenticator,0,0,0,0,0,0,0,0,0
andsel_moquette.io.moquette.broker.config.ConfigurationParser,1,0,0,0,0,0,0,0,1
andsel_moquette.io.moquette.broker.config.IConfig,1,0,0,1,0,0,0,0,2
andsel_moquette.io.moquette.broker.subscriptions.CTrieSubscriptionDirectory,7,0,0,7,0,0,0,0,14
andsel_moquette.io.moquette.broker.subscriptions.CTrie,8,0,0,8,0,0,0,0,16
andsel_moquette.io.moquette.broker.Server,1,0,0,0,0,0,0,2,3
caskdata_tephra.co.cask.tephra.Transaction,34,0,0,16,0,0,0,0,50
apache_tajo.org.apache.tajo.exception.SQLExceptionUtil,8,0,0,0,0,8,0,0,16
apache_tajo.org.apache.tajo.schema.IdentifierUtil,61,26,0,45,0,0,0,1,133
apache_tajo.org.apache.tajo.common.type.TajoTypeUtil,1,1,0,0,0,0,0,0,2
apache_tajo.org.apache.tajo.catalog.Schema,12,0,0,11,0,0,0,0,23
apache_tajo.org.apache.tajo.jdbc.TajoResultSetBase,1,0,0,1,0,0,0,0,2
apache_tajo.org.apache.tajo.catalog.SchemaBuilder,90,36,0,90,0,1,0,75,292
apache_tajo.org.apache.tajo.exception.ErrorUtil,5,0,0,2,0,0,0,0,7
apache_tajo.org.apache.tajo.metrics.MetricsUtil,2,0,0,0,0,0,0,0,2
apache_tajo.org.apache.tajo.ExecutionBlockId,4,0,0,1,0,0,0,0,5
apache_tajo.org.apache.tajo.conf.TajoConf,7,1,0,5,0,0,0,0,13
apache_tajo.org.apache.tajo.plan.LogicalPlanner,61,1,0,60,0,0,0,3,125
apache_tajo.org.apache.tajo.rule.EvaluationContext,2,0,0,2,0,0,0,0,4
apache_tajo.org.apache.tajo.util.Pair,4,0,0,1,0,3,0,1,9
apache_tajo.org.apache.tajo.util.datetime.DateTimeFormat,1,0,0,0,0,0,0,1,2
apache_tajo.org.apache.tajo.util.BitArray,2,1,0,2,0,0,0,0,5
apache_tajo.org.apache.tajo.util.NumberUtil,2,0,0,0,0,0,0,0,2
apache_tajo.org.apache.tajo.util.StringUtils,5,0,0,0,0,0,0,0,5
apache_tajo.org.apache.tajo.util.BytesUtils,3,0,0,1,0,0,0,0,4
apache_tajo.org.apache.tajo.util.datetime.DateTimeUtil,15,0,0,9,0,0,0,1,25
apache_tajo.org.apache.tajo.util.UriUtil,1,0,0,0,0,0,0,0,1
apache_tajo.org.apache.tajo.util.TajoIdUtils,2,0,0,1,0,0,0,0,3
apache_tajo.org.apache.tajo.QueryIdFactory,8,0,0,7,0,1,0,0,16
apache_tajo.org.apache.tajo.datum.NullDatum,1,0,0,0,0,0,0,11,12
apache_tajo.org.apache.tajo.datum.Int8Datum,1,0,0,0,0,0,0,0,1
apache_tajo.org.apache.tajo.storage.Tuple,4,0,0,4,0,0,0,0,8
apache_tajo.org.apache.tajo.catalog.CatalogUtil,44,2,0,41,0,0,0,0,87
apache_tajo.org.apache.tajo.catalog.FunctionDesc,2,0,0,2,0,0,0,0,4
apache_tajo.org.apache.tajo.catalog.TableDesc,11,1,0,4,0,0,0,0,16
apache_tajo.org.apache.tajo.exception.TajoException,1,0,0,0,0,1,0,0,2
apache_tajo.org.apache.tajo.storage.TablespaceManager,17,0,0,15,0,3,0,1,36
apache_tajo.org.apache.tajo.catalog.CatalogService,34,12,0,25,0,0,0,1,72
apache_tajo.org.apache.tajo.util.CommonTestingUtil,8,1,0,7,0,0,0,1,17
apache_tajo.org.apache.tajo.client.QueryStatus,1,0,0,1,0,1,0,0,3
apache_tajo.org.apache.tajo.util.FileUtil,0,0,0,0,0,0,0,5,5
apache_tajo.org.apache.tajo.plan.LogicalPlan,1,0,0,1,0,0,0,0,2
apache_tajo.org.apache.tajo.storage.FileTablespace,21,4,0,21,0,0,0,0,46
apache_tajo.org.apache.tajo.catalog.statistics.TableStats,1,0,0,1,0,0,0,2,4
apache_tajo.org.apache.tajo.datum.DatumFactory,25,0,0,25,0,1,0,1,52
apache_tajo.org.apache.tajo.storage.VTuple,4,0,0,4,0,0,0,0,8
apache_tajo.org.apache.tajo.pullserver.PullServerUtil,5,2,0,5,0,2,0,0,14
apache_tajo.org.apache.tajo.QueryId,5,0,0,4,0,0,0,0,9
apache_tajo.org.apache.tajo.rpc.TajoServiceException,1,0,0,1,0,1,0,0,3
apache_tajo.org.apache.tajo.rpc.DefaultRpcController,1,0,0,1,0,1,0,0,3
apache_tajo.org.apache.tajo.rpc.NettyServerBase,3,0,0,2,0,2,0,0,7
apache_tajo.org.apache.tajo.rpc.RpcClientManager,2,0,0,2,0,0,0,0,4
apache_tajo.org.apache.tajo.rpc.CallFuture,4,0,0,4,0,0,0,0,8
apache_tajo.org.apache.tajo.ws.rs.netty.NettyRestServer,1,0,0,1,0,0,0,0,2
apache_tajo.org.apache.tajo.ws.rs.netty.NettyRestServerFactory,1,0,0,1,0,0,0,0,2
apache_tajo.org.apache.tajo.algebra.Expr,2,0,0,1,0,0,0,0,3
apache_tajo.org.apache.tajo.algebra.UnaryOperator,1,0,0,1,0,0,0,0,2
apache_tajo.org.apache.tajo.auth.UserRoleInfo,0,0,0,0,0,0,0,4,4
apache_tajo.org.apache.tajo.util.JavaResourceUtil,1,0,0,1,0,0,0,0,2
apache_tajo.org.apache.tajo.OverridableConf,1,0,0,1,0,0,0,0,2
apache_tajo.org.apache.tajo.cli.tsql.TajoCli,2,3,0,1,0,1,0,6,13
apache_tajo.org.apache.tajo.cli.tsql.SimpleParser,8,0,0,7,0,1,0,0,16
apache_tajo.org.apache.tajo.cli.tsql.DefaultTajoCliOutputFormatter,1,0,0,0,0,0,0,0,1
apache_tajo.org.apache.tajo.catalog.AlterTableDesc,1,0,0,1,0,0,0,0,2
apache_tajo.org.apache.tajo.util.KeyValueSet,12,1,0,12,0,1,0,0,26
apache_tajo.org.apache.tajo.catalog.IndexDesc,3,0,0,1,0,0,0,0,4
apache_tajo.org.apache.tajo.catalog.Column,5,0,0,2,0,0,0,0,7
apache_tajo.org.apache.tajo.catalog.TableMeta,2,0,0,2,0,0,0,0,4
apache_tajo.org.apache.tajo.catalog.store.XMLCatalogSchemaManager,8,0,0,8,0,0,0,0,16
apache_tajo.org.apache.tajo.catalog.statistics.ColumnStats,1,1,0,1,0,0,0,0,3
apache_tajo.org.apache.tajo.catalog.statistics.Stat,2,0,0,2,0,0,0,0,4
apache_tajo.org.apache.tajo.catalog.statistics.StatisticsUtil,0,0,0,0,0,0,0,0,0
apache_tajo.org.apache.tajo.type.Type,2,0,0,2,0,0,0,2,6
apache_tajo.org.apache.tajo.schema.Field,0,0,0,0,0,0,0,1,1
apache_tajo.org.apache.tajo.type.TypeStringEncoder,1,0,0,1,0,0,0,0,2
apache_tajo.org.apache.tajo.schema.Identifier,1,0,0,1,0,0,0,0,2
apache_tajo.org.apache.tajo.schema.IdentifierPolicy,2,0,0,2,0,0,0,2,6
apache_tajo.org.apache.tajo.common.type.TimeRange,2,0,0,1,0,0,0,0,3
apache_tajo.org.apache.tajo.common.type.IPv4,4,0,0,1,0,0,0,0,5
apache_tajo.org.apache.tajo.storage.fragment.Fragment,1,0,0,1,0,0,0,0,2
apache_tajo.org.apache.tajo.storage.fragment.FragmentConvertor,1,0,0,1,0,0,0,0,2
apache_tajo.org.apache.tajo.storage.text.ByteBufLineReader,2,0,0,2,0,0,0,0,4
apache_tajo.org.apache.tajo.storage.StorageUtil,0,0,0,0,0,0,0,0,0
apache_tajo.org.apache.tajo.storage.text.LineSplitProcessor,1,0,0,0,0,0,0,0,1
apache_tajo.org.apache.tajo.storage.LazyTuple,1,0,0,1,0,0,0,0,2
apache_tajo.org.apache.tajo.util.graph.SimpleDirectedGraph,1,0,0,1,0,0,0,0,2
apache_tajo.org.apache.tajo.util.graph.Graph,1,0,0,1,0,0,0,0,2
apache_tajo.org.apache.tajo.datum.IntervalDatum,1,0,0,0,0,0,0,0,1
apache_tajo.org.apache.tajo.datum.Datum,9,0,0,1,0,0,0,0,10
apache_tajo.org.apache.tajo.util.Bytes,1,0,0,1,0,0,0,0,2
apache_tajo.org.apache.tajo.datum.TextDatum,2,0,0,1,0,0,0,0,3
apache_tajo.org.apache.tajo.datum.TimeDatum,1,0,0,1,0,0,0,0,2
apache_tajo.org.apache.tajo.datum.DateDatum,2,0,0,1,0,0,0,0,3
apache_tajo.org.apache.tajo.datum.protobuf.TextUtils,1,0,0,0,0,0,0,0,1
apache_tajo.org.apache.tajo.datum.ProtobufDatumFactory,0,0,0,0,0,0,0,0,0
apache_tajo.org.apache.tajo.tuple.memory.MemoryRowBlock,3,0,0,3,0,1,0,4,11
apache_tajo.org.apache.tajo.tuple.memory.MemoryBlock,2,0,0,2,0,0,0,0,4
apache_tajo.org.apache.tajo.tuple.memory.ResizableLimitSpec,2,0,0,2,0,0,0,0,4
apache_tajo.org.apache.tajo.tuple.memory.RowWriter,1,0,0,1,0,0,0,1,3
apache_tajo.org.apache.tajo.rule.SelfDiagnosisRuleEngine,5,0,0,5,0,0,0,1,11
apache_tajo.org.apache.tajo.client.QueryClient,2,0,0,1,0,0,0,2,5
apache_tajo.org.apache.tajo.client.CatalogAdminClient,8,0,0,8,0,2,0,0,18
apache_tajo.org.apache.tajo.rpc.NettyClientBase,1,0,0,1,0,0,0,0,2
apache_tajo.org.apache.tajo.client.v2.TajoClient,2,0,0,2,0,0,0,0,4
apache_tajo.org.apache.tajo.plan.expr.EvalNode,3,0,0,3,0,0,0,0,6
apache_tajo.org.apache.tajo.plan.expr.EvalTreeUtil,2,0,0,1,0,0,0,0,3
apache_tajo.org.apache.tajo.plan.expr.AlgebraicUtil,5,0,0,3,0,0,0,0,8
apache_tajo.org.apache.tajo.storage.Tablespace,1,0,0,0,0,1,0,1,3
apache_tajo.org.apache.tajo.plan.logical.ScanNode,1,0,0,1,0,0,0,0,2
apache_tajo.org.apache.tajo.util.NetUtils,0,0,0,0,0,0,0,0,0
apache_tajo.org.apache.tajo.storage.avro.AvroUtil,0,0,0,0,0,0,0,0,0
apache_tajo.org.apache.tajo.plan.util.WritableTypeConverter,1,0,0,1,0,1,0,0,3
searchisko_elasticsearch-river-jira.org.jboss.elasticsearch.river.jira.ChangedIssuesResults,1,0,0,1,0,0,0,0,2
searchisko_elasticsearch-river-jira.org.jboss.elasticsearch.river.jira.JIRA5RestIssueIndexStructureBuilder,10,0,0,6,0,0,0,1,17
searchisko_elasticsearch-river-jira.org.jboss.elasticsearch.river.jira.DateTimeUtils,8,0,0,8,0,0,0,1,17
searchisko_elasticsearch-river-jira.org.jboss.elasticsearch.river.jira.CronExpression,2,0,0,0,0,0,0,0,2
searchisko_elasticsearch-river-jira.org.jboss.elasticsearch.river.jira.JIRAProjectIndexerCoordinator,11,0,0,9,0,0,0,2,22
searchisko_elasticsearch-river-jira.org.jboss.elasticsearch.river.jira.Utils,8,0,0,0,0,0,0,0,8
searchisko_elasticsearch-river-jira.org.jboss.elasticsearch.river.jira.JIRA5RestClient,6,1,0,4,0,0,0,0,11
searchisko_elasticsearch-river-jira.org.jboss.elasticsearch.river.jira.IJIRAClient,3,0,0,2,0,1,0,0,6
searchisko_elasticsearch-river-jira.org.jboss.elasticsearch.river.jira.JiraRiver,15,0,0,9,0,0,0,2,26
searchisko_elasticsearch-river-jira.org.jboss.elasticsearch.river.jira.IESIntegration,1,0,0,0,0,0,0,0,1
searchisko_elasticsearch-river-jira.org.jboss.elasticsearch.river.jira.ProjectIndexingInfo,1,0,0,1,0,0,0,0,2
searchisko_elasticsearch-river-jira.org.jboss.elasticsearch.river.jira.JIRAProjectIndexer,4,0,0,4,0,0,0,1,9
searchisko_elasticsearch-river-jira.org.jboss.elasticsearch.river.jira.mgm.TransportJRMgmBaseAction,0,0,0,0,0,0,0,0,0
searchisko_elasticsearch-river-jira.org.jboss.elasticsearch.river.jira.IJiraRiverMgm,1,0,0,1,0,0,0,0,2
searchisko_elasticsearch-river-jira.org.jboss.elasticsearch.river.jira.mgm.riverslist.TransportListRiversAction,2,0,0,1,0,0,0,0,3
searchisko_elasticsearch-river-jira.org.jboss.elasticsearch.river.jira.mgm.NodeJRMgmBaseResponse,5,0,0,0,0,0,0,0,5
searchisko_elasticsearch-river-jira.org.jboss.elasticsearch.river.jira.mgm.riverslist.ListRiversAction,0,0,0,0,0,0,0,0,0
searchisko_elasticsearch-river-jira.org.jboss.elasticsearch.river.jira.mgm.state.JRStateRequestBuilder,1,0,0,1,0,0,0,0,2
searchisko_elasticsearch-river-jira.org.jboss.elasticsearch.river.jira.mgm.state.TransportJRStateAction,5,0,0,2,0,0,0,0,7
searchisko_elasticsearch-river-jira.org.jboss.elasticsearch.river.jira.mgm.state.JRStateAction,0,0,0,0,0,0,0,0,0
searchisko_elasticsearch-river-jira.org.jboss.elasticsearch.river.jira.mgm.NodeJRMgmBaseRequest,4,0,0,0,0,0,0,0,4
searchisko_elasticsearch-river-jira.org.jboss.elasticsearch.river.jira.mgm.JRMgmBaseRequest,1,0,0,0,0,0,0,0,1
searchisko_elasticsearch-river-jira.org.jboss.elasticsearch.river.jira.mgm.lifecycle.JRLifecycleAction,0,0,0,0,0,0,0,0,0
searchisko_elasticsearch-river-jira.org.jboss.elasticsearch.river.jira.mgm.lifecycle.JRLifecycleRequest,3,0,0,3,0,0,0,0,6
searchisko_elasticsearch-river-jira.org.jboss.elasticsearch.river.jira.mgm.lifecycle.TransportJRLifecycleAction,5,0,0,2,0,0,0,0,7
searchisko_elasticsearch-river-jira.org.jboss.elasticsearch.river.jira.mgm.lifecycle.JRLifecycleRequestBuilder,1,0,0,1,0,0,0,0,2
searchisko_elasticsearch-river-jira.org.jboss.elasticsearch.river.jira.mgm.JRMgmBaseResponse,5,0,0,2,0,0,0,0,7
searchisko_elasticsearch-river-jira.org.jboss.elasticsearch.river.jira.mgm.fullupdate.FullUpdateRequestBuilder,1,0,0,1,0,0,0,0,2
searchisko_elasticsearch-river-jira.org.jboss.elasticsearch.river.jira.mgm.fullupdate.TransportFullUpdateAction,5,0,0,2,0,0,0,0,7
searchisko_elasticsearch-river-jira.org.jboss.elasticsearch.river.jira.mgm.fullupdate.FullUpdateRequest,3,0,0,3,0,0,0,0,6
searchisko_elasticsearch-river-jira.org.jboss.elasticsearch.river.jira.mgm.fullupdate.FullUpdateAction,0,0,0,0,0,0,0,0,0
searchisko_elasticsearch-river-jira.org.jboss.elasticsearch.river.jira.mgm.incrementalupdate.IncrementalUpdateAction,0,0,0,0,0,0,0,0,0
searchisko_elasticsearch-river-jira.org.jboss.elasticsearch.river.jira.mgm.incrementalupdate.IncrementalUpdateRequest,3,0,0,3,0,0,0,0,6
searchisko_elasticsearch-river-jira.org.jboss.elasticsearch.river.jira.mgm.incrementalupdate.TransportIncrementalUpdateAction,5,0,0,2,0,0,0,0,7
searchisko_elasticsearch-river-jira.org.jboss.elasticsearch.river.jira.mgm.incrementalupdate.IncrementalUpdateRequestBuilder,1,0,0,1,0,0,0,0,2
thelinmichael_spotify-web-api-java.se.michaelthelin.spotify.requests.AbstractRequest,89,0,0,1,0,0,0,99,189
thelinmichael_spotify-web-api-java.se.michaelthelin.spotify.requests.authorization.authorization_code.pkce.AuthorizationCodePKCERefreshRequest,0,0,0,0,0,0,0,1,1
thelinmichael_spotify-web-api-java.se.michaelthelin.spotify.requests.authorization.authorization_code.pkce.AuthorizationCodePKCERequest,0,0,0,0,0,0,0,1,1
thelinmichael_spotify-web-api-java.se.michaelthelin.spotify.requests.authorization.authorization_code.AuthorizationCodeRefreshRequest,0,0,0,0,0,0,0,1,1
thelinmichael_spotify-web-api-java.se.michaelthelin.spotify.requests.authorization.authorization_code.AuthorizationCodeUriRequest,0,0,0,0,0,0,0,2,2
thelinmichael_spotify-web-api-java.se.michaelthelin.spotify.requests.authorization.authorization_code.AuthorizationCodeRequest,0,0,0,0,0,0,0,1,1
thelinmichael_spotify-web-api-java.se.michaelthelin.spotify.requests.authorization.client_credentials.ClientCredentialsRequest,0,0,0,0,0,0,0,1,1
thelinmichael_spotify-web-api-java.se.michaelthelin.spotify.requests.data.player.PauseUsersPlaybackRequest,0,0,0,0,0,0,0,1,1
thelinmichael_spotify-web-api-java.se.michaelthelin.spotify.requests.data.player.GetUsersAvailableDevicesRequest,0,0,0,0,0,0,0,2,2
thelinmichael_spotify-web-api-java.se.michaelthelin.spotify.requests.data.player.SeekToPositionInCurrentlyPlayingTrackRequest,0,0,0,0,0,0,0,1,1
thelinmichael_spotify-web-api-java.se.michaelthelin.spotify.requests.data.player.AddItemToUsersPlaybackQueueRequest,0,0,0,0,0,0,0,1,1
thelinmichael_spotify-web-api-java.se.michaelthelin.spotify.requests.data.player.SkipUsersPlaybackToPreviousTrackRequest,0,0,0,0,0,0,0,1,1
thelinmichael_spotify-web-api-java.se.michaelthelin.spotify.requests.data.player.ToggleShuffleForUsersPlaybackRequest,0,0,0,0,0,0,0,1,1
thelinmichael_spotify-web-api-java.se.michaelthelin.spotify.requests.data.player.SetVolumeForUsersPlaybackRequest,0,0,0,0,0,0,0,1,1
thelinmichael_spotify-web-api-java.se.michaelthelin.spotify.requests.data.player.SetRepeatModeOnUsersPlaybackRequest,0,0,0,0,0,0,0,1,1
thelinmichael_spotify-web-api-java.se.michaelthelin.spotify.requests.data.player.StartResumeUsersPlaybackRequest,0,0,0,0,0,0,0,1,1
thelinmichael_spotify-web-api-java.se.michaelthelin.spotify.requests.data.player.GetUsersCurrentlyPlayingTrackRequest,0,0,0,0,0,0,0,3,3
thelinmichael_spotify-web-api-java.se.michaelthelin.spotify.requests.data.player.SkipUsersPlaybackToNextTrackRequest,0,0,0,0,0,0,0,1,1
thelinmichael_spotify-web-api-java.se.michaelthelin.spotify.requests.data.player.GetCurrentUsersRecentlyPlayedTracksRequest,0,0,0,0,0,0,0,1,1
thelinmichael_spotify-web-api-java.se.michaelthelin.spotify.requests.data.player.GetInformationAboutUsersCurrentPlaybackRequest,0,0,0,0,0,0,0,3,3
thelinmichael_spotify-web-api-java.se.michaelthelin.spotify.requests.data.player.TransferUsersPlaybackRequest,0,0,0,0,0,0,0,1,1
thelinmichael_spotify-web-api-java.se.michaelthelin.spotify.requests.data.personalization.simplified.GetUsersTopArtistsRequest,0,0,0,0,0,0,0,1,1
thelinmichael_spotify-web-api-java.se.michaelthelin.spotify.requests.data.personalization.simplified.GetUsersTopTracksRequest,0,0,0,0,0,0,0,1,1
thelinmichael_spotify-web-api-java.se.michaelthelin.spotify.requests.data.albums.GetAlbumRequest,0,0,0,0,0,0,0,1,1
thelinmichael_spotify-web-api-java.se.michaelthelin.spotify.requests.data.albums.GetAlbumsTracksRequest,0,0,0,0,0,0,0,1,1
thelinmichael_spotify-web-api-java.se.michaelthelin.spotify.requests.data.albums.GetSeveralAlbumsRequest,0,0,0,0,0,0,0,2,2
thelinmichael_spotify-web-api-java.se.michaelthelin.spotify.requests.data.episodes.GetEpisodeRequest,0,0,0,0,0,0,0,1,1
thelinmichael_spotify-web-api-java.se.michaelthelin.spotify.requests.data.episodes.GetSeveralEpisodesRequest,0,0,0,0,0,0,0,1,1
thelinmichael_spotify-web-api-java.se.michaelthelin.spotify.requests.data.search.SearchItemRequest,0,0,0,0,0,0,0,1,1
thelinmichael_spotify-web-api-java.se.michaelthelin.spotify.requests.data.search.simplified.SearchPlaylistsRequest,0,0,0,0,0,0,0,1,1
thelinmichael_spotify-web-api-java.se.michaelthelin.spotify.requests.data.search.simplified.SearchArtistsRequest,0,0,0,0,0,0,0,1,1
thelinmichael_spotify-web-api-java.se.michaelthelin.spotify.requests.data.search.simplified.SearchEpisodesRequest,0,0,0,0,0,0,0,1,1
thelinmichael_spotify-web-api-java.se.michaelthelin.spotify.requests.data.search.simplified.SearchAlbumsRequest,0,0,0,0,0,0,0,1,1
thelinmichael_spotify-web-api-java.se.michaelthelin.spotify.requests.data.search.simplified.SearchTracksRequest,0,0,0,0,0,0,0,1,1
thelinmichael_spotify-web-api-java.se.michaelthelin.spotify.requests.data.search.simplified.SearchShowsRequest,0,0,0,0,0,0,0,1,1
thelinmichael_spotify-web-api-java.se.michaelthelin.spotify.requests.data.search.simplified.special.SearchAlbumsSpecialRequest,0,0,0,0,0,0,0,1,1
thelinmichael_spotify-web-api-java.se.michaelthelin.spotify.requests.data.artists.GetArtistsRelatedArtistsRequest,0,0,0,0,0,0,0,1,1
thelinmichael_spotify-web-api-java.se.michaelthelin.spotify.requests.data.artists.GetArtistsTopTracksRequest,0,0,0,0,0,0,0,1,1
thelinmichael_spotify-web-api-java.se.michaelthelin.spotify.requests.data.artists.GetSeveralArtistsRequest,0,0,0,0,0,0,0,1,1
thelinmichael_spotify-web-api-java.se.michaelthelin.spotify.requests.data.artists.GetArtistsAlbumsRequest,0,0,0,0,0,0,0,1,1
thelinmichael_spotify-web-api-java.se.michaelthelin.spotify.requests.data.artists.GetArtistRequest,0,0,0,0,0,0,0,1,1
thelinmichael_spotify-web-api-java.se.michaelthelin.spotify.requests.data.users_profile.GetCurrentUsersProfileRequest,0,0,0,0,0,0,0,1,1
thelinmichael_spotify-web-api-java.se.michaelthelin.spotify.requests.data.users_profile.GetUsersProfileRequest,0,0,0,0,0,0,0,1,1
thelinmichael_spotify-web-api-java.se.michaelthelin.spotify.requests.data.browse.GetListOfNewReleasesRequest,0,0,0,0,0,0,0,1,1
thelinmichael_spotify-web-api-java.se.michaelthelin.spotify.requests.data.browse.GetRecommendationsRequest,0,0,0,0,0,0,0,1,1
thelinmichael_spotify-web-api-java.se.michaelthelin.spotify.requests.data.browse.GetCategorysPlaylistsRequest,0,0,0,0,0,0,0,1,1
thelinmichael_spotify-web-api-java.se.michaelthelin.spotify.requests.data.browse.GetListOfFeaturedPlaylistsRequest,0,0,0,0,0,0,0,1,1
thelinmichael_spotify-web-api-java.se.michaelthelin.spotify.requests.data.browse.GetCategoryRequest,0,0,0,0,0,0,0,1,1
thelinmichael_spotify-web-api-java.se.michaelthelin.spotify.requests.data.browse.GetListOfCategoriesRequest,0,0,0,0,0,0,0,1,1
thelinmichael_spotify-web-api-java.se.michaelthelin.spotify.requests.data.browse.miscellaneous.GetAvailableGenreSeedsRequest,0,0,0,0,0,0,0,1,1
thelinmichael_spotify-web-api-java.se.michaelthelin.spotify.requests.data.shows.GetSeveralShowsRequest,0,0,0,0,0,0,0,1,1
thelinmichael_spotify-web-api-java.se.michaelthelin.spotify.requests.data.shows.GetShowRequest,0,0,0,0,0,0,0,1,1
thelinmichael_spotify-web-api-java.se.michaelthelin.spotify.requests.data.shows.GetShowsEpisodesRequest,0,0,0,0,0,0,0,1,1
thelinmichael_spotify-web-api-java.se.michaelthelin.spotify.requests.data.tracks.GetAudioAnalysisForTrackRequest,0,0,0,0,0,0,0,1,1
thelinmichael_spotify-web-api-java.se.michaelthelin.spotify.requests.data.tracks.GetTrackRequest,0,0,0,0,0,0,0,1,1
thelinmichael_spotify-web-api-java.se.michaelthelin.spotify.requests.data.tracks.GetAudioFeaturesForSeveralTracksRequest,0,0,0,0,0,0,0,1,1
thelinmichael_spotify-web-api-java.se.michaelthelin.spotify.requests.data.tracks.GetSeveralTracksRequest,0,0,0,0,0,0,0,1,1
thelinmichael_spotify-web-api-java.se.michaelthelin.spotify.requests.data.tracks.GetAudioFeaturesForTrackRequest,0,0,0,0,0,0,0,1,1
thelinmichael_spotify-web-api-java.se.michaelthelin.spotify.requests.data.follow.UnfollowPlaylistRequest,0,0,0,0,0,0,0,1,1
thelinmichael_spotify-web-api-java.se.michaelthelin.spotify.requests.data.follow.FollowPlaylistRequest,0,0,0,0,0,0,0,1,1
thelinmichael_spotify-web-api-java.se.michaelthelin.spotify.requests.data.follow.GetUsersFollowedArtistsRequest,0,0,0,0,0,0,0,2,2
thelinmichael_spotify-web-api-java.se.michaelthelin.spotify.requests.data.follow.CheckCurrentUserFollowsArtistsOrUsersRequest,0,0,0,0,0,0,0,1,1
thelinmichael_spotify-web-api-java.se.michaelthelin.spotify.requests.data.follow.FollowArtistsOrUsersRequest,0,0,0,0,0,0,0,1,1
thelinmichael_spotify-web-api-java.se.michaelthelin.spotify.requests.data.follow.UnfollowArtistsOrUsersRequest,0,0,0,0,0,0,0,1,1
thelinmichael_spotify-web-api-java.se.michaelthelin.spotify.requests.data.follow.CheckUsersFollowPlaylistRequest,0,0,0,0,0,0,0,1,1
thelinmichael_spotify-web-api-java.se.michaelthelin.spotify.requests.data.follow.legacy.UnfollowPlaylistRequest,0,0,0,0,0,0,0,1,1
thelinmichael_spotify-web-api-java.se.michaelthelin.spotify.requests.data.follow.legacy.FollowPlaylistRequest,0,0,0,0,0,0,0,1,1
thelinmichael_spotify-web-api-java.se.michaelthelin.spotify.requests.data.library.GetUsersSavedTracksRequest,0,0,0,0,0,0,0,1,1
thelinmichael_spotify-web-api-java.se.michaelthelin.spotify.requests.data.library.RemoveUsersSavedShowsRequest,0,0,0,0,0,0,0,1,1
thelinmichael_spotify-web-api-java.se.michaelthelin.spotify.requests.data.library.RemoveUsersSavedTracksRequest,0,0,0,0,0,0,0,1,1
thelinmichael_spotify-web-api-java.se.michaelthelin.spotify.requests.data.library.GetCurrentUsersSavedAlbumsRequest,0,0,0,0,0,0,0,1,1
thelinmichael_spotify-web-api-java.se.michaelthelin.spotify.requests.data.library.CheckUsersSavedTracksRequest,0,0,0,0,0,0,0,1,1
thelinmichael_spotify-web-api-java.se.michaelthelin.spotify.requests.data.library.CheckUsersSavedAlbumsRequest,0,0,0,0,0,0,0,1,1
thelinmichael_spotify-web-api-java.se.michaelthelin.spotify.requests.data.library.SaveShowsForCurrentUserRequest,0,0,0,0,0,0,0,1,1
thelinmichael_spotify-web-api-java.se.michaelthelin.spotify.requests.data.library.CheckUsersSavedShowsRequest,0,0,0,0,0,0,0,1,1
thelinmichael_spotify-web-api-java.se.michaelthelin.spotify.requests.data.library.GetUsersSavedShowsRequest,0,0,0,0,0,0,0,1,1
thelinmichael_spotify-web-api-java.se.michaelthelin.spotify.requests.data.library.SaveTracksForUserRequest,0,0,0,0,0,0,0,1,1
thelinmichael_spotify-web-api-java.se.michaelthelin.spotify.requests.data.library.SaveAlbumsForCurrentUserRequest,0,0,0,0,0,0,0,1,1
thelinmichael_spotify-web-api-java.se.michaelthelin.spotify.requests.data.library.RemoveAlbumsForCurrentUserRequest,0,0,0,0,0,0,0,1,1
thelinmichael_spotify-web-api-java.se.michaelthelin.spotify.requests.data.playlists.ReplacePlaylistsItemsRequest,0,0,0,0,0,0,0,1,1
thelinmichael_spotify-web-api-java.se.michaelthelin.spotify.requests.data.playlists.ReorderPlaylistsItemsRequest,0,0,0,0,0,0,0,1,1
thelinmichael_spotify-web-api-java.se.michaelthelin.spotify.requests.data.playlists.AddItemsToPlaylistRequest,0,0,0,0,0,0,0,1,1
thelinmichael_spotify-web-api-java.se.michaelthelin.spotify.requests.data.playlists.GetPlaylistRequest,0,0,0,0,0,0,0,1,1
thelinmichael_spotify-web-api-java.se.michaelthelin.spotify.requests.data.playlists.GetListOfCurrentUsersPlaylistsRequest,0,0,0,0,0,0,0,1,1
thelinmichael_spotify-web-api-java.se.michaelthelin.spotify.requests.data.playlists.CreatePlaylistRequest,0,0,0,0,0,0,0,1,1
thelinmichael_spotify-web-api-java.se.michaelthelin.spotify.requests.data.playlists.GetPlaylistCoverImageRequest,0,0,0,0,0,0,0,1,1
thelinmichael_spotify-web-api-java.se.michaelthelin.spotify.requests.data.playlists.UploadCustomPlaylistCoverImageRequest,0,0,0,0,0,0,0,1,1
thelinmichael_spotify-web-api-java.se.michaelthelin.spotify.requests.data.playlists.RemoveItemsFromPlaylistRequest,0,0,0,0,0,0,0,1,1
thelinmichael_spotify-web-api-java.se.michaelthelin.spotify.requests.data.playlists.GetPlaylistsItemsRequest,0,0,0,0,0,0,0,2,2
thelinmichael_spotify-web-api-java.se.michaelthelin.spotify.requests.data.playlists.ChangePlaylistsDetailsRequest,0,0,0,0,0,0,0,1,1
thelinmichael_spotify-web-api-java.se.michaelthelin.spotify.requests.data.playlists.GetListOfUsersPlaylistsRequest,0,0,0,0,0,0,0,1,1
paukiatwee_budgetapp.io.budgetapp.model.form.SignUpForm,1,0,0,1,0,0,0,0,2
paukiatwee_budgetapp.io.budgetapp.model.form.user.Password,1,0,0,1,0,0,0,0,2
paukiatwee_budgetapp.io.budgetapp.model.form.TransactionForm,2,0,0,2,0,0,0,0,4
paukiatwee_budgetapp.io.budgetapp.model.Category,2,0,0,2,0,0,0,0,4
paukiatwee_budgetapp.io.budgetapp.model.form.budget.BudgetForm,2,0,0,2,0,0,0,0,4
paukiatwee_budgetapp.io.budgetapp.util.Util,6,0,0,2,0,0,0,0,8
arquillian_arquillian-cube.org.arquillian.cube.docker.impl.docker.compose.DockerComposeConverter,12,1,0,12,0,0,0,0,25
arquillian_arquillian-cube.org.arquillian.cube.impl.util.IOUtil,3,0,0,0,0,0,0,0,3
arquillian_arquillian-cube.org.arquillian.cube.docker.impl.docker.DockerClientExecutor,1,0,0,0,0,0,0,0,1
arquillian_arquillian-cube.org.arquillian.cube.docker.impl.client.CubeDockerConfiguration,18,0,0,18,0,0,0,0,36
arquillian_arquillian-cube.org.arquillian.cube.docker.impl.util.GitHubUtil,0,0,0,0,0,0,0,0,0
arquillian_arquillian-cube.org.arquillian.cube.docker.impl.util.Top,0,0,0,0,0,0,0,0,0
arquillian_arquillian-cube.org.arquillian.cube.docker.impl.util.AutoStartOrderUtil,0,0,0,0,0,0,0,10,10
arquillian_arquillian-cube.org.arquillian.cube.docker.impl.util.HomeResolverUtil,0,0,0,0,0,0,0,0,0
arquillian_arquillian-cube.org.arquillian.cube.docker.impl.util.DockerFileUtil,0,0,0,0,0,0,0,0,0
arquillian_arquillian-cube.org.arquillian.cube.docker.impl.util.DockerMachine,3,0,0,3,0,0,0,0,6
arquillian_arquillian-cube.org.arquillian.cube.docker.impl.model.DockerCube,10,0,0,5,0,0,0,0,15
arquillian_arquillian-cube.org.arquillian.cube.docker.impl.util.ConfigUtil,1,0,0,1,0,0,0,5,7
arquillian_arquillian-cube.org.arquillian.cube.docker.impl.util.OperatingSystemInterface,3,0,0,3,0,0,0,0,6
arquillian_arquillian-cube.org.arquillian.cube.docker.impl.client.DockerContainerDefinitionParser,0,0,0,0,0,0,0,0,0
arquillian_arquillian-cube.org.arquillian.cube.spi.CubeRegistry,2,0,0,2,0,0,0,0,4
arquillian_arquillian-cube.org.arquillian.cube.spi.CubeConfiguration,12,0,0,12,0,0,0,4,28
arquillian_arquillian-cube.org.arquillian.cube.docker.impl.client.SystemPropertiesCubeSetter,2,0,0,0,0,0,0,0,2
arquillian_arquillian-cube.org.arquillian.cube.docker.impl.client.CubeDockerConfigurationResolver,4,1,0,4,0,0,0,0,9
arquillian_arquillian-cube.org.arquillian.cube.docker.impl.client.containerobject.CubeContainerObjectTestEnricher,7,0,0,7,0,0,0,0,14
arquillian_arquillian-cube.org.arquillian.cube.docker.impl.client.containerobject.DockerContainerObjectBuilder,9,0,0,9,0,9,0,0,27
arquillian_arquillian-cube.org.arquillian.cube.docker.impl.client.containerobject.dsl.ContainerNetworkObjectDslTestEnricher,0,0,0,0,0,0,0,1,1
arquillian_arquillian-cube.org.arquillian.cube.docker.impl.client.config.Image,8,0,0,8,0,0,0,0,16
arquillian_arquillian-cube.org.arquillian.cube.docker.impl.client.config.CustomBeforeStopAction,0,0,0,0,0,0,0,0,0
arquillian_arquillian-cube.org.arquillian.cube.docker.impl.client.config.CustomAfterStartAction,0,0,0,0,0,0,0,0,0
arquillian_arquillian-cube.org.arquillian.cube.docker.impl.requirement.DockerMachineRequirement,0,0,0,0,0,0,0,1,1
arquillian_arquillian-cube.org.arquillian.cube.docker.impl.requirement.DockerRequirement,0,0,0,0,0,0,0,1,1
arquillian_arquillian-cube.org.arquillian.cube.docker.impl.client.config.DockerCompositions,1,0,0,1,0,0,0,0,2
arquillian_arquillian-cube.org.arquillian.cube.docker.impl.client.config.Await,11,0,0,11,0,0,0,0,22
arquillian_arquillian-cube.org.arquillian.cube.docker.impl.await.AwaitStrategyFactory,0,0,0,0,0,0,0,0,0
arquillian_arquillian-cube.org.arquillian.cube.docker.impl.client.config.CubeContainer,0,0,0,0,0,0,0,0,0
arquillian_arquillian-cube.org.arquillian.cube.TopContainer,5,0,0,5,0,0,2,0,12
arquillian_arquillian-cube.org.arquillian.cube.CubeController,0,0,0,0,0,0,0,8,8
arquillian_arquillian-cube.org.arquillian.cube.docker.restassured.AuthenticationSchemeFactory,7,0,0,0,0,0,0,0,7
arquillian_arquillian-cube.org.arquillian.cube.docker.restassured.RestAssuredCustomizer,0,0,0,0,0,0,0,7,7
arquillian_arquillian-cube.org.arquillian.cube.docker.drone.SeleniumContainers,8,0,0,8,0,0,0,0,16
arquillian_arquillian-cube.org.arquillian.cube.docker.drone.CubeDroneConfiguration,0,0,0,0,0,0,0,3,3
arquillian_arquillian-cube.org.arquillian.cube.docker.drone.VncRecorderLifecycleManager,1,0,0,0,0,0,0,2,3
arquillian_arquillian-cube.org.arquillian.cube.docker.junit5.ContainerDsl,1,0,0,1,0,0,0,0,2
arquillian_arquillian-cube.org.arquillian.cube.docker.junit5.NetworkDsl,0,0,0,0,0,0,0,0,0
arquillian_arquillian-cube.org.arquillian.cube.spi.CubeOutput,0,0,0,0,0,0,0,0,0
arquillian_arquillian-cube.org.arquillian.cube.docker.junit.rule.NetworkDslRule,0,0,0,0,0,0,0,0,0
arquillian_arquillian-cube.org.arquillian.cube.docker.junit.rule.ContainerDslRule,0,0,0,0,0,0,0,0,0
arquillian_arquillian-cube.org.arquillian.cube.persistence.UserRepository,0,0,0,0,0,0,0,2,2
arquillian_arquillian-cube.org.arquillian.cube.docker.impl.client.utils.NumberConversion,0,0,0,0,0,0,0,0,0
arquillian_arquillian-cube.org.arquillian.cube.docker.impl.client.reporter.TakeDockerEnvironment,1,0,0,0,0,0,0,0,1
arquillian_arquillian-cube.org.arquillian.cube.docker.impl.client.reporter.TakeVncDroneVideo,2,0,0,0,0,0,0,0,2
arquillian_arquillian-cube.org.arquillian.cube.docker.impl.client.containerobject.dsl.Container,0,0,0,0,0,0,0,0,0
arquillian_arquillian-cube.org.arquillian.cube.impl.shrinkwrap.asset.CacheUrlAsset,0,0,0,0,0,0,0,0,0
arquillian_arquillian-cube.org.arquillian.cube.impl.util.Timespan,0,0,0,0,0,0,0,0,0
arquillian_arquillian-cube.org.arquillian.cube.impl.util.Strings,0,0,0,0,0,0,0,0,0
arquillian_arquillian-cube.org.arquillian.cube.impl.EnricherExpressionResolver,0,0,0,0,0,0,0,0,0
arquillian_arquillian-cube.org.arquillian.cube.impl.model.CubeIdFactory,0,0,0,0,0,0,0,0,0
arquillian_arquillian-cube.org.arquillian.cube.spi.Binding,3,0,0,0,0,0,0,0,3
arquillian_arquillian-cube.org.arquillian.cube.impl.client.enricher.HostPortTestEnricher,0,0,0,0,0,0,0,0,0
arquillian_arquillian-cube.org.arquillian.cube.impl.client.enricher.CubeIpTestEnricher,0,0,0,0,0,0,0,0,0
arquillian_arquillian-cube.org.arquillian.cube.impl.client.enricher.HostIpTestEnricher,0,0,0,0,0,0,0,0,0
arquillian_arquillian-cube.org.fabric8.maven.plugin.build.Fabric8MavenPluginResourceGeneratorBuilder,1,0,0,1,0,0,0,0,2
odiszapc_nginx-java-parser.com.github.odiszapc.nginxparser.NgxBlock,10,0,0,2,0,0,0,2,14
odiszapc_nginx-java-parser.com.github.odiszapc.nginxparser.NgxDumper,2,0,0,2,0,0,1,0,5
odiszapc_nginx-java-parser.com.github.odiszapc.nginxparser.NgxAbstractEntry,1,0,0,0,0,0,0,0,1
apache_airavata.org.apache.airavata.model.experiment.UserConfigurationDataModel,3,0,0,1,0,0,0,0,4
apache_airavata.org.apache.airavata.model.data.replica.DataProductModel,3,0,0,3,0,0,0,0,6
apache_airavata.org.apache.airavata.model.workspace.Notification,1,0,1,1,0,0,0,0,3
apache_airavata.org.apache.airavata.model.workspace.Gateway,17,0,14,17,0,0,0,0,48
apache_airavata.org.apache.airavata.model.experiment.ExperimentModel,3,0,1,3,0,0,0,0,7
apache_airavata.org.apache.airavata.model.status.QueueStatusModel,1,0,1,1,0,0,0,0,3
apache_airavata.org.apache.airavata.model.user.UserProfile,2,0,0,2,0,0,0,0,4
apache_airavata.org.apache.airavata.model.appcatalog.storageresource.StorageResourceDescription,1,1,1,1,0,0,0,0,4
apache_airavata.org.apache.airavata.model.appcatalog.computeresource.JobSubmissionInterface,1,0,0,1,0,0,0,0,2
apache_airavata.org.apache.airavata.model.appcatalog.groupresourceprofile.GroupResourceProfile,5,1,1,5,0,0,0,0,12
apache_airavata.org.apache.airavata.model.appcatalog.computeresource.ComputeResourceDescription,7,0,0,5,0,0,0,0,12
apache_airavata.org.apache.airavata.model.appcatalog.computeresource.ResourceJobManager,0,0,0,0,0,0,0,0,0
apache_airavata.org.apache.airavata.model.appcatalog.userresourceprofile.UserComputeResourcePreference,1,0,1,1,0,0,0,0,3
apache_airavata.org.apache.airavata.model.appcatalog.appdeployment.ApplicationModule,5,0,0,5,0,0,0,0,10
apache_airavata.org.apache.airavata.model.appcatalog.appinterface.ApplicationInterfaceDescription,6,0,0,6,0,0,0,0,12
apache_airavata.org.apache.airavata.model.appcatalog.gatewaygroups.GatewayGroups,2,0,0,2,0,0,0,0,4
apache_airavata.org.apache.airavata.model.appcatalog.gatewayprofile.GatewayResourceProfile,1,1,0,1,0,0,0,0,3
apache_airavata.org.apache.airavata.model.appcatalog.appdeployment.ApplicationDeploymentDescription,4,0,0,0,0,0,0,0,4
apache_airavata.org.apache.airavata.model.workflow.AiravataWorkflow,1,0,0,1,0,0,0,0,2
apache_airavata.org.apache.airavata.model.util.GroupComputeResourcePreferenceUtil,0,0,0,0,0,0,0,0,0
arangodb_arangodb-java-driver.com.arangodb.ArangoDBException,3,1,0,2,0,2,0,0,8
arangodb_arangodb-java-driver.com.arangodb.ArangoDB,1,0,0,1,0,0,0,0,2
arangodb_arangodb-java-driver.com.arangodb.ArangoDBMultipleException,1,0,0,0,0,0,0,0,1
arangodb_arangodb-java-driver.com.arangodb.entity.BaseDocument,56,0,0,45,0,8,0,0,109
arangodb_arangodb-java-driver.com.arangodb.internal.DocumentCache,1,0,0,1,0,0,0,0,2
arangodb_arangodb-java-driver.com.arangodb.internal.net.HostHandler,6,1,0,5,0,1,0,0,13
arangodb_arangodb-java-driver.com.arangodb.util.ArangoDeserializer,0,0,0,0,0,0,0,0,0
arangodb_arangodb-java-driver.com.arangodb.util.ArangoSerializer,1,0,0,0,0,0,0,0,1
arangodb_arangodb-java-driver.com.arangodb.util.UnicodeUtils,0,0,0,0,0,0,0,0,0
arangodb_arangodb-java-driver.com.arangodb.internal.util.EncodeUtils,0,0,0,0,0,0,0,0,0
arangodb_arangodb-java-driver.com.arangodb.util.MapBuilder,9,0,0,9,0,0,0,0,18
arangodb_arangodb-java-driver.com.arangodb.entity.CollectionEntity,3,0,0,1,0,1,0,0,5
arangodb_arangodb-java-driver.com.arangodb.model.DocumentCreateOptions,3,0,0,0,0,3,0,0,6
arangodb_arangodb-java-driver.com.arangodb.entity.DocumentEntity,9,0,0,8,0,2,0,0,19
arangodb_arangodb-java-driver.com.arangodb.entity.MultiDocumentEntity,3,0,0,3,0,0,0,0,6
arangodb_arangodb-java-driver.com.arangodb.model.DocumentDeleteOptions,0,0,0,0,0,1,0,0,1
arangodb_arangodb-java-driver.com.arangodb.entity.IndexEntity,7,0,0,1,0,3,0,0,11
arangodb_arangodb-java-driver.com.arangodb.model.IndexOptions,9,3,0,9,0,0,0,0,21
arangodb_arangodb-java-driver.com.arangodb.model.ZKDIndexOptions,1,0,0,1,0,0,0,0,2
arangodb_arangodb-java-driver.com.arangodb.model.DocumentExistsOptions,0,0,0,0,0,0,0,0,0
arangodb_arangodb-java-driver.com.arangodb.model.DocumentImportOptions,12,0,0,2,0,2,0,0,16
arangodb_arangodb-java-driver.com.arangodb.entity.CollectionPropertiesEntity,4,0,0,4,0,0,0,0,8
arangodb_arangodb-java-driver.com.arangodb.model.CollectionCreateOptions,9,0,0,8,0,2,0,0,19
arangodb_arangodb-java-driver.com.arangodb.entity.ShardEntity,1,0,0,0,0,0,0,0,1
arangodb_arangodb-java-driver.com.arangodb.async.ArangoDBAsync,29,1,0,26,0,6,0,7,69
arangodb_arangodb-java-driver.com.arangodb.DbName,4,0,0,3,0,0,0,0,7
arangodb_arangodb-java-driver.com.arangodb.entity.LogLevelEntity,1,0,0,1,0,0,0,0,2
arangodb_arangodb-java-driver.com.arangodb.model.VertexCreateOptions,1,0,0,1,0,0,0,0,2
arangodb_arangodb-java-driver.com.arangodb.async.ArangoVertexCollectionAsync,1,0,0,1,0,0,0,0,2
arangodb_arangodb-java-driver.com.arangodb.entity.StreamTransactionEntity,6,0,0,6,0,2,0,2,16
arangodb_arangodb-java-driver.com.arangodb.async.ArangoEdgeCollectionAsync,1,0,0,1,0,0,0,0,2
arangodb_arangodb-java-driver.com.arangodb.async.ArangoCollectionAsync,0,0,0,0,0,1,0,0,1
arangodb_arangodb-java-driver.com.arangodb.model.GraphDocumentReadOptions,4,0,0,4,0,4,0,0,12
arangodb_arangodb-java-driver.com.arangodb.model.VertexDeleteOptions,0,0,0,0,0,2,0,0,2
arangodb_arangodb-java-driver.com.arangodb.model.EdgeDeleteOptions,0,0,0,0,0,2,0,0,2
arangodb_arangodb-java-driver.com.arangodb.model.DocumentReadOptions,0,0,0,0,0,2,0,0,2
arangodb_arangodb-java-driver.com.arangodb.entity.ArangoDBEngine,1,0,0,0,0,0,0,0,1
arangodb_arangodb-java-driver.com.arangodb.model.CollectionsReadOptions,1,0,0,0,0,0,0,0,1
arangodb_arangodb-java-driver.com.arangodb.model.AqlQueryOptions,5,0,0,3,0,3,0,0,11
arangodb_arangodb-java-driver.com.arangodb.entity.QueryCachePropertiesEntity,2,0,0,2,0,0,0,0,4
arangodb_arangodb-java-driver.com.arangodb.entity.QueryTrackingPropertiesEntity,2,0,0,2,0,0,0,0,4
arangodb_arangodb-java-driver.com.arangodb.model.AqlFunctionDeleteOptions,1,0,0,0,0,0,0,0,1
arangodb_arangodb-java-driver.com.arangodb.model.TransactionOptions,1,0,0,0,0,1,0,0,2
arangodb_arangodb-java-driver.com.arangodb.entity.DatabaseEntity,1,1,0,1,0,1,0,0,4
arangodb_arangodb-java-driver.com.arangodb.entity.GraphEntity,3,1,0,2,0,0,0,0,6
arangodb_arangodb-java-driver.com.arangodb.model.GraphCreateOptions,1,0,0,1,0,0,0,0,2
arangodb_arangodb-java-driver.com.arangodb.async.ArangoGraphAsync,1,0,0,1,0,0,0,0,2
arangodb_arangodb-java-driver.com.arangodb.entity.EdgeDefinition,8,2,0,6,0,0,0,0,16
arangodb_arangodb-java-driver.com.arangodb.entity.ViewEntity,4,0,0,4,0,0,0,0,8
arangodb_arangodb-java-driver.com.arangodb.async.ArangoViewAsync,0,0,0,0,0,0,0,0,0
arangodb_arangodb-java-driver.com.arangodb.entity.arangosearch.PrimarySort,1,0,0,1,0,0,0,0,2
arangodb_arangodb-java-driver.com.arangodb.model.arangosearch.ArangoSearchCreateOptions,1,0,0,1,0,0,0,0,2
arangodb_arangodb-java-driver.com.arangodb.async.ArangoSearchAsync,3,0,0,3,0,0,0,0,6
arangodb_arangodb-java-driver.com.arangodb.entity.arangosearch.AnalyzerEntity,0,0,0,0,0,0,0,6,6
arangodb_arangodb-java-driver.com.arangodb.entity.arangosearch.analyzer.SearchAnalyzer,0,0,0,0,0,0,0,1,1
arangodb_arangodb-java-driver.com.arangodb.entity.arangosearch.analyzer.DelimiterAnalyzerProperties,0,0,0,0,0,0,0,1,1
arangodb_arangodb-java-driver.com.arangodb.entity.arangosearch.analyzer.StemAnalyzerProperties,0,0,0,0,0,0,0,1,1
arangodb_arangodb-java-driver.com.arangodb.entity.arangosearch.analyzer.NormAnalyzerProperties,0,0,0,0,0,0,0,1,1
arangodb_arangodb-java-driver.com.arangodb.entity.arangosearch.analyzer.NGramAnalyzerProperties,0,0,0,0,0,0,0,1,1
arangodb_arangodb-java-driver.com.arangodb.entity.arangosearch.analyzer.TextAnalyzerProperties,0,0,0,0,0,0,0,1,1
arangodb_arangodb-java-driver.com.arangodb.mapping.ArangoJack,4,0,0,4,0,0,0,0,8
arangodb_arangodb-java-driver.com.arangodb.ArangoCursor,8,0,0,0,0,0,0,0,8
arangodb_arangodb-java-driver.com.arangodb.entity.DocumentCreateEntity,1,0,0,1,0,0,0,0,2
arangodb_arangodb-java-driver.com.arangodb.ArangoSerializationAccessor,0,0,0,0,0,0,0,0,0
googlegenomics_dataflow-java.com.google.cloud.genomics.dataflow.utils.GCSHelper,0,0,0,0,0,0,0,0,0
googlegenomics_dataflow-java.com.google.cloud.genomics.dataflow.utils.AnnotationUtils,5,0,0,0,0,0,0,0,5
googlegenomics_dataflow-java.com.google.cloud.genomics.dataflow.readers.bam.BAMShard,3,0,0,3,0,0,0,0,6
googlegenomics_dataflow-java.com.google.cloud.genomics.dataflow.pipelines.ShardedBAMWriting,1,0,0,0,0,0,0,0,1
googlegenomics_dataflow-java.com.google.cloud.genomics.dataflow.functions.verifybamid.ReadFunctions,0,0,0,0,0,0,0,0,0
googlegenomics_dataflow-java.com.google.cloud.genomics.dataflow.functions.verifybamid.LikelihoodFn,1,0,0,1,0,0,0,0,2
googlegenomics_dataflow-java.com.google.cloud.genomics.dataflow.functions.verifybamid.Solver,2,0,0,1,0,0,0,0,3
googlegenomics_dataflow-java.com.google.cloud.genomics.dataflow.functions.ibs.CallSimilarityCalculator,3,0,0,0,0,0,0,0,3
googlegenomics_dataflow-java.com.google.cloud.genomics.dataflow.coders.GenericJsonCoder,1,0,0,0,0,0,0,0,1
eclipsesource_J2V8.com.eclipsesource.v8.inspector.V8Inspector,0,0,0,0,0,2,0,1,3
eclipsesource_J2V8.com.eclipsesource.v8.V8Value,0,0,0,0,0,0,0,2,2
eclipsesource_J2V8.com.eclipsesource.v8.V8,110,0,0,71,0,24,0,24,229
eclipsesource_J2V8.com.eclipsesource.v8.V8Object,43,0,0,43,0,0,0,48,134
eclipsesource_J2V8.com.eclipsesource.v8.V8Array,57,0,0,56,0,0,0,1,114
eclipsesource_J2V8.com.eclipsesource.v8.V8ArrayBuffer,16,0,0,16,0,0,0,0,32
eclipsesource_J2V8.com.eclipsesource.v8.V8ScriptException,0,0,0,0,0,0,0,0,0
eclipsesource_J2V8.com.eclipsesource.v8.V8TypedArray,0,0,0,0,0,0,0,0,0
eclipsesource_J2V8.com.eclipsesource.v8.utils.TypedArray,0,0,0,0,0,0,0,0,0
eclipsesource_J2V8.com.eclipsesource.v8.NodeJS,0,0,0,0,0,1,0,0,1
eclipsesource_J2V8.com.eclipsesource.v8.V8Function,0,0,0,0,0,0,0,0,0
eclipsesource_J2V8.com.eclipsesource.v8.V8Locker,2,0,0,0,0,2,0,5,9
eclipsesource_J2V8.com.eclipsesource.v8.utils.V8PropertyMap,10,0,0,9,0,0,0,0,19
eclipsesource_J2V8.com.eclipsesource.v8.utils.ConcurrentV8,2,0,0,0,0,2,0,0,4
eclipsesource_J2V8.com.eclipsesource.v8.utils.V8ObjectUtils,96,0,0,94,0,0,0,3,193
eclipsesource_J2V8.com.eclipsesource.v8.utils.V8Map,5,0,0,5,0,0,0,4,14
eclipsesource_J2V8.com.eclipsesource.v8.utils.MemoryManager,6,0,0,6,0,0,0,1,13
eclipsesource_J2V8.com.eclipsesource.v8.utils.ArrayBuffer,0,0,0,0,0,0,0,0,0
eclipsesource_J2V8.com.eclipsesource.v8.utils.V8Executor,4,0,0,4,0,0,0,1,9
eclipsesource_J2V8.com.eclipsesource.v8.debug.mirror.Frame,1,0,0,1,0,0,0,0,2
eclipsesource_J2V8.com.eclipsesource.v8.debug.mirror.Mirror,0,0,0,0,0,0,0,0,0
eclipsesource_J2V8.com.eclipsesource.v8.debug.mirror.Scope,0,0,0,0,0,0,0,0,0
eclipsesource_J2V8.com.eclipsesource.v8.debug.ExecutionState,0,0,0,0,0,0,0,3,3
eclipsesource_J2V8.com.eclipsesource.v8.debug.ScriptBreakPoint,1,0,0,1,0,0,0,2,4
eclipsesource_J2V8.com.eclipsesource.v8.debug.BreakEvent,0,0,0,0,0,0,0,0,0
eclipsesource_J2V8.com.eclipsesource.v8.debug.DebugHandler,1,0,0,1,0,0,0,7,9
JasonRuckman_sidney.com.github.jasonruckman.sidney.core.AbstractSid,0,0,0,0,0,0,0,0,0
alaisi_postgres-async-driver.com.pgasync.ResultSet,2,0,0,2,0,0,0,0,4
alaisi_postgres-async-driver.com.pgasync.Row,0,0,0,0,0,0,0,0,0
alaisi_postgres-async-driver.com.pgasync.QueryExecutor,0,0,0,0,0,0,0,0,0
alaisi_postgres-async-driver.com.pgasync.Connectible,1,0,0,1,0,0,0,5,7
vogellacompany_eclipse4book.com.vogella.tasks.services.internal.TransientTaskServiceImpl,0,0,0,0,0,0,0,0,0
hcoles_QuickBuilder.org.pitest.quickbuilder.Maybe,1,0,0,1,0,0,0,0,2
hcoles_QuickBuilder.org.pitest.quickbuilder.builders.QB,12,0,0,0,0,6,0,0,18
hcoles_QuickBuilder.org.pitest.quickbuilder.Builder,1,0,0,0,0,0,0,0,1
hcoles_QuickBuilder.org.pitest.quickbuilder.internal.StringUtils,0,0,0,0,0,0,0,0,0
hcoles_QuickBuilder.org.pitest.quickbuilder.common.BuilderIterable,2,0,0,2,0,0,0,0,4
hcoles_QuickBuilder.org.pitest.quickbuilder.SequenceBuilder,5,0,0,5,0,0,0,0,10
hcoles_QuickBuilder.org.pitest.quickbuilder.common.NullBuilder,0,0,0,0,0,0,0,0,0
hcoles_QuickBuilder.org.pitest.quickbuilder.common.SequenceWrapper,0,0,0,0,0,0,0,0,0
hcoles_QuickBuilder.org.pitest.quickbuilder.common.Integers,0,0,0,0,0,0,0,0,0
hcoles_QuickBuilder.org.pitest.quickbuilder.common.ConvertingBuilder,0,0,0,0,0,0,0,0,0
hcoles_QuickBuilder.org.pitest.quickbuilder.common.NonBuilder,1,0,0,1,0,0,0,0,2
hcoles_QuickBuilder.org.pitest.quickbuilder.builders.Builders,1,0,0,0,0,0,0,0,1
hcoles_QuickBuilder.org.pitest.quickbuilder.common.ElementSequence,1,0,0,1,0,0,0,0,2
stuartgunter_dropwizard-cassandra.systems.composable.dropwizard.cassandra.CassandraFactory,0,0,0,0,0,0,0,0,0
stuartgunter_dropwizard-cassandra.systems.composable.dropwizard.cassandra.CassandraManager,0,0,0,0,0,0,0,2,2
stuartgunter_dropwizard-cassandra.systems.composable.dropwizard.cassandra.CassandraMetricSet,0,0,0,0,0,0,0,0,0
stuartgunter_dropwizard-cassandra.systems.composable.dropwizard.cassandra.speculativeexecution.ConstantSpeculativeExecutionPolicyFactory,0,0,0,0,0,0,0,0,0
stuartgunter_dropwizard-cassandra.systems.composable.dropwizard.cassandra.speculativeexecution.NoSpeculativeExecutionPolicyFactory,0,0,0,0,0,0,0,0,0
stuartgunter_dropwizard-cassandra.systems.composable.dropwizard.cassandra.pooling.PoolingOptionsFactory,2,0,0,1,0,0,0,0,3
stuartgunter_dropwizard-cassandra.systems.composable.dropwizard.cassandra.reconnection.ExponentialReconnectionPolicyFactory,1,0,0,1,0,0,0,0,2
stuartgunter_dropwizard-cassandra.systems.composable.dropwizard.cassandra.reconnection.ConstantReconnectionPolicyFactory,0,0,0,0,0,0,0,0,0
stuartgunter_dropwizard-cassandra.systems.composable.dropwizard.cassandra.network.EC2MultiRegionAddressTranslatorFactory,0,0,0,0,0,0,0,0,0
stuartgunter_dropwizard-cassandra.systems.composable.dropwizard.cassandra.retry.LoggingRetryPolicyFactory,0,0,0,0,0,0,0,1,1
stuartgunter_dropwizard-cassandra.systems.composable.dropwizard.cassandra.retry.DowngradingConsistencyRetryPolicyFactory,0,0,0,0,0,0,0,0,0
stuartgunter_dropwizard-cassandra.systems.composable.dropwizard.cassandra.retry.DefaultRetryPolicyFactory,0,0,0,0,0,0,0,0,0
stuartgunter_dropwizard-cassandra.systems.composable.dropwizard.cassandra.retry.FallthroughRetryPolicyFactory,0,0,0,0,0,0,0,0,0
stuartgunter_dropwizard-cassandra.systems.composable.dropwizard.cassandra.ssl.JDKSSLOptionsFactory,0,0,0,0,0,0,0,0,0
stuartgunter_dropwizard-cassandra.systems.composable.dropwizard.cassandra.ssl.NettySSLOptionsFactory,0,0,0,0,0,0,0,0,0
stuartgunter_dropwizard-cassandra.systems.composable.dropwizard.cassandra.loadbalancing.LatencyAwarePolicyFactory,0,0,0,0,0,0,0,0,0
stuartgunter_dropwizard-cassandra.systems.composable.dropwizard.cassandra.loadbalancing.ErrorAwarePolicyFactory,0,0,0,0,0,0,0,0,0
stuartgunter_dropwizard-cassandra.systems.composable.dropwizard.cassandra.loadbalancing.DCAwareRoundRobinPolicyFactory,0,0,0,0,0,0,0,0,0
stuartgunter_dropwizard-cassandra.systems.composable.dropwizard.cassandra.loadbalancing.WhiteListPolicyFactory,0,0,0,0,0,0,0,0,0
stuartgunter_dropwizard-cassandra.systems.composable.dropwizard.cassandra.loadbalancing.TokenAwarePolicyFactory,0,0,0,0,0,0,0,0,0
stuartgunter_dropwizard-cassandra.systems.composable.dropwizard.cassandra.loadbalancing.RoundRobinPolicyFactory,0,0,0,0,0,0,0,0,0
kennycason_kumo.com.kennycason.kumo.nlp.tokenizer.api.WordTokenizer,3,0,0,0,0,0,0,0,3
kennycason_kumo.com.kennycason.kumo.WordCloud,1,1,0,1,0,0,0,3,6
kennycason_kumo.com.kennycason.kumo.nlp.FrequencyAnalyzer,5,0,0,5,0,0,3,38,51
kennycason_kumo.com.kennycason.kumo.ImageProcessor,0,0,0,0,0,0,0,1,1
kennycason_kumo.com.kennycason.kumo.nlp.FrequencyFileLoader,1,0,0,1,0,0,0,0,2
kennycason_kumo.com.kennycason.kumo.WordFrequency,1,0,0,1,0,0,0,0,2
kennycason_kumo.com.kennycason.kumo.font.scale.SqrtFontScalar,1,0,0,0,0,0,0,0,1
kennycason_kumo.com.kennycason.kumo.font.scale.LinearFontScalar,1,0,0,0,0,0,0,0,1
kennycason_kumo.com.kennycason.kumo.font.scale.LogFontScalar,1,0,0,0,0,0,0,0,1
kennycason_kumo.com.kennycason.kumo.palette.ColorPalette,2,0,0,0,0,0,0,0,2
kennycason_kumo.com.kennycason.kumo.image.CollisionRaster,3,1,0,3,0,0,0,0,7
oxo42_stateless4j.com.github.oxo42.stateless4j.StateMachine,0,0,0,0,0,0,0,1,1
oxo42_stateless4j.com.github.oxo42.stateless4j.transitions.Transition,0,0,0,0,0,0,0,0,0
Plaid_plaid-java.com.plaid.client.model.ItemWebhookUpdateRequest,2,0,0,2,0,0,0,0,4
Plaid_plaid-java.com.plaid.client.model.ItemImportRequestUserAuth,3,0,0,3,0,0,0,0,6
Plaid_plaid-java.com.plaid.client.model.Category,1,0,0,1,0,0,0,0,2
Plaid_plaid-java.com.plaid.client.model.AssetReportPDFGetRequest,0,0,0,0,0,0,0,0,0
Plaid_plaid-java.com.plaid.client.model.ItemPublicTokenExchangeRequest,1,0,0,0,0,0,0,0,1
Plaid_plaid-java.com.plaid.client.model.ItemImportRequestOptions,1,0,0,1,0,0,0,0,2
Plaid_plaid-java.com.plaid.client.model.AssetReportAuditCopyCreateRequest,1,0,0,1,0,0,0,0,2
Plaid_plaid-java.com.plaid.client.model.LinkTokenCreateRequestUser,5,0,0,5,0,0,0,0,10
Plaid_plaid-java.com.plaid.client.model.InvestmentsHoldingsGetRequest,2,0,0,2,0,0,0,0,4
Plaid_plaid-java.com.plaid.client.model.AssetReportRemoveRequest,0,0,0,0,0,0,0,0,0
Plaid_plaid-java.com.plaid.client.model.AssetReportGetResponse,4,0,0,4,0,0,0,0,8
Plaid_plaid-java.com.plaid.client.model.AccountsBalanceGetRequest,2,0,0,1,0,0,0,0,3
Plaid_plaid-java.com.plaid.client.model.LinkTokenGetRequest,0,0,0,0,0,0,0,0,0
Plaid_plaid-java.com.plaid.client.model.InvestmentsTransactionsGetRequestOptions,1,1,0,1,0,0,0,0,3
Plaid_plaid-java.com.plaid.client.model.AccountsGetRequest,5,1,0,4,0,0,0,0,10
Plaid_plaid-java.com.plaid.client.model.InvestmentsTransactionsGetRequest,0,0,0,0,0,0,0,0,0
Plaid_plaid-java.com.plaid.client.model.IdentityGetRequest,1,0,0,1,0,0,0,0,2
Plaid_plaid-java.com.plaid.client.model.WebhookVerificationKeyGetRequest,1,0,0,0,0,0,0,0,1
Plaid_plaid-java.com.plaid.client.model.ItemAccessTokenInvalidateRequest,1,0,0,0,0,0,0,0,1
Plaid_plaid-java.com.plaid.client.model.IncomeVerificationTaxformsGetRequest,1,0,0,1,0,0,0,0,2
Plaid_plaid-java.com.plaid.client.model.ItemGetRequest,2,0,0,1,0,0,0,0,3
Plaid_plaid-java.com.plaid.client.model.PaymentInitiationRecipientGetRequest,2,0,0,0,0,0,0,0,2
Plaid_plaid-java.com.plaid.client.model.ItemRemoveRequest,0,0,0,0,0,0,0,0,0
Plaid_plaid-java.com.plaid.client.model.InstitutionsSearchRequest,1,0,0,1,0,0,0,0,2
Plaid_plaid-java.com.plaid.client.model.InstitutionsSearchRequestOptions,3,0,0,3,0,0,0,0,6
Plaid_plaid-java.com.plaid.client.model.SandboxItemResetLoginRequest,1,0,0,0,0,0,0,0,1
Plaid_plaid-java.com.plaid.client.model.PaymentInitiationPaymentListRequest,1,1,0,1,0,0,0,0,3
Plaid_plaid-java.com.plaid.client.model.IncomeVerificationPaystubsGetRequest,1,0,0,1,0,0,0,0,2
Plaid_plaid-java.com.plaid.client.model.InstitutionsGetRequest,2,0,0,2,0,0,0,0,4
Plaid_plaid-java.com.plaid.client.model.InstitutionsGetRequestOptions,4,0,0,4,0,0,0,0,8
Plaid_plaid-java.com.plaid.client.model.AuthGetRequest,1,0,0,1,0,0,0,0,2
Plaid_plaid-java.com.plaid.client.model.ProcessorApexProcessorTokenCreateRequest,0,0,0,0,0,0,0,0,0
Plaid_plaid-java.com.plaid.client.model.ProcessorStripeBankAccountTokenCreateRequest,0,0,0,0,0,0,0,0,0
Plaid_plaid-java.com.plaid.client.model.ProcessorTokenCreateRequest,0,0,0,0,0,0,0,0,0
Plaid_plaid-java.com.plaid.client.model.SandboxPublicTokenCreateRequest,1,0,0,1,0,0,0,0,2
Plaid_plaid-java.com.plaid.client.model.InstitutionsGetByIdRequest,0,0,0,0,0,0,0,0,0
Plaid_plaid-java.com.plaid.client.model.InstitutionsGetByIdRequestOptions,4,0,0,4,0,0,0,0,8
Plaid_plaid-java.com.plaid.client.model.TransactionsRefreshRequest,0,0,0,0,0,0,0,0,0
Plaid_plaid-java.com.plaid.client.model.TransactionsGetRequestOptions,1,1,0,1,0,0,0,0,3
Plaid_plaid-java.com.plaid.client.model.TransactionsGetRequest,0,0,0,0,0,0,0,0,0
Plaid_plaid-java.com.plaid.client.model.LiabilitiesGetRequest,3,0,0,3,0,0,0,0,6
Plaid_plaid-java.com.plaid.client.model.BankTransferMigrateAccountRequest,1,0,0,1,0,0,0,0,2
highsource_jaxb2-basics.org.jvnet.jaxb2_commons.xml.namespace.util.QNameUtils,2,0,0,0,0,0,0,0,2
highsource_jaxb2-basics.org.jvnet.jaxb2_commons.reflection.util.Accessor,1,0,0,0,0,0,0,0,1
highsource_jaxb2-basics.org.jvnet.jaxb2_commons.xml.bind.model.util.XmlTypeUtils,0,0,0,0,0,0,0,0,0
highsource_jaxb2-basics.org.jvnet.jaxb2_commons.lang.DefaultEqualsStrategy,0,0,0,0,0,0,0,0,0
highsource_jaxb2-basics.org.jvnet.jaxb2_commons.xml.bind.model.concrete.CMInfoFactory,1,0,0,0,0,0,0,0,1
highsource_jaxb2-basics.org.jvnet.jaxb2_commons.lang.EnumValue,0,0,0,0,0,0,0,0,0
virgo47_javasimon.org.javasimon.javaee.SimonServletFilter,1,0,0,1,0,0,0,0,2
virgo47_javasimon.org.javasimon.javaee.SimonServletFilterUtils,7,0,0,4,0,0,0,0,11
virgo47_javasimon.org.javasimon.javaee.HttpStopwatchSource,0,0,0,0,0,0,0,3,3
virgo47_javasimon.org.javasimon.jdbc4.SimonConnectionConfiguration,1,0,0,1,0,0,0,0,2
virgo47_javasimon.org.javasimon.jdbc4.SqlNormalizer,1,0,0,1,0,0,0,0,2
virgo47_javasimon.org.javasimon.jdbcx4.SimonDataSource,2,0,0,2,0,0,0,0,4
virgo47_javasimon.org.javasimon.SimonPattern,10,0,0,10,0,0,0,0,20
virgo47_javasimon.org.javasimon.Counter,8,0,0,8,0,0,0,0,16
virgo47_javasimon.org.javasimon.Stopwatch,5,0,0,5,0,0,0,0,10
virgo47_javasimon.org.javasimon.SimonManager,12,0,0,12,0,0,0,2,26
virgo47_javasimon.org.javasimon.Simon,2,0,0,2,0,0,0,0,4
virgo47_javasimon.org.javasimon.utils.SimonUtils,1,0,0,0,0,0,0,0,1
virgo47_javasimon.org.javasimon.callback.CompositeCallback,1,0,0,1,0,0,0,0,2
virgo47_javasimon.org.javasimon.EnabledManager,0,0,0,0,0,0,0,0,0
virgo47_javasimon.org.javasimon.ManagerConfiguration,1,0,0,1,0,0,0,0,2
virgo47_javasimon.org.javasimon.callback.CompositeFilterCallback,3,0,0,3,0,0,0,0,6
virgo47_javasimon.org.javasimon.Split,8,0,0,8,0,0,0,0,16
virgo47_javasimon.org.javasimon.IncrementalSimonsPurger,0,0,0,0,0,0,0,1,1
virgo47_javasimon.org.javasimon.utils.StopwatchAggregate,7,0,0,7,0,0,0,0,14
virgo47_javasimon.org.javasimon.StopwatchSample,0,0,0,0,0,0,0,0,0
virgo47_javasimon.org.javasimon.CounterSample,0,0,0,0,0,0,0,0,0
virgo47_javasimon.org.javasimon.utils.CounterAggregate,6,0,0,6,0,0,0,0,12
virgo47_javasimon.org.javasimon.utils.SampleHtmlGenerator,0,0,0,0,0,0,0,1,1
virgo47_javasimon.org.javasimon.utils.bean.ClassUtils,0,0,0,0,0,0,0,0,0
virgo47_javasimon.org.javasimon.utils.bean.SimonBeanUtils,0,0,0,0,0,0,0,0,0
virgo47_javasimon.org.javasimon.utils.bean.ToDoubleConverter,0,0,0,0,0,0,0,0,0
virgo47_javasimon.org.javasimon.utils.bean.NestedResolver,3,0,0,3,0,0,0,0,6
virgo47_javasimon.org.javasimon.jmx.CounterMXBeanImpl,0,0,0,0,0,0,0,0,0
virgo47_javasimon.org.javasimon.jmx.JmxReporter,0,0,0,0,0,0,0,10,10
virgo47_javasimon.org.javasimon.jmx.StopwatchMXBeanImpl,0,0,0,0,0,0,0,0,0
virgo47_javasimon.org.javasimon.jmx.SimonManagerMXBeanImpl,6,0,0,6,0,0,0,3,15
virgo47_javasimon.org.javasimon.callback.logging.LogTemplates,0,0,0,0,0,0,0,2,2
virgo47_javasimon.org.javasimon.clock.SimonClock,1,0,0,0,0,0,0,0,1
virgo47_javasimon.org.javasimon.callback.lastsplits.CircularList,1,0,0,0,0,0,0,1,2
virgo47_javasimon.org.javasimon.callback.lastsplits.LastSplits,2,0,0,1,0,0,0,0,3
virgo47_javasimon.org.javasimon.callback.timeline.TimeRange,1,0,0,0,0,0,0,0,1
virgo47_javasimon.org.javasimon.callback.timeline.StopwatchTimeRange,1,0,0,1,0,0,0,0,2
virgo47_javasimon.org.javasimon.callback.timeline.StopwatchTimeline,1,0,0,1,0,0,0,0,2
virgo47_javasimon.org.javasimon.Manager,1,0,0,1,0,0,0,0,2
virgo47_javasimon.org.javasimon.callback.Callback,1,0,0,1,0,0,0,0,2
virgo47_javasimon.org.javasimon.proxy.Delegating,0,0,0,0,0,0,0,0,0
virgo47_javasimon.org.javasimon.callback.quantiles.Buckets,5,0,0,5,0,0,0,0,10
virgo47_javasimon.org.javasimon.source.AbstractMethodStopwatchSource,0,0,0,0,0,0,0,1,1
virgo47_javasimon.org.javasimon.console.SimonConsolePluginManager,0,0,0,0,0,0,0,1,1
virgo47_javasimon.org.javasimon.console.SimonConsoleRequestProcessor,1,0,0,0,0,0,0,1,2
virgo47_javasimon.org.javasimon.console.json.ObjectJS,2,0,0,2,0,0,0,0,4
virgo47_javasimon.org.javasimon.console.json.AnyJS,0,0,0,0,0,0,0,0,0
virgo47_javasimon.org.javasimon.console.action.ResourceAction,1,0,0,0,0,0,0,0,1
virgo47_javasimon.org.javasimon.console.action.TreeXmlAction,1,0,0,1,0,0,0,0,2
virgo47_javasimon.org.javasimon.console.action.AbstractTableAction,6,0,0,6,0,0,0,0,12
virgo47_javasimon.org.javasimon.console.action.DetailHtmlAction,0,0,0,0,0,0,0,0,0
virgo47_javasimon.org.javasimon.console.action.DetailJsonAction,2,0,0,2,0,0,0,0,4
virgo47_javasimon.org.javasimon.console.action.TreeJsonAction,1,0,0,1,0,0,0,0,2
virgo47_javasimon.org.javasimon.console.action.PluginsJsonAction,2,0,0,2,0,0,0,0,4
virgo47_javasimon.org.javasimon.console.action.ListJsonAction,1,0,0,1,0,0,0,0,2
yfpeng_pengyifan-commons.com.pengyifan.commons.math.MatrixUtils2,0,0,0,0,0,0,0,0,0
yfpeng_pengyifan-commons.com.pengyifan.commons.math.RangeUtils,0,0,0,0,0,0,0,0,0
yfpeng_pengyifan-commons.com.pengyifan.commons.math.SparseRealMatrix,2,0,0,2,0,0,0,1,5
yfpeng_pengyifan-commons.com.pengyifan.commons.math.SparseRealVector,2,0,0,2,0,0,0,1,5
yfpeng_pengyifan-commons.com.pengyifan.commons.lang.IndentStringFormatter,0,0,0,0,0,0,0,3,3
yfpeng_pengyifan-commons.com.pengyifan.commons.collections.ImmutableCollectors,0,0,0,0,0,0,0,0,0
yfpeng_pengyifan-commons.com.pengyifan.commons.collections.tree.Tree,13,0,0,3,0,0,0,0,16
yfpeng_pengyifan-commons.com.pengyifan.commons.collections.heap.FibonacciHeap,1,0,0,0,0,0,0,0,1
yfpeng_pengyifan-commons.com.pengyifan.commons.collections.graph.IndexGraph,0,0,0,0,0,0,0,0,0
yfpeng_pengyifan-commons.com.pengyifan.commons.collections.graph.DirectedLoopGraph,0,0,0,0,0,0,0,0,0
yfpeng_pengyifan-commons.com.pengyifan.commons.collections.graph.ExactSubgraphMatching,2,0,0,0,0,0,0,0,2
yfpeng_pengyifan-commons.com.pengyifan.commons.collections.graph.ExactSubgraphMatchingPredicate,2,0,0,0,0,0,0,0,2
yfpeng_pengyifan-commons.com.pengyifan.util.regex.RegExpPattern,5,0,0,5,0,0,0,0,10
seleniumQuery_seleniumQuery.io.github.seleniumquery.SeleniumQueryObject,145,2,0,142,0,1,0,14,304
seleniumQuery_seleniumQuery.io.github.seleniumquery.internal.fluentfunctions.evaluators.EvaluationReport,0,0,0,0,0,0,0,0,0
seleniumQuery_seleniumQuery.io.github.seleniumquery.internal.fluentfunctions.evaluators.matches.MatchesStringRegexEvaluator,0,0,0,0,0,0,0,0,0
seleniumQuery_seleniumQuery.io.github.seleniumquery.internal.fluentfunctions.evaluators.matches.MatchesPatternEvaluator,0,0,0,0,0,0,0,0,0
seleniumQuery_seleniumQuery.io.github.seleniumquery.internal.fluentfunctions.evaluators.comparison.ComparisonEvaluatorUtils,0,0,0,0,0,0,0,0,0
seleniumQuery_seleniumQuery.io.github.seleniumquery.utils.SelectorUtils,7,0,0,2,0,0,0,1,10
seleniumQuery_seleniumQuery.io.github.seleniumquery.functions.jquery.manipulation.TextFunction,0,0,0,0,0,0,0,0,0
seleniumQuery_seleniumQuery.io.github.seleniumquery.functions.jquery.traversing.filtering.filterfunction.FilterPredicateFunction,1,0,0,1,0,0,0,0,2
seleniumQuery_seleniumQuery.io.github.seleniumquery.functions.jquery.traversing.filtering.filterfunction.FilterSelectorFunction,1,0,0,1,0,0,0,1,3
seleniumQuery_seleniumQuery.io.github.seleniumquery.functions.jquery.events.ClickFunction,1,0,0,0,0,0,0,0,1
seleniumQuery_seleniumQuery.io.github.seleniumquery.functions.jquery.events.DoubleClickFunction,0,0,0,0,0,0,0,2,2
seleniumQuery_seleniumQuery.io.github.seleniumquery.browser.driver.builders.PhantomJSDriverBuilder,0,0,0,0,0,0,0,3,3
seleniumQuery_seleniumQuery.io.github.seleniumquery.by.secondgen.csstree.condition.CssAndCondition,1,0,0,1,0,0,0,0,2
seleniumQuery_seleniumQuery.io.github.seleniumquery.by.secondgen.csstree.CssSelectorList,11,0,0,11,0,0,0,0,22
seleniumQuery_seleniumQuery.io.github.seleniumquery.by.secondgen.csstree.condition.attribute.CssAttributeConditionBase,7,0,0,7,0,0,0,0,14
seleniumQuery_seleniumQuery.io.github.seleniumquery.by.secondgen.csstree.condition.attribute.CssIdAttributeCondition,1,0,0,1,0,0,0,0,2
seleniumQuery_seleniumQuery.io.github.seleniumquery.by.secondgen.csstree.condition.attribute.CssClassAttributeCondition,1,0,0,1,0,0,0,0,2
seleniumQuery_seleniumQuery.io.github.seleniumquery.by.secondgen.parser.ParseTreeBuilder,0,0,0,0,0,0,0,2,2
seleniumQuery_seleniumQuery.io.github.seleniumquery.by.secondgen.parser.ast.condition.pseudoclass.AstCssFunctionalPseudoClassCondition,0,0,0,0,0,0,0,0,0
seleniumQuery_seleniumQuery.io.github.seleniumquery.by.secondgen.csstree.condition.pseudoclass.finderfactorystrategy.MaybeNativelySupportedPseudoClass,0,0,0,0,0,0,0,0,0
seleniumQuery_seleniumQuery.io.github.seleniumquery.by.secondgen.csstree.selector.CssConditionalSelector,1,0,0,1,0,0,0,0,2
seleniumQuery_seleniumQuery.io.github.seleniumquery.by.secondgen.csstree.selector.combinator.CssCombinationSelector,6,0,0,6,0,0,0,0,12
seleniumQuery_seleniumQuery.io.github.seleniumquery.by.secondgen.csstree.selector.CssTagNameSelector,1,0,0,1,0,0,0,0,2
seleniumQuery_seleniumQuery.io.github.seleniumquery.by.secondgen.finder.ElementFinderUtils,0,0,0,0,0,0,0,0,0
seleniumQuery_seleniumQuery.io.github.seleniumquery.by.secondgen.finder.ElementFinder,0,0,0,0,0,0,0,0,0
seleniumQuery_seleniumQuery.io.github.seleniumquery.by.secondgen.finder.CssFinder,0,0,0,0,0,0,0,0,0
seleniumQuery_seleniumQuery.io.github.seleniumquery.by.common.preparser.NotEqualsAttributeSelectorFix,1,0,0,0,0,0,0,0,1
seleniumQuery_seleniumQuery.io.github.seleniumquery.by.common.elementfilter.ElementFilterList,0,0,0,0,0,0,0,0,0
seleniumQuery_seleniumQuery.io.github.seleniumquery.by.firstgen.xpath.XPathComponentCompilerService,0,0,0,0,0,0,0,0,0
seleniumQuery_seleniumQuery.io.github.seleniumquery.by.firstgen.xpath.component.TagComponent,0,0,0,0,0,0,0,0,0
seleniumQuery_seleniumQuery.io.github.seleniumquery.by.firstgen.css.conditionals.AndConditionalCssSelector,1,0,0,1,0,0,0,0,2
seleniumQuery_seleniumQuery.io.github.seleniumquery.by.common.preparser.W3cCssSelectorWithMapParser,1,0,0,1,0,0,0,0,2
seleniumQuery_seleniumQuery.io.github.seleniumquery.browser.driver.SeleniumQueryDriver,10,6,0,18,0,1,1,3,39
seleniumQuery_seleniumQuery.io.github.seleniumquery.by.firstgen.css.CssSelectorMatcherService,19,0,0,1,0,0,0,0,20
seleniumQuery_seleniumQuery.io.github.seleniumquery.SeleniumQuery,2,0,0,2,0,0,2,6,12
seleniumQuery_seleniumQuery.io.github.seleniumquery.SeleniumQueryFluentFunctionEvaluateIf,8,0,0,8,0,6,0,3,25
seleniumQuery_seleniumQuery.io.github.seleniumquery.SeleniumQueryFluentFunction,6,0,0,6,0,2,0,11,25
seleniumQuery_seleniumQuery.io.github.seleniumquery.browser.BrowserFunctions,0,0,0,0,0,0,0,0,0
seleniumQuery_seleniumQuery.io.github.seleniumquery.functions.as.AsSelect,0,0,0,0,0,0,0,0,0
seleniumQuery_seleniumQuery.io.github.seleniumquery.browser.driver.builders.OperaDriverBuilder,0,0,0,0,0,0,0,1,1
seleniumQuery_seleniumQuery.io.github.seleniumquery.browser.driver.DriverBuilder,1,0,0,1,0,0,0,4,6
seleniumQuery_seleniumQuery.io.github.seleniumquery.browser.driver.builders.InternetExplorerDriverBuilder,0,0,0,0,0,0,0,2,2
seleniumQuery_seleniumQuery.io.github.seleniumquery.browser.driver.builders.DriverInstantiationUtils,0,0,0,0,0,0,0,1,1
seleniumQuery_seleniumQuery.io.github.seleniumquery.browser.driver.builders.EdgeDriverBuilder,0,0,0,0,0,0,0,1,1
seleniumQuery_seleniumQuery.io.github.seleniumquery.browser.driver.builders.FirefoxDriverBuilder,0,0,0,0,0,0,0,0,0
seleniumQuery_seleniumQuery.io.github.seleniumquery.browser.driver.builders.HtmlUnitDriverBuilder,0,0,0,0,0,0,0,0,0
seleniumQuery_seleniumQuery.io.github.seleniumquery.browser.driver.builders.ChromeDriverBuilder,1,0,0,1,0,0,0,2,4
seleniumQuery_seleniumQuery.io.github.seleniumquery.SeleniumQueryBrowser,1,0,0,1,0,0,0,0,2
seleniumQuery_seleniumQuery.io.github.seleniumquery.utils.DriverVersionUtils,1,0,0,0,0,1,0,0,2
datacleaner_DataCleaner.org.datacleaner.actions.PreviewTransformedDataActionListener,8,0,0,7,0,0,0,0,15
datacleaner_DataCleaner.org.datacleaner.widgets.table.DCTableCellRenderer,3,0,0,1,0,0,0,0,4
datacleaner_DataCleaner.org.datacleaner.descriptors.SimpleDescriptorProvider,1,0,0,1,0,0,0,0,2
datacleaner_DataCleaner.org.datacleaner.connection.Neo4jDatastore,2,0,0,2,0,0,0,0,4
datacleaner_DataCleaner.org.datacleaner.VersionComparator,1,0,0,0,0,0,0,0,1
datacleaner_DataCleaner.org.datacleaner.connection.DatastoreCatalog,0,0,0,0,0,0,0,1,1
datacleaner_DataCleaner.org.datacleaner.connection.JdbcDatastore,0,0,0,0,0,0,0,3,3
datacleaner_DataCleaner.org.datacleaner.extension.output.CreateCsvFileAnalyzer,5,0,0,5,0,1,0,0,11
datacleaner_DataCleaner.org.datacleaner.connection.DatastoreConnection,1,0,0,1,0,0,0,0,2
datacleaner_DataCleaner.org.datacleaner.extension.output.CreateExcelSpreadsheetAnalyzer,6,0,0,4,0,2,0,0,12
datacleaner_DataCleaner.org.datacleaner.job.builder.AnalysisJobBuilder,4,0,0,4,0,0,0,0,8
datacleaner_DataCleaner.org.datacleaner.job.builder.AbstractComponentBuilder,1,0,0,1,0,0,0,0,2
datacleaner_DataCleaner.org.datacleaner.test.TestHelper,2,0,0,2,0,2,0,2,8
datacleaner_DataCleaner.org.datacleaner.result.CategorizationResultReducer,1,0,0,1,0,0,0,0,2
datacleaner_DataCleaner.org.datacleaner.test.AssertHelper,0,0,0,0,0,0,0,0,0
datacleaner_DataCleaner.org.datacleaner.beans.BooleanAnalyzerReducer,1,0,0,1,0,0,0,0,2
datacleaner_DataCleaner.org.datacleaner.beans.BooleanAnalyzerResult,1,0,0,1,0,0,0,0,2
datacleaner_DataCleaner.org.datacleaner.beans.ComposeJsonTransformer,4,0,0,4,0,0,0,0,8
datacleaner_DataCleaner.org.datacleaner.beans.ParseJsonTransformer,4,0,0,4,0,0,0,0,8
datacleaner_DataCleaner.org.datacleaner.beans.uniqueness.UniqueKeyCheckAnalyzer,1,0,0,1,0,0,0,0,2
datacleaner_DataCleaner.org.datacleaner.beans.referentialintegrity.ReferentialIntegrityAnalyzerReducer,1,0,0,1,0,0,0,0,2
datacleaner_DataCleaner.org.datacleaner.components.machinelearning.impl.VectorNGramFeatureModifierBuilder,1,0,0,1,0,0,0,0,2
datacleaner_DataCleaner.org.datacleaner.components.machinelearning.impl.VectorOneHotEncodingFeatureModifierBuilder,2,0,0,2,0,0,0,0,4
datacleaner_DataCleaner.org.datacleaner.extension.networktools.ResolveHostnameTransformer,1,0,0,1,0,0,0,0,2
datacleaner_DataCleaner.org.datacleaner.components.http.HttpRequestTransformer,1,0,0,1,0,0,1,0,3
datacleaner_DataCleaner.org.datacleaner.result.AnalysisResult,1,0,0,1,0,0,0,0,2
datacleaner_DataCleaner.org.datacleaner.beans.transform.RemoveDictionaryMatchesTransformer,2,0,0,2,0,0,0,0,4
datacleaner_DataCleaner.org.datacleaner.beans.transform.SynonymLookupTransformer,4,0,0,4,0,0,0,0,8
datacleaner_DataCleaner.org.datacleaner.beans.transform.PlainSearchReplaceTransformer,0,0,0,0,0,0,0,1,1
datacleaner_DataCleaner.org.datacleaner.beans.transform.RemoveSubstringTransformer,9,0,0,7,0,0,0,0,16
datacleaner_DataCleaner.org.datacleaner.beans.transform.TextCaseTransformer,7,0,0,0,0,0,0,0,7
datacleaner_DataCleaner.org.datacleaner.connection.Datastore,1,0,0,1,0,0,0,0,2
datacleaner_DataCleaner.org.datacleaner.components.fuse.CoalesceUnit,3,0,0,3,0,0,0,0,6
datacleaner_DataCleaner.org.datacleaner.documentation.ComponentDocumentationBuilder,0,0,0,0,0,0,0,0,0
datacleaner_DataCleaner.org.datacleaner.beans.writers.TypeConverter,4,0,0,0,0,0,0,0,4
datacleaner_DataCleaner.org.datacleaner.beans.writers.WriteDataResultHtmlRenderer,1,0,0,1,0,0,0,0,2
datacleaner_DataCleaner.org.datacleaner.descriptors.ClasspathScanDescriptorProvider,1,0,0,1,0,0,0,0,2
datacleaner_DataCleaner.org.datacleaner.descriptors.ResultDescriptor,1,0,0,1,0,0,0,0,2
datacleaner_DataCleaner.org.datacleaner.beans.writers.DeleteFromTableAnalyzer,2,0,0,2,0,0,0,1,5
datacleaner_DataCleaner.org.datacleaner.descriptors.ComponentDescriptor,1,0,0,1,0,0,0,0,2
datacleaner_DataCleaner.org.datacleaner.beans.valuedist.ValueDistributionAnalyzer,4,0,0,4,0,0,0,0,8
datacleaner_DataCleaner.org.datacleaner.beans.valuedist.ValueDistributionAnalyzerResultReducer,2,1,0,2,0,0,0,0,5
datacleaner_DataCleaner.org.datacleaner.reference.DatastoreSynonymCatalog,1,0,0,1,0,0,0,0,2
datacleaner_DataCleaner.org.datacleaner.reference.AbstractReferenceData,0,0,0,0,0,0,0,0,0
datacleaner_DataCleaner.org.datacleaner.components.group.GrouperTransformer,3,0,0,3,0,0,0,0,6
datacleaner_DataCleaner.org.datacleaner.components.annotate.MarkRowsAnalyzerResultReducer,2,0,0,2,0,0,0,0,4
datacleaner_DataCleaner.org.datacleaner.beans.codec.HashTransformer,1,0,0,1,0,0,0,0,2
datacleaner_DataCleaner.org.datacleaner.connection.UsageAwareDatastore,1,0,0,0,0,0,0,0,1
datacleaner_DataCleaner.org.datacleaner.reference.ReferenceDataCatalog,3,0,0,3,0,0,0,0,6
datacleaner_DataCleaner.org.datacleaner.configuration.DataCleanerConfiguration,1,0,0,1,0,0,0,0,2
datacleaner_DataCleaner.org.datacleaner.test.MockHadoopConfigHelper,1,0,0,1,0,0,0,0,2
datacleaner_DataCleaner.org.datacleaner.job.runner.ErrorAware,5,0,0,5,0,6,0,1,17
datacleaner_DataCleaner.org.datacleaner.job.runner.AnalysisResultFuture,4,0,0,4,0,0,0,0,8
datacleaner_DataCleaner.org.datacleaner.connection.CsvDatastore,2,0,0,2,0,0,0,0,4
datacleaner_DataCleaner.org.datacleaner.util.convert.ResourceConverter,5,1,0,4,0,0,0,0,10
datacleaner_DataCleaner.org.datacleaner.util.convert.ShiftedToday,0,0,0,0,0,0,0,0,0
datacleaner_DataCleaner.org.datacleaner.util.convert.HdfsResourceTypeHandler,1,0,0,1,0,0,0,0,2
datacleaner_DataCleaner.org.datacleaner.util.convert.MapStringToStringConverter,2,0,0,2,0,0,0,0,4
datacleaner_DataCleaner.org.datacleaner.extensions.CompoundClassLoader,1,0,0,1,0,0,0,0,2
datacleaner_DataCleaner.org.datacleaner.reference.regexswap.RegexSwapClient,1,0,0,1,0,0,0,0,2
datacleaner_DataCleaner.org.datacleaner.descriptors.CompositeDescriptorProvider,1,0,0,0,0,0,0,1,2
datacleaner_DataCleaner.org.datacleaner.metadata.ColumnMeaningCollection,1,0,0,0,0,0,0,0,1
datacleaner_DataCleaner.org.datacleaner.api.UsageMeteringMessage,4,0,0,4,0,0,0,0,8
c4fcm_CLIFF.org.mediacloud.cliff.ParseManager,6,0,0,2,0,0,0,0,8
c4fcm_CLIFF.org.mediacloud.cliff.util.MuckUtils,2,0,0,2,0,0,0,0,4
c4fcm_CLIFF.org.mediacloud.cliff.CliffConfig,3,0,0,3,0,0,0,0,6
c4fcm_CLIFF.org.mediacloud.cliff.extractor.ExtractedEntities,12,0,0,12,0,0,0,0,24
c4fcm_CLIFF.org.mediacloud.cliff.places.AbstractGeoNameLookup,2,0,0,2,0,0,0,0,4
c4fcm_CLIFF.org.mediacloud.cliff.places.substitutions.AbstractSubstitutionMap,5,0,0,5,0,0,0,0,10
c4fcm_CLIFF.org.mediacloud.cliff.people.disambiguation.KindaDumbDisambiguationStrategy,0,0,0,0,0,0,0,0,0
Appendium_objectlabkit.net.objectlab.kit.util.Counter,5,0,0,0,0,0,0,0,5
Appendium_objectlabkit.net.objectlab.kit.util.IntegerUtil,10,0,0,0,0,0,0,0,10
Appendium_objectlabkit.net.objectlab.kit.util.ObjectHolder,1,0,0,0,0,0,0,0,1
Appendium_objectlabkit.net.objectlab.kit.util.PopulationStandardDeviation,12,0,0,12,0,0,0,0,24
Appendium_objectlabkit.net.objectlab.kit.util.Average,6,0,0,6,0,0,0,0,12
Appendium_objectlabkit.net.objectlab.kit.util.ObjectUtil,1,0,0,0,0,0,0,0,1
Appendium_objectlabkit.net.objectlab.kit.util.CollectionUtil,6,0,0,0,0,0,0,0,6
Appendium_objectlabkit.net.objectlab.kit.util.PeriodBuilder,1,0,0,1,0,0,0,0,2
Appendium_objectlabkit.net.objectlab.kit.util.BooleanUtil,5,0,0,0,0,0,0,0,5
Appendium_objectlabkit.net.objectlab.kit.util.BigDecimalUtil,20,0,0,2,0,0,0,0,22
Appendium_objectlabkit.net.objectlab.kit.util.StringUtil,26,0,0,0,0,0,0,0,26
Appendium_objectlabkit.net.objectlab.kit.util.FrequencyBucketDistribution,4,0,0,2,0,0,0,0,6
Appendium_objectlabkit.net.objectlab.kit.util.Total,7,0,0,0,0,0,0,0,7
Appendium_objectlabkit.net.objectlab.kit.collections.ReadOnlyExpiringCollectionBuilder,8,0,0,8,0,0,0,0,16
Appendium_objectlabkit.net.objectlab.kit.util.excel.ExcelStyle,3,0,0,0,0,0,0,0,3
Appendium_objectlabkit.net.objectlab.kit.util.excel.ExcelWorkbook,0,0,0,0,0,0,0,1,1
Appendium_objectlabkit.net.objectlab.kit.pf.ucits.BasicUcitsConcentrationValidator,2,0,0,2,0,0,0,0,4
Appendium_objectlabkit.net.objectlab.kit.fxcalc.FxRateImpl,5,0,0,5,0,0,0,0,10
Appendium_objectlabkit.net.objectlab.kit.fxcalc.Cash,3,0,0,0,0,0,0,0,3
Appendium_objectlabkit.net.objectlab.kit.fxcalc.MajorCurrencyRanking,1,0,0,0,0,0,0,0,1
Appendium_objectlabkit.net.objectlab.kit.fxcalc.CrossRateCalculator,6,0,0,6,0,0,0,0,12
Appendium_objectlabkit.net.objectlab.kit.fxcalc.FxRateCalculatorBuilder,3,0,0,3,0,0,0,0,6
Appendium_objectlabkit.net.objectlab.kit.fxcalc.CurrencyPair,4,0,0,2,0,0,0,0,6
teamed_qulice.com.qulice.checkstyle.CheckstyleValidator,0,0,0,0,0,0,0,0,0
teamed_qulice.com.qulice.spi.Environment,1,0,0,1,0,0,0,0,2
teamed_qulice.com.qulice.maven.AbstractQuliceMojo,0,0,0,0,0,0,0,1,1
teamed_qulice.com.qulice.maven.CheckMojo,0,0,0,0,0,0,0,1,1
teamed_qulice.com.qulice.maven.DefaultValidatorsProvider,0,0,0,0,0,0,0,0,0
teamed_qulice.com.qulice.maven.DefaultMavenEnvironment,2,0,0,2,0,0,0,0,4
teamed_qulice.com.qulice.maven.PomXpathValidator,0,0,0,0,0,0,0,1,1
teamed_qulice.com.qulice.maven.DependenciesValidator,0,0,0,0,0,0,0,4,4
teamed_qulice.com.qulice.maven.MavenValidator,0,0,0,0,0,0,0,1,1
teamed_qulice.com.qulice.plugin.alpha.Main,2,0,0,0,0,0,0,0,2
teamed_qulice.com.qulice.pmd.PmdValidator,0,0,0,0,0,0,0,0,0
google_acai.com.google.acai.Acai,12,0,0,0,0,2,0,3,17
google_acai.com.google.acai.TestingServiceManager,4,0,0,0,0,2,0,2,8
google_acai.com.google.acai.Dependencies,1,0,0,0,0,0,0,1,2
mdeverdelhan_ta4j.eu.verdelhan.ta4j.analysis.CashFlow,9,0,0,8,0,0,0,0,17
mdeverdelhan_ta4j.eu.verdelhan.ta4j.Order,4,0,0,3,0,0,0,0,7
mdeverdelhan_ta4j.eu.verdelhan.ta4j.AnalysisCriterion,12,0,0,2,0,0,0,0,14
mdeverdelhan_ta4j.eu.verdelhan.ta4j.analysis.criteria.AverageProfitableTradesCriterion,1,0,0,1,0,0,0,0,2
mdeverdelhan_ta4j.eu.verdelhan.ta4j.analysis.criteria.RewardRiskRatioCriterion,0,0,0,0,0,0,0,0,0
mdeverdelhan_ta4j.eu.verdelhan.ta4j.analysis.criteria.AbstractAnalysisCriterion,1,0,0,0,0,0,0,0,1
mdeverdelhan_ta4j.eu.verdelhan.ta4j.analysis.criteria.MaximumDrawdownCriterion,0,0,0,0,0,0,0,0,0
mdeverdelhan_ta4j.eu.verdelhan.ta4j.TradingRecord,7,0,0,5,0,0,0,0,12
mdeverdelhan_ta4j.eu.verdelhan.ta4j.TimeSeriesManager,6,0,0,6,0,0,0,0,12
mdeverdelhan_ta4j.eu.verdelhan.ta4j.Tick,2,0,0,1,0,0,0,0,3
mdeverdelhan_ta4j.eu.verdelhan.ta4j.Trade,2,0,0,1,0,0,0,0,3
mdeverdelhan_ta4j.eu.verdelhan.ta4j.TimeSeries,10,0,0,8,0,1,0,1,20
mdeverdelhan_ta4j.eu.verdelhan.ta4j.Rule,14,0,0,4,0,0,0,0,18
mdeverdelhan_ta4j.eu.verdelhan.ta4j.trading.rules.StopLossRule,1,0,0,1,0,0,0,0,2
mdeverdelhan_ta4j.eu.verdelhan.ta4j.trading.rules.StopGainRule,1,0,0,1,0,0,0,0,2
mdeverdelhan_ta4j.eu.verdelhan.ta4j.trading.rules.WaitForRule,2,0,0,2,0,0,0,0,4
mdeverdelhan_ta4j.eu.verdelhan.ta4j.indicators.CachedIndicator,88,0,0,5,0,0,0,0,93
mdeverdelhan_ta4j.eu.verdelhan.ta4j.indicators.RecursiveCachedIndicator,17,0,0,0,0,0,0,0,17
mdeverdelhan_ta4j.eu.verdelhan.ta4j.Indicator,2,0,0,0,0,0,0,0,2
mdeverdelhan_ta4j.eu.verdelhan.ta4j.indicators.AbstractIndicator,1,0,0,0,0,0,0,0,1
mdeverdelhan_ta4j.eu.verdelhan.ta4j.indicators.helpers.FixedIndicator,2,0,0,0,0,0,0,0,2
mdeverdelhan_ta4j.eu.verdelhan.ta4j.indicators.helpers.ConstantIndicator,1,0,0,0,0,0,0,0,1
mdeverdelhan_ta4j.eu.verdelhan.ta4j.Decimal,8,0,0,8,0,0,0,0,16
mdeverdelhan_ta4j.eu.verdelhan.ta4j.indicators.statistics.PeriodicalGrowthRateIndicator,0,0,0,0,0,0,0,0,0
mdeverdelhan_ta4j.eu.verdelhan.ta4j.indicators.bollinger.BollingerBandsUpperIndicator,1,0,0,1,0,0,0,0,2
mdeverdelhan_ta4j.eu.verdelhan.ta4j.indicators.bollinger.BollingerBandsLowerIndicator,1,0,0,1,0,0,0,0,2
takari_takari-lifecycle.io.takari.maven.plugins.compile.ProcessorpathResolver,1,0,0,0,0,0,0,0,1
takari_takari-lifecycle.io.takari.maven.plugins.compile.jdt.FilerImpl,1,0,0,0,0,0,0,0,1
takari_takari-lifecycle.io.takari.maven.plugins.compile.jdt.classpath.Classpath,0,0,0,0,0,0,0,0,0
takari_takari-lifecycle.io.takari.maven.plugins.compile.jdt.classpath.ClasspathDirectory,1,0,0,1,0,0,0,0,2
takari_takari-lifecycle.io.takari.maven.plugins.install_deploy.DeployParticipant,1,0,0,0,0,0,0,0,1
takari_takari-lifecycle.io.takari.maven.plugins.configurator.MojoConfigurationProcessor,3,0,0,1,0,0,0,0,4
takari_takari-lifecycle.io.takari.maven.plugins.plugin.model.MojoRequirement,1,0,0,1,0,0,0,0,2
takari_takari-lifecycle.io.takari.maven.plugins.plugin.model.MojoDescriptor,0,0,0,0,0,0,0,0,0
caelum_vraptor-panettone.br.com.caelum.vraptor.panettone.Compiler,3,0,0,1,0,0,0,0,4
caelum_vraptor-panettone.br.com.caelum.vraptor.panettone.Template,0,0,0,0,0,0,0,1,1
caelum_vraptor-panettone.br.com.caelum.vraptor.panettone.VRaptorCompilationListener,0,0,0,0,0,0,0,0,0
caelum_vraptor-panettone.br.com.caelum.vraptor.panettone.parser.SourceCode,6,0,0,3,0,0,0,0,9
caelum_vraptor-panettone.br.com.caelum.vraptor.panettone.parser.rule.Rule,17,0,0,17,0,0,1,0,35
caelum_vraptor-panettone.br.com.caelum.vraptor.panettone.parser.rule.ScriptletPrintRule,0,0,0,0,0,0,0,0,0
caelum_vraptor-panettone.br.com.caelum.vraptor.panettone.parser.rule.ExpressionRule,0,0,0,0,0,0,0,0,0
caelum_vraptor-panettone.br.com.caelum.vraptor.panettone.parser.rule.InjectDeclarationRule,2,0,0,2,0,0,0,0,4
caelum_vraptor-panettone.br.com.caelum.vraptor.panettone.parser.rule.PrintVariableRule,0,0,0,0,0,0,0,0,0
caelum_vraptor-panettone.br.com.caelum.vraptor.panettone.parser.rule.CommentRule,0,0,0,0,0,0,0,0,0
caelum_vraptor-panettone.br.com.caelum.vraptor.panettone.parser.rule.RuleExtractor,1,0,0,1,0,0,0,0,2
caelum_vraptor-panettone.br.com.caelum.vraptor.panettone.parser.rule.VariableDeclarationRule,1,0,0,1,0,0,0,0,2
caelum_vraptor-panettone.br.com.caelum.vraptor.panettone.parser.rule.ReusableVariableRule,1,0,0,1,0,0,0,0,2
Stratio_streaming-cep-engine.com.stratio.decision.commons.kafka.service.KafkaTopicService,0,0,0,0,0,0,0,0,0
Stratio_streaming-cep-engine.com.stratio.decision.commons.messages.StratioStreamingMessage,6,1,0,5,0,0,0,0,12
Stratio_streaming-cep-engine.com.stratio.decision.commons.dto.ActionCallbackDto,0,0,0,0,0,0,0,0,0
Stratio_streaming-cep-engine.com.stratio.decision.commons.messages.ColumnNameTypeValue,1,0,0,1,0,0,0,0,2
bytedeco_javacpp.org.bytedeco.javacpp.Pointer,17,10,0,14,0,1,0,0,42
bytedeco_javacpp.org.bytedeco.javacpp.BytePointer,3,1,0,2,0,0,0,0,6
bytedeco_javacpp.org.bytedeco.javacpp.ShortPointer,1,0,0,1,0,0,0,0,2
bytedeco_javacpp.org.bytedeco.javacpp.IntPointer,3,0,0,2,0,0,0,0,5
bytedeco_javacpp.org.bytedeco.javacpp.LongPointer,1,0,0,1,0,0,0,0,2
bytedeco_javacpp.org.bytedeco.javacpp.FloatPointer,1,0,0,1,0,0,0,0,2
bytedeco_javacpp.org.bytedeco.javacpp.DoublePointer,1,0,0,1,0,0,0,0,2
bytedeco_javacpp.org.bytedeco.javacpp.tools.Builder,1,0,0,1,0,0,0,0,2
bytedeco_javacpp.org.bytedeco.javacpp.indexer.Indexer,15,14,0,15,0,0,0,0,44
bytedeco_javacpp.org.bytedeco.javacpp.indexer.Bfloat16Indexer,1,0,0,1,0,0,0,0,2
bytedeco_javacpp.org.bytedeco.javacpp.indexer.BooleanIndexer,1,0,0,1,0,0,0,0,2
bytedeco_javacpp.org.bytedeco.javacpp.indexer.ByteIndexer,1,0,0,1,0,0,0,0,2
bytedeco_javacpp.org.bytedeco.javacpp.indexer.CharIndexer,1,0,0,1,0,0,0,0,2
bytedeco_javacpp.org.bytedeco.javacpp.indexer.DoubleIndexer,1,0,0,1,0,0,0,0,2
bytedeco_javacpp.org.bytedeco.javacpp.indexer.FloatIndexer,2,0,0,1,0,0,0,0,3
bytedeco_javacpp.org.bytedeco.javacpp.indexer.HalfIndexer,1,0,0,1,0,0,0,0,2
bytedeco_javacpp.org.bytedeco.javacpp.indexer.IntIndexer,1,0,0,1,0,0,0,0,2
bytedeco_javacpp.org.bytedeco.javacpp.indexer.LongIndexer,1,0,0,1,0,0,0,0,2
bytedeco_javacpp.org.bytedeco.javacpp.indexer.ShortIndexer,1,0,0,1,0,0,0,0,2
bytedeco_javacpp.org.bytedeco.javacpp.indexer.UByteIndexer,1,0,0,1,0,0,0,0,2
bytedeco_javacpp.org.bytedeco.javacpp.indexer.UIntIndexer,1,0,0,1,0,0,0,0,2
bytedeco_javacpp.org.bytedeco.javacpp.indexer.ULongIndexer,1,0,0,1,0,0,0,0,2
bytedeco_javacpp.org.bytedeco.javacpp.indexer.UShortIndexer,1,0,0,1,0,0,0,0,2
bytedeco_javacpp.org.bytedeco.javacpp.CharPointer,1,0,0,0,0,0,0,0,1
fiji_Trainable_Segmentation.trainableSegmentation.WekaSegmentation,1,1,0,1,0,0,0,0,3
apache_incubator-samoa.org.apache.samoa.instances.ArffLoader,2,0,0,2,0,0,0,0,4
OpenTOSCA_container.org.opentosca.container.core.next.model.DeploymentTestResult,2,0,0,2,0,0,0,0,4
OpenTOSCA_container.org.opentosca.container.core.next.model.RelationshipTemplateInstance,1,0,0,1,0,0,0,0,2
OpenTOSCA_container.org.opentosca.container.core.next.xml.PropertyParser,4,0,0,0,0,0,0,0,4
OpenTOSCA_container.org.opentosca.container.core.next.xml.DomUtil,1,0,0,1,0,0,0,0,2
OpenTOSCA_container.org.opentosca.container.api.dto.request.CreateServiceTemplateInstanceRequest,0,0,0,0,0,0,0,0,0
OpenTOSCA_container.org.opentosca.container.core.model.csar.Csar,6,0,0,6,0,0,0,0,12
OpenTOSCA_container.org.opentosca.container.core.service.CsarStorageService,1,0,0,1,0,0,0,0,2
OpenTOSCA_container.org.opentosca.container.control.plan.PlanGenerationService,1,0,0,1,0,0,0,0,2
vert-x3_vertx-metrics.io.vertx.ext.dropwizard.MetricsService,18,3,0,0,0,1,0,3,25
vert-x3_vertx-metrics.io.vertx.ext.dropwizard.impl.AbstractMetrics,1,0,0,0,0,0,0,0,1
vert-x3_vertx-metrics.io.vertx.ext.dropwizard.impl.InstantThroughput,1,0,0,1,0,0,0,0,2
vert-x3_vertx-metrics.io.vertx.ext.dropwizard.DropwizardMetricsOptions,9,0,0,9,0,0,0,0,18
vert-x3_vertx-metrics.io.vertx.ext.dropwizard.impl.VertxMetricsFactoryImpl,3,0,0,2,0,0,0,0,5
KittehOrg_KittehIRCClientLib.org.kitteh.irc.client.library.defaults.feature.SimpleDefaultMessageMap,2,0,0,2,0,0,0,0,4
KittehOrg_KittehIRCClientLib.org.kitteh.irc.client.library.feature.auth.SaslEcdsaNist256PChallenge,0,0,0,0,0,0,0,0,0
KittehOrg_KittehIRCClientLib.org.kitteh.irc.client.library.util.Pair,3,0,0,3,0,0,0,0,6
KittehOrg_KittehIRCClientLib.org.kitteh.irc.client.library.feature.CapabilityManager,1,0,0,1,0,0,0,0,2
KittehOrg_KittehIRCClientLib.org.kitteh.irc.client.library.Client,0,0,0,0,0,1,0,5,6
KittehOrg_KittehIRCClientLib.org.kitteh.irc.client.library.command.TopicCommand,0,0,0,0,0,0,0,4,4
KittehOrg_KittehIRCClientLib.org.kitteh.irc.client.library.command.WhoisCommand,0,0,0,0,0,0,0,3,3
KittehOrg_KittehIRCClientLib.org.kitteh.irc.client.library.command.KickCommand,0,0,0,0,0,0,0,3,3
KittehOrg_KittehIRCClientLib.org.kitteh.irc.client.library.command.Command,0,0,0,0,0,0,0,0,0
KittehOrg_KittehIRCClientLib.org.kitteh.irc.client.library.command.CapabilityRequestCommand,0,0,0,0,0,0,0,3,3
KittehOrg_KittehIRCClientLib.org.kitteh.irc.client.library.command.ChannelModeCommand,0,0,0,0,0,0,0,9,9
KittehOrg_KittehIRCClientLib.org.kitteh.irc.client.library.command.OperCommand,0,0,0,0,0,0,0,1,1
KittehOrg_KittehIRCClientLib.org.kitteh.irc.client.library.command.WallopsCommand,0,0,0,0,0,0,0,1,1
KittehOrg_KittehIRCClientLib.org.kitteh.irc.client.library.command.AwayCommand,0,0,0,0,0,0,0,4,4
KittehOrg_KittehIRCClientLib.org.kitteh.irc.client.library.command.MonitorCommand,0,0,0,0,0,0,0,7,7
KittehOrg_KittehIRCClientLib.org.kitteh.irc.client.library.command.UserModeCommand,0,0,0,0,0,0,0,6,6
KittehOrg_KittehIRCClientLib.org.kitteh.irc.client.library.util.CIKeyMap,3,0,0,3,0,0,0,0,6
KittehOrg_KittehIRCClientLib.org.kitteh.irc.client.library.util.CtcpUtil,0,0,0,0,0,0,0,0,0
KittehOrg_KittehIRCClientLib.org.kitteh.irc.client.library.util.Sanity,0,0,0,0,0,0,0,3,3
KittehOrg_KittehIRCClientLib.org.kitteh.irc.client.library.util.CISet,1,0,0,1,0,0,0,0,2
KittehOrg_KittehIRCClientLib.org.kitteh.irc.client.library.util.ToStringer,0,0,0,0,0,0,0,0,0
KittehOrg_KittehIRCClientLib.org.kitteh.irc.client.library.util.StringUtil,1,0,0,0,0,0,0,1,2
KittehOrg_KittehIRCClientLib.org.kitteh.irc.client.library.util.StsUtil,1,0,0,1,0,0,0,0,2
KittehOrg_KittehIRCClientLib.org.kitteh.irc.client.library.util.SslUtil,0,0,0,0,0,0,0,0,0
KittehOrg_KittehIRCClientLib.org.kitteh.irc.client.library.defaults.feature.DefaultISupportManager,11,0,0,4,0,0,0,0,15
KittehOrg_KittehIRCClientLib.org.kitteh.irc.client.library.util.AbstractNameValueProcessor,0,0,0,0,0,0,0,0,0
KittehOrg_KittehIRCClientLib.org.kitteh.irc.client.library.feature.ServerInfo,1,0,0,1,0,0,0,0,2
KittehOrg_KittehIRCClientLib.org.kitteh.irc.client.library.defaults.feature.DefaultAuthManager,2,0,0,1,0,0,0,0,3
KittehOrg_KittehIRCClientLib.org.kitteh.irc.client.library.element.ClientLinked,3,0,0,3,0,0,0,0,6
KittehOrg_KittehIRCClientLib.org.kitteh.irc.client.library.element.MessageTag,1,0,0,1,0,0,0,0,2
KittehOrg_KittehIRCClientLib.org.kitteh.irc.client.library.feature.EventManager,0,0,0,0,0,0,0,0,0
KittehOrg_KittehIRCClientLib.org.kitteh.irc.client.library.feature.sts.StsHandler,3,0,0,3,0,0,0,0,6
KittehOrg_KittehIRCClientLib.org.kitteh.irc.client.library.feature.sts.StsPropertiesStorageManager,2,0,0,2,0,0,0,0,4
robert-bor_aho-corasick.org.ahocorasick.trie.State,4,0,0,4,0,0,0,0,8
robert-bor_aho-corasick.org.ahocorasick.trie.Trie,2,0,0,2,0,0,0,16,20
robert-bor_aho-corasick.org.ahocorasick.trie.PayloadTrie,5,0,0,5,0,0,0,16,26
robert-bor_aho-corasick.org.ahocorasick.interval.Interval,2,0,0,1,0,0,0,0,3
robert-bor_aho-corasick.org.ahocorasick.interval.IntervalTree,0,0,0,0,0,0,0,0,0
robert-bor_aho-corasick.org.ahocorasick.interval.Intervalable,3,0,0,0,0,0,0,0,3
RichardWarburton_java-8-lambdas-exercises.com.insightfullogic.java8.examples.chapter4.Primitives,0,0,0,0,0,0,0,1,1
RichardWarburton_java-8-lambdas-exercises.com.insightfullogic.java8.examples.chapter4.Order,0,0,0,0,0,0,0,0,0
RichardWarburton_java-8-lambdas-exercises.com.insightfullogic.java8.examples.chapter4.MusicalCarriage,0,0,0,0,0,0,0,0,0
RichardWarburton_java-8-lambdas-exercises.com.insightfullogic.java8.examples.chapter4.Parent,0,0,0,0,0,0,0,0,0
RichardWarburton_java-8-lambdas-exercises.com.insightfullogic.java8.examples.chapter4.Child,0,0,0,0,0,0,0,0,0
RichardWarburton_java-8-lambdas-exercises.com.insightfullogic.java8.examples.chapter1.Performance,0,0,0,0,0,0,0,0,0
RichardWarburton_java-8-lambdas-exercises.com.insightfullogic.java8.examples.chapter7.Testing,0,0,0,0,0,0,0,0,0
RichardWarburton_java-8-lambdas-exercises.com.insightfullogic.java8.examples.chapter4.OrderDomain,0,0,0,0,0,0,0,0,0
RichardWarburton_java-8-lambdas-exercises.com.insightfullogic.java8.examples.chapter5.StringCombiner,1,0,0,0,0,0,0,0,1
RichardWarburton_java-8-lambdas-exercises.com.insightfullogic.java8.examples.chapter1.SampleData,1,0,0,0,0,0,0,0,1
RichardWarburton_java-8-lambdas-exercises.com.insightfullogic.java8.examples.chapter5.StringExamples,0,0,0,0,0,0,0,0,0
RichardWarburton_java-8-lambdas-exercises.com.insightfullogic.java8.examples.chapter5.StringCollector,0,0,0,0,0,0,0,0,0
RichardWarburton_java-8-lambdas-exercises.com.insightfullogic.java8.examples.chapter9.AlbumLookup,1,0,0,1,0,0,0,0,2
RichardWarburton_java-8-lambdas-exercises.com.insightfullogic.java8.examples.chapter9.RxExamples,0,0,0,0,0,0,0,0,0
RichardWarburton_java-8-lambdas-exercises.com.insightfullogic.java8.examples.chapter6.ArrayExamples,0,0,0,0,0,0,0,0,0
RichardWarburton_java-8-lambdas-exercises.com.insightfullogic.java8.examples.chapter3.StreamExercises,0,0,0,0,0,0,0,0,0
RichardWarburton_java-8-lambdas-exercises.com.insightfullogic.java8.examples.chapter1.Track,0,0,0,0,0,0,0,0,0
RichardWarburton_java-8-lambdas-exercises.com.insightfullogic.java8.examples.chapter3.Iteration,0,0,0,0,0,0,0,2,2
RichardWarburton_java-8-lambdas-exercises.com.insightfullogic.java8.examples.chapter8.command.Macro,0,0,0,0,0,0,0,3,3
RichardWarburton_java-8-lambdas-exercises.com.insightfullogic.java8.examples.chapter8.template_method.traditional.LoanApplication,0,0,0,0,0,0,0,1,1
RichardWarburton_java-8-lambdas-exercises.com.insightfullogic.java8.answers.chapter4.PerformanceFixed,1,0,0,0,0,1,0,0,2
RichardWarburton_java-8-lambdas-exercises.com.insightfullogic.java8.answers.chapter4.ArtistsFixed,0,0,0,0,0,0,0,0,0
RichardWarburton_java-8-lambdas-exercises.com.insightfullogic.java8.answers.chapter5.WordCount,1,0,0,0,0,0,0,0,1
RichardWarburton_java-8-lambdas-exercises.com.insightfullogic.java8.answers.chapter5.Fibonacci,0,0,0,0,0,0,0,0,0
RichardWarburton_java-8-lambdas-exercises.com.insightfullogic.java8.answers.chapter5.LongestName,0,0,0,0,0,0,0,0,0
RichardWarburton_java-8-lambdas-exercises.com.insightfullogic.java8.answers.chapter9.BlockingArtistAnalyzer,0,0,0,0,0,0,0,0,0
RichardWarburton_java-8-lambdas-exercises.com.insightfullogic.java8.answers.chapter6.SerialToParallel,0,0,0,0,0,0,0,0,0
RichardWarburton_java-8-lambdas-exercises.com.insightfullogic.java8.answers.chapter6.BuggyReduce,0,0,0,0,0,0,0,0,0
RichardWarburton_java-8-lambdas-exercises.com.insightfullogic.java8.answers.chapter3.Question1,0,0,0,0,0,0,0,0,0
RichardWarburton_java-8-lambdas-exercises.com.insightfullogic.java8.answers.chapter3.Question2,0,0,0,0,0,0,0,0,0
RichardWarburton_java-8-lambdas-exercises.com.insightfullogic.java8.answers.chapter3.StringExercises,0,0,0,0,0,0,0,0,0
RichardWarburton_java-8-lambdas-exercises.com.insightfullogic.java8.exercises.chapter4.PerformanceFixed,1,0,0,0,0,1,0,0,2
RichardWarburton_java-8-lambdas-exercises.com.insightfullogic.java8.exercises.chapter4.Artists,0,0,0,0,0,0,0,0,0
RichardWarburton_java-8-lambdas-exercises.com.insightfullogic.java8.exercises.chapter5.WordCount,1,0,0,0,0,0,0,0,1
RichardWarburton_java-8-lambdas-exercises.com.insightfullogic.java8.exercises.chapter5.Fibonacci,0,0,0,0,0,0,0,0,0
RichardWarburton_java-8-lambdas-exercises.com.insightfullogic.java8.exercises.chapter5.LongestName,0,0,0,0,0,0,0,0,0
RichardWarburton_java-8-lambdas-exercises.com.insightfullogic.java8.exercises.chapter9.BlockingArtistAnalyzer,0,0,0,0,0,0,0,0,0
RichardWarburton_java-8-lambdas-exercises.com.insightfullogic.java8.exercises.chapter6.SerialToParallel,0,0,0,0,0,0,0,0,0
RichardWarburton_java-8-lambdas-exercises.com.insightfullogic.java8.exercises.chapter6.BuggyReduce,0,0,0,0,0,0,0,0,0
RichardWarburton_java-8-lambdas-exercises.com.insightfullogic.java8.exercises.chapter3.Question1,0,0,0,0,0,0,0,0,0
RichardWarburton_java-8-lambdas-exercises.com.insightfullogic.java8.exercises.chapter3.Question2,0,0,0,0,0,0,0,0,0
RichardWarburton_java-8-lambdas-exercises.com.insightfullogic.java8.exercises.chapter3.StringExercises,0,0,0,0,0,0,0,0,0
softlayer_softlayer-java.com.softlayer.api.RestApiClient,19,0,0,15,0,2,0,0,36
softlayer_softlayer-java.com.softlayer.api.http.HttpBasicAuthCredentials,0,0,0,0,0,0,0,0,0
softlayer_softlayer-java.com.softlayer.api.http.BuiltInHttpClientFactory,1,0,0,0,0,0,0,6,7
softlayer_softlayer-java.com.softlayer.api.http.HttpBearerCredentials,0,0,0,0,0,0,0,0,0
tabulapdf_tabula-java.technology.tabula.TextElement,4,0,0,4,0,0,0,0,8
tabulapdf_tabula-java.technology.tabula.ProjectionProfile,1,0,0,0,0,0,0,0,1
tabulapdf_tabula-java.technology.tabula.Cell,2,0,0,2,0,0,0,0,4
tabulapdf_tabula-java.technology.tabula.RectangularTextContainer,1,0,0,1,0,0,0,0,2
tabulapdf_tabula-java.technology.tabula.Ruling,1,0,0,0,0,0,0,0,1
tabulapdf_tabula-java.technology.tabula.extractors.BasicExtractionAlgorithm,3,0,0,3,0,0,0,0,6
tabulapdf_tabula-java.technology.tabula.Page,2,0,0,2,0,0,0,1,5
tabulapdf_tabula-java.technology.tabula.Rectangle,9,0,0,7,0,0,1,0,17
tabulapdf_tabula-java.technology.tabula.ObjectExtractor,4,1,0,3,0,2,0,0,10
tabulapdf_tabula-java.technology.tabula.RectangleSpatialIndex,0,0,0,0,0,0,0,0,0
tabulapdf_tabula-java.technology.tabula.writers.CSVWriter,1,0,0,0,0,0,0,1,2
tabulapdf_tabula-java.technology.tabula.writers.JSONWriter,0,0,0,0,0,0,0,0,0
tabulapdf_tabula-java.technology.tabula.extractors.SpreadsheetExtractionAlgorithm,11,0,0,10,0,0,0,3,24
tabulapdf_tabula-java.technology.tabula.Utils,2,0,0,0,0,0,0,1,3
tabulapdf_tabula-java.technology.tabula.Line,0,0,0,0,0,0,0,0,0
tabulapdf_tabula-java.technology.tabula.Table,2,0,0,2,0,0,0,0,4
HotswapProjects_HotswapAgent.org.hotswap.agent.logging.AgentLogger,0,0,0,0,0,0,0,0,0
HotswapProjects_HotswapAgent.org.hotswap.agent.logging.AgentLoggerHandler,0,0,0,0,0,0,0,1,1
HotswapProjects_HotswapAgent.org.hotswap.agent.annotation.handler.InitHandler,0,0,0,0,0,0,0,0,0
HotswapProjects_HotswapAgent.org.hotswap.agent.annotation.handler.OnClassLoadedHandler,0,0,0,0,0,0,0,0,0
HotswapProjects_HotswapAgent.org.hotswap.agent.command.ReflectionCommand,1,0,0,1,0,0,0,0,2
HotswapProjects_HotswapAgent.org.hotswap.agent.config.PluginManager,1,0,0,1,0,0,0,0,2
HotswapProjects_HotswapAgent.org.hotswap.agent.config.PluginConfiguration,1,0,0,0,0,0,0,0,1
HotswapProjects_HotswapAgent.org.hotswap.agent.javassist.ClassPool,2,0,0,2,0,0,0,1,5
HotswapProjects_HotswapAgent.org.hotswap.agent.annotation.handler.AnnotationProcessor,0,0,0,0,0,0,0,0,0
HotswapProjects_HotswapAgent.org.hotswap.agent.util.AnnotationHelper,1,0,0,0,0,0,0,0,1
HotswapProjects_HotswapAgent.org.hotswap.agent.util.scanner.ClassPathAnnotationScanner,0,0,0,0,0,0,0,0,0
HotswapProjects_HotswapAgent.org.hotswap.agent.util.classloader.ClassLoaderDefineClassPatcher,1,0,0,0,0,0,0,0,1
HotswapProjects_HotswapAgent.org.hotswap.agent.util.classloader.ClassLoaderHelper,1,0,0,0,0,0,0,0,1
HotswapProjects_HotswapAgent.org.hotswap.agent.watch.WatcherFactory,0,0,0,0,0,0,0,0,0
HotswapProjects_HotswapAgent.org.hotswap.agent.watch.Watcher,2,0,0,2,0,0,0,0,4
HotswapProjects_HotswapAgent.org.hotswap.agent.versions.matcher.AbstractMatcher,0,0,0,0,0,0,0,0,0
HotswapProjects_HotswapAgent.org.hotswap.agent.plugin.jvm.AnonymousClassInfos,2,0,0,2,0,0,0,0,4
HotswapProjects_HotswapAgent.org.hotswap.agent.plugin.jvm.AnonymousClassInfo,4,0,0,0,0,0,0,0,4
HotswapProjects_HotswapAgent.org.hotswap.agent.plugin.hotswapper.HotSwapper,0,0,0,0,0,0,0,0,0
HotswapProjects_HotswapAgent.org.hotswap.agent.plugin.weld.command.BeanClassRefreshAgent,0,0,0,0,0,0,0,0,0
HotswapProjects_HotswapAgent.org.hotswap.agent.plugin.hibernate3.session.proxy.SessionFactoryProxy,0,0,0,0,0,1,0,0,1
HotswapProjects_HotswapAgent.org.hotswap.agent.util.test.WaitHelper,1,0,0,0,0,0,0,0,1
gid15_jpcsp.jpcsp.crypto.KIRK,1,0,0,1,0,0,0,0,2
gid15_jpcsp.jpcsp.util.FileUtil,1,0,0,0,0,0,0,0,1
tdunning_t-digest.com.tdunning.math.stats.TDigest,18,2,0,15,0,2,0,2,39
tdunning_t-digest.com.tdunning.math.stats.LogHistogram,1,0,0,0,0,0,0,0,1
tdunning_t-digest.com.tdunning.math.stats.AbstractTDigest,2,0,0,2,0,0,0,3,7
tdunning_t-digest.com.tdunning.math.stats.Comparison,4,0,0,3,0,1,0,0,8
tdunning_t-digest.com.tdunning.math.stats.IntAVLTree,2,2,0,2,0,0,0,0,6
tdunning_t-digest.com.tdunning.math.stats.Histogram,3,0,0,3,0,0,0,0,6
tdunning_t-digest.com.tdunning.math.stats.MergingDigest,2,1,0,2,0,0,0,4,9
tdunning_t-digest.com.tdunning.math.stats.Dist,0,0,0,0,0,0,0,1,1
tdunning_t-digest.com.tdunning.math.stats.Sort,3,0,0,1,0,0,0,7,11
tdunning_t-digest.com.tdunning.math.stats.AVLGroupTree,5,0,0,5,0,0,0,0,10
raphaeljolivet_java2typescript.java2typescript.jackson.module.Configuration,0,0,0,0,0,0,0,4,4
raphaeljolivet_java2typescript.java2typescript.jackson.module.StaticFieldExporter,1,0,0,1,0,0,0,0,2
raphaeljolivet_java2typescript.java2typescript.jackson.module.writer.ExternalModuleFormatWriter,0,0,0,0,0,0,0,6,6
raphaeljolivet_java2typescript.java2typescript.jackson.module.grammar.Module,0,0,0,0,0,0,0,1,1
raphaeljolivet_java2typescript.java2typescript.jackson.module.writer.AmbientModuleFormatWriter,0,0,0,0,0,0,0,1,1
raphaeljolivet_java2typescript.java2typescript.jackson.module.writer.WriterPreferences,0,0,0,0,0,0,0,6,6
raphaeljolivet_java2typescript.java2typescript.jaxrs.ServiceDescriptorGenerator,0,0,0,0,0,0,0,2,2
simpligility_android-ndk-maven-plugin.com.simpligility.maven.plugins.androidndk.PluginInfo,0,0,0,0,0,0,0,0,0
simpligility_android-ndk-maven-plugin.com.simpligility.maven.plugins.androidndk.common.NativeHelper,3,0,0,0,0,1,0,0,4
migzai_irc-api.com.ircclouds.irc.api.negotiators.SaslNegotiator,1,0,0,1,0,0,0,0,2
migzai_irc-api.com.ircclouds.irc.api.negotiators.NoopNegotiator,0,0,0,0,0,0,0,1,1
migzai_irc-api.com.ircclouds.irc.api.negotiators.SaslContext,0,0,0,0,0,0,0,11,11
migzai_irc-api.com.ircclouds.irc.api.negotiators.CompositeNegotiator,12,0,0,0,0,0,0,0,12
migzai_irc-api.com.ircclouds.irc.api.negotiators.capabilities.SimpleCapability,3,0,0,3,0,0,0,0,6
commons-rdf_commons-rdf.org.apache.commons.rdf.api.Graph,6,0,0,4,0,0,0,0,10
commons-rdf_commons-rdf.org.apache.commons.rdf.api.BlankNode,2,0,0,0,0,0,0,0,2
commons-rdf_commons-rdf.org.apache.commons.rdf.api.RDFTerm,1,0,0,0,0,0,0,0,1
commons-rdf_commons-rdf.org.apache.commons.rdf.api.RDFTermFactory,11,0,0,11,0,0,0,1,23
commons-rdf_commons-rdf.org.apache.commons.rdf.api.Literal,2,0,0,2,0,0,0,0,4
commons-rdf_commons-rdf.org.apache.commons.rdf.simple.GraphImpl,0,0,0,0,0,0,0,3,3
commons-rdf_commons-rdf.org.apache.commons.rdf.simple.Types,1,0,0,1,0,0,0,0,2
nutzam_nutzwx.org.nutz.weixin.util.Wxs,0,0,0,0,0,0,0,0,0
nutzam_nutzwx.org.nutz.weixin.spi.WxTemplateMsgApi,0,0,0,0,0,0,0,1,1
ebay_oink.org.pig.oink.common.config.PropertyLoader,5,0,0,5,0,4,0,0,14
ebay_oink.org.pig.oink.common.service.EndNotificationService,0,0,0,0,0,0,0,1,1
ebay_oink.org.pig.oink.common.service.impl.HttpNotification,1,0,0,1,0,0,0,0,2
ebay_oink.org.pig.oink.common.service.impl.EmailNotification,0,0,0,0,0,0,0,1,1
ebay_oink.org.pig.oink.common.config.ConfigurationLoader,0,0,0,0,0,0,0,2,2
ebay_oink.org.pig.oink.testutils.ServletTestCase,2,0,0,0,0,0,0,0,2
smola_galimatias.io.mola.galimatias.canonicalize.URLCanonicalizer,1,0,0,1,0,0,0,0,2
smola_galimatias.io.mola.galimatias.URL,8,0,0,8,0,0,0,2,18
smola_galimatias.io.mola.galimatias.URLParsingSettings,2,0,0,2,0,2,0,0,6
smola_galimatias.io.mola.galimatias.GalimatiasParseException,2,0,0,2,0,0,0,0,4
smola_galimatias.io.mola.galimatias.Domain,1,0,0,0,0,0,0,0,1
smola_galimatias.io.mola.galimatias.FormURLEncodedParser,1,0,0,0,0,0,0,0,1
smola_galimatias.io.mola.galimatias.IPv6Address,2,1,0,2,0,0,0,0,5
smola_galimatias.io.mola.galimatias.Host,1,0,0,0,0,0,0,0,1
smola_galimatias.io.mola.galimatias.URLParser,1,1,0,1,0,0,0,0,3
smola_galimatias.io.mola.galimatias.URLSearchParameters,7,0,0,5,0,0,0,0,12
smola_galimatias.io.mola.galimatias.IPv4Address,2,0,0,2,0,0,0,0,4
google_guice.com.google.inject.testing.throwingproviders.CheckedProviderSubject,0,0,0,0,0,0,0,3,3
google_guice.com.google.inject.throwingproviders.ThrowingProviderBinder,1,0,0,1,0,4,0,1,7
google_guice.com.google.inject.AbstractModule,16,2,0,11,0,17,0,15,61
google_guice.com.google.inject.throwingproviders.ThrowingProvider,1,0,0,1,0,2,0,0,4
google_guice.com.google.inject.binder.ScopedBindingBuilder,0,0,0,0,0,0,0,1,1
google_guice.com.google.inject.name.Names,14,0,0,6,0,3,0,15,38
google_guice.com.google.inject.Provider,6,0,0,1,0,3,0,0,10
google_guice.com.google.inject.CreationException,24,0,0,4,0,28,0,0,56
google_guice.com.google.inject.internal.InternalFlags,6,1,0,4,0,1,0,3,15
google_guice.com.google.inject.ConfigurationException,4,0,0,0,0,4,0,0,8
google_guice.com.google.inject.Injector,1,0,0,0,0,0,0,1,2
google_guice.com.google.inject.matcher.Matchers,19,1,0,14,0,2,0,0,36
google_guice.com.google.inject.binder.AnnotatedConstantBindingBuilder,1,0,0,1,0,0,0,0,2
google_guice.com.google.inject.spi.Elements,0,0,0,0,0,0,0,1,1
google_guice.com.google.inject.Binder,0,0,0,0,0,0,0,22,22
google_guice.com.google.inject.binder.ConstantBindingBuilder,1,0,0,1,0,0,0,0,2
google_guice.com.google.inject.PrivateModule,0,0,0,0,0,0,0,2,2
google_guice.com.google.inject.spi.Element,1,0,0,1,0,0,0,0,2
google_guice.com.google.inject.Binding,1,0,0,1,0,0,0,0,2
google_guice.com.google.inject.multibindings.MultibindingsScanner,4,0,0,4,0,3,0,0,11
google_guice.com.google.inject.internal.Messages,0,0,0,0,0,0,0,0,0
google_guice.com.google.inject.internal.PackageNameCompressor,0,0,0,0,0,0,0,0,0
google_guice.com.google.inject.internal.ProxyFactory,3,0,0,3,0,0,0,0,6
google_guice.com.google.inject.internal.util.ContinuousStopwatch,2,0,0,0,0,0,0,0,2
google_guice.com.google.inject.util.Types,1,0,0,1,0,0,0,0,2
google_guice.com.google.inject.spi.InjectionPoint,1,0,0,1,0,0,0,1,3
google_guice.com.google.inject.spi.ProviderInstanceBinding,1,0,0,0,0,1,0,0,2
google_guice.com.google.inject.internal.ProviderMethodsModule,2,0,0,0,0,0,0,0,2
google_guice.com.google.inject.ProvisionException,7,0,0,0,0,0,0,0,7
nidi3_raml-tester.guru.nidi.ramltester.util.MediaType,4,0,0,3,0,0,0,0,7
nidi3_raml-tester.guru.nidi.ramltester.model.Values,7,0,0,5,0,0,0,0,12
nidi3_raml-tester.guru.nidi.ramltester.RamlLoaders,2,0,0,2,0,0,0,9,13
nidi3_raml-tester.guru.nidi.ramltester.restassured.RestAssuredClient,5,0,0,5,0,0,0,0,10
nidi3_raml-tester.guru.nidi.ramltester.RamlDefinition,5,0,0,4,0,1,0,2,12
nidi3_raml-tester.guru.nidi.ramltester.core.RamlReport,4,0,0,3,0,0,0,0,7
nidi3_raml-tester.guru.nidi.ramltester.core.Usage,1,0,0,1,0,0,0,0,2
nidi3_raml-tester.guru.nidi.ramltester.core.RamlViolations,2,0,0,2,0,0,0,0,4
nidi3_raml-tester.guru.nidi.ramltester.core.RamlValidator,0,0,0,0,0,0,0,0,0
nidi3_raml-tester.guru.nidi.ramltester.MultiReportAggregator,2,0,0,2,0,0,0,0,4
nidi3_raml-tester.guru.nidi.ramltester.SimpleReportAggregator,1,0,0,1,0,0,0,0,2
nidi3_raml-tester.guru.nidi.ramltester.httpcomponents.RamlHttpClient,4,0,0,4,0,0,0,0,8
nidi3_raml-tester.guru.nidi.ramltester.model.RamlMessage,2,0,0,1,0,0,0,0,3
nidi3_raml-tester.guru.nidi.ramltester.model.RamlRequest,2,0,0,0,0,0,0,0,2
nidi3_raml-tester.guru.nidi.ramltester.restassured3.RestAssuredClient,5,0,0,5,0,0,0,0,10
nidi3_raml-tester.guru.nidi.ramltester.core.JsRegex,2,0,0,0,0,0,0,0,2
nidi3_raml-tester.guru.nidi.ramltester.core.VariableMatcher,0,0,0,0,0,0,0,4,4
nidi3_raml-tester.guru.nidi.ramltester.spring.SpringMockRamlRequest,3,0,0,2,0,0,0,0,5
nidi3_raml-tester.guru.nidi.ramltester.junit.RamlMatchers,0,0,0,0,0,0,0,6,6
tracee_tracee.io.tracee.Tracee,0,0,0,0,0,0,0,0,0
tracee_tracee.io.tracee.testhelper.SimpleTraceeBackend,4,0,0,1,0,0,0,0,5
tracee_tracee.io.tracee.BackendProviderResolver,0,0,0,0,0,0,0,0,0
tracee_tracee.io.tracee.BackendProviderSet,1,0,0,0,0,0,0,0,1
tracee_tracee.io.tracee.TraceeBackend,26,0,0,20,0,0,0,24,70
tracee_tracee.io.tracee.testhelper.FieldAccessUtil,1,0,0,0,0,0,0,0,1
tracee_tracee.io.tracee.configuration.TraceeFilterConfiguration,0,0,0,0,0,0,0,7,7
tracee_tracee.io.tracee.testhelper.PermitAllTraceeFilterConfiguration,2,0,0,0,0,0,0,0,2
chanjarster_weixin-java-tools.me.chanjar.weixin.mp.bean.result.WxRedpackResult,2,0,0,2,0,0,0,0,4
chanjarster_weixin-java-tools.me.chanjar.weixin.mp.bean.WxMpMassOpenIdsMessage,1,0,0,1,0,0,0,0,2
chanjarster_weixin-java-tools.me.chanjar.weixin.mp.bean.WxMpMassGroupMessage,1,0,0,1,0,0,0,0,2
chanjarster_weixin-java-tools.me.chanjar.weixin.common.bean.WxMenu,0,0,0,0,0,0,0,1,1
chanjarster_weixin-java-tools.me.chanjar.weixin.mp.api.WxMpServiceImpl,1,0,0,0,0,0,0,0,1
FlexTradeUKLtd_jfixture.com.flextrade.jfixture.mockito.utility.PropertyUtil,0,0,0,0,0,0,0,0,0
FlexTradeUKLtd_jfixture.com.flextrade.jfixture.mockito.customisation.MockitoAutoPropertySpecification,0,0,0,0,0,0,0,0,0
FlexTradeUKLtd_jfixture.com.flextrade.jfixture.JFixture,38,0,0,0,0,2,0,4,44
FlexTradeUKLtd_jfixture.com.flextrade.jfixture.FixtureAnnotations,2,0,0,0,0,0,0,0,2
FlexTradeUKLtd_jfixture.com.flextrade.jfixture.FluentCustomisation,3,0,0,3,0,0,0,0,6
FlexTradeUKLtd_jfixture.com.flextrade.jfixture.rules.FixtureRule,0,0,0,0,0,0,0,0,0
FlexTradeUKLtd_jfixture.com.flextrade.jfixture.DefaultFactoryMethodQuery,3,0,0,0,0,0,0,0,3
FlexTradeUKLtd_jfixture.com.flextrade.jfixture.SpecimenBuilderContext,0,0,0,0,0,0,0,1,1
FlexTradeUKLtd_jfixture.com.flextrade.jfixture.SpecimenBuilder,0,0,0,0,0,0,0,5,5
FlexTradeUKLtd_jfixture.com.flextrade.jfixture.MultipleCount,0,0,0,0,0,0,0,0,0
FlexTradeUKLtd_jfixture.com.flextrade.jfixture.DefaultFluentCustomisation,0,0,0,0,0,0,0,1,1
FlexTradeUKLtd_jfixture.com.flextrade.jfixture.FixtureBehaviour,0,0,0,0,0,0,0,2,2
FlexTradeUKLtd_jfixture.com.flextrade.jfixture.FixtureBehaviours,0,0,0,0,0,0,0,1,1
FlexTradeUKLtd_jfixture.com.flextrade.jfixture.DefaultConstructorQuery,4,0,0,0,0,0,0,0,4
FlexTradeUKLtd_jfixture.com.flextrade.jfixture.behaviours.autoproperty.AutoPropertyBehaviour,0,0,0,0,0,0,0,0,0
FlexTradeUKLtd_jfixture.com.flextrade.jfixture.behaviours.autoproperty.DefaultAutoPropertySpecification,2,0,0,0,0,0,0,0,2
FlexTradeUKLtd_jfixture.com.flextrade.jfixture.behaviours.tracing.TracingBehaviour,0,0,0,0,0,0,0,0,0
FlexTradeUKLtd_jfixture.com.flextrade.jfixture.behaviours.tracing.DebugTracingStrategy,1,0,0,0,0,0,0,0,1
FlexTradeUKLtd_jfixture.com.flextrade.jfixture.behaviours.tracing.MemberOnlyResponseStrategy,0,0,0,0,0,0,0,0,0
FlexTradeUKLtd_jfixture.com.flextrade.jfixture.behaviours.tracing.SpecimenTracer,0,0,0,0,0,0,0,1,1
FlexTradeUKLtd_jfixture.com.flextrade.jfixture.behaviours.specimentype.SpecimenTypeInjectorBehaviour,0,0,0,0,0,0,0,0,0
FlexTradeUKLtd_jfixture.com.flextrade.jfixture.behaviours.specimentype.SpecimenTypeInjector,1,0,0,1,0,0,0,1,3
FlexTradeUKLtd_jfixture.com.flextrade.jfixture.behaviours.recursion.OmitSpecimenRecursionHandler,0,0,0,0,0,0,0,0,0
FlexTradeUKLtd_jfixture.com.flextrade.jfixture.behaviours.recursion.ThrowingRecursionBehaviour,0,0,0,0,0,0,0,0,0
FlexTradeUKLtd_jfixture.com.flextrade.jfixture.behaviours.recursion.OmitSpecimenRecursionBehaviour,0,0,0,0,0,0,0,0,0
FlexTradeUKLtd_jfixture.com.flextrade.jfixture.behaviours.noresolution.ThrowOnNoResolutionBehaviour,0,0,0,0,0,0,0,0,0
FlexTradeUKLtd_jfixture.com.flextrade.jfixture.behaviours.noresolution.IgnoreNoResolutionHandler,0,0,0,0,0,0,0,0,0
FlexTradeUKLtd_jfixture.com.flextrade.jfixture.behaviours.noresolution.IgnoreNoResolutionBehaviour,0,0,0,0,0,0,0,0,0
FlexTradeUKLtd_jfixture.com.flextrade.jfixture.builders.QueueBuilder,0,0,0,0,0,0,0,0,0
FlexTradeUKLtd_jfixture.com.flextrade.jfixture.builders.SwitchingBooleanGenerator,1,0,0,0,0,0,0,0,1
FlexTradeUKLtd_jfixture.com.flextrade.jfixture.specifications.Specification,0,0,0,0,0,0,0,0,0
FlexTradeUKLtd_jfixture.com.flextrade.jfixture.ConstructorQuery,0,0,0,0,0,0,0,0,0
FlexTradeUKLtd_jfixture.com.flextrade.jfixture.SpecimenContext,3,0,0,3,0,0,0,0,6
FlexTradeUKLtd_jfixture.com.flextrade.jfixture.builders.MultipleSpecimenRelay,0,0,0,0,0,0,0,1,1
FlexTradeUKLtd_jfixture.com.flextrade.jfixture.builders.CalendarBuilder,1,0,0,0,0,0,0,1,2
FlexTradeUKLtd_jfixture.com.flextrade.jfixture.FactoryMethodQuery,0,0,0,0,0,0,0,0,0
FlexTradeUKLtd_jfixture.com.flextrade.jfixture.builders.SeedIgnoringRelay,0,0,0,0,0,0,0,0,0
FlexTradeUKLtd_jfixture.com.flextrade.jfixture.builders.FactoryMethodRelay,0,0,0,0,0,0,0,0,0
FlexTradeUKLtd_jfixture.com.flextrade.jfixture.builders.SetBuilder,0,0,0,0,0,0,0,0,0
FlexTradeUKLtd_jfixture.com.flextrade.jfixture.builders.NumericRangeRelay,0,0,0,0,0,0,0,0,0
FlexTradeUKLtd_jfixture.com.flextrade.jfixture.builders.IterableBuilder,1,0,0,0,0,0,0,0,1
FlexTradeUKLtd_jfixture.com.flextrade.jfixture.builders.EnumBuilder,0,0,0,0,0,0,0,0,0
FlexTradeUKLtd_jfixture.com.flextrade.jfixture.builders.StringGenerator,0,0,0,0,0,0,0,0,0
FlexTradeUKLtd_jfixture.com.flextrade.jfixture.builders.CharacterGenerator,0,0,0,0,0,0,0,0,0
FlexTradeUKLtd_jfixture.com.flextrade.jfixture.builders.UuidGenerator,0,0,0,0,0,0,0,0,0
FlexTradeUKLtd_jfixture.com.flextrade.jfixture.builders.ElementFromListRelay,0,0,0,0,0,0,0,0,0
FlexTradeUKLtd_jfixture.com.flextrade.jfixture.builders.UrlBuilder,0,0,0,0,0,0,0,0,0
FlexTradeUKLtd_jfixture.com.flextrade.jfixture.builders.NumberInRangeGenerator,4,0,0,0,0,0,0,0,4
FlexTradeUKLtd_jfixture.com.flextrade.jfixture.builders.ArrayRelay,0,0,0,0,0,0,0,0,0
FlexTradeUKLtd_jfixture.com.flextrade.jfixture.builders.DateGenerator,0,0,0,0,0,0,0,0,0
FlexTradeUKLtd_jfixture.com.flextrade.jfixture.utility.TimeProvider,1,0,0,1,0,0,0,0,2
FlexTradeUKLtd_jfixture.com.flextrade.jfixture.builders.MapBuilder,1,0,0,0,0,0,0,0,1
FlexTradeUKLtd_jfixture.com.flextrade.jfixture.builders.UriBuilder,0,0,0,0,0,0,0,1,1
FlexTradeUKLtd_jfixture.com.flextrade.jfixture.builders.FieldRelay,1,0,0,1,0,0,0,0,2
FlexTradeUKLtd_jfixture.com.flextrade.jfixture.builders.SeededStringBuilder,0,0,0,0,0,0,0,0,0
FlexTradeUKLtd_jfixture.com.flextrade.jfixture.builders.KeyValuePairRelay,0,0,0,0,0,0,0,0,0
FlexTradeUKLtd_jfixture.com.flextrade.jfixture.specifications.NeverSpecification,1,0,0,0,0,0,0,0,1
FlexTradeUKLtd_jfixture.com.flextrade.jfixture.specifications.TypeRequestSpecification,0,0,0,0,0,0,0,0,0
FlexTradeUKLtd_jfixture.com.flextrade.jfixture.specifications.SpecificTypeSpecification,0,0,0,0,0,0,0,0,0
FlexTradeUKLtd_jfixture.com.flextrade.jfixture.utility.SpecimenType,1,0,0,1,0,0,0,0,2
FlexTradeUKLtd_jfixture.com.flextrade.jfixture.utility.GenericTypeCollection,1,0,0,1,0,0,0,0,2
FlexTradeUKLtd_jfixture.com.flextrade.jfixture.utility.GenericType,0,0,0,0,0,0,0,0,0
FlexTradeUKLtd_jfixture.com.flextrade.jfixture.utility.PropertyUtil,0,0,0,0,0,0,0,0,0
FlexTradeUKLtd_jfixture.com.flextrade.jfixture.utility.comparators.MethodParameterCountComparator,0,0,0,0,0,0,0,0,0
FlexTradeUKLtd_jfixture.com.flextrade.jfixture.utility.CircularList,3,0,0,0,0,0,0,0,3
FlexTradeUKLtd_jfixture.com.flextrade.jfixture.utility.StringUtil,1,0,0,0,0,0,0,0,1
FlexTradeUKLtd_jfixture.com.flextrade.jfixture.utility.RequestFilter,0,0,0,0,0,0,0,0,0
FlexTradeUKLtd_jfixture.com.flextrade.jfixture.utility.IntegerPolyfill,5,0,0,0,0,0,0,0,5
FlexTradeUKLtd_jfixture.com.flextrade.jfixture.utility.comparators.ConstructorParameterCountComparator,0,0,0,0,0,0,0,0,0
FlexTradeUKLtd_jfixture.com.flextrade.jfixture.customisation.SubTypeRelay,0,0,0,0,0,0,0,1,1
FlexTradeUKLtd_jfixture.com.flextrade.jfixture.customisation.CustomBuilder,0,0,0,0,0,0,0,2,2
FlexTradeUKLtd_jfixture.com.flextrade.jfixture.customisation.fluent.AutoPropertyBehaviour,0,0,0,0,0,0,0,2,2
FlexTradeUKLtd_jfixture.com.flextrade.jfixture.customisation.fluent.RecursionBehaviour,1,0,0,1,0,0,0,2,4
FlexTradeUKLtd_jfixture.com.flextrade.jfixture.customisation.fluent.NoResolutionBehaviour,0,0,0,0,0,0,0,2,2
FlexTradeUKLtd_jfixture.com.flextrade.jfixture.requests.enrichers.NumberListBuilder,8,0,0,0,0,0,0,0,8
FlexTradeUKLtd_jfixture.com.flextrade.jfixture.requests.enrichers.StringListBuilder,1,0,0,0,0,0,0,0,1
FlexTradeUKLtd_jfixture.com.flextrade.jfixture.requests.enrichers.RangeRequestEnricher,1,0,0,1,0,0,0,0,2
FlexTradeUKLtd_jfixture.com.flextrade.jfixture.requests.enrichers.FromListRequestEnricher,1,0,0,1,0,0,0,0,2
FlexTradeUKLtd_jfixture.com.flextrade.jfixture.requests.enrichers.RequestEnricher,0,0,0,0,0,0,0,1,1
FlexTradeUKLtd_jfixture.com.flextrade.jfixture.BehavioursContainer,0,0,0,0,0,0,0,0,0
mulesoft-labs_rhinodo.org.mule.tools.rhinodo.rhino.NodeRequire,2,0,0,0,0,1,0,0,3
mulesoft-labs_rhinodo.org.mule.tools.rhinodo.rhino.NodeJsGlobal,3,0,0,0,0,0,0,0,3
mulesoft-labs_rhinodo.org.mule.tools.rhinodo.impl.console.WrappingConsoleProvider,0,0,0,0,0,0,0,0,0
mulesoft-labs_rhinodo.org.mule.tools.rhinodo.impl.NodeModuleProviderImpl,1,0,0,0,0,0,0,0,1
release-engineering_pom-manipulation-ext.org.commonjava.maven.ext.common.util.WildcardMap,4,0,0,1,0,0,0,0,5
release-engineering_pom-manipulation-ext.org.commonjava.maven.ext.common.util.JSONUtils,1,0,0,1,0,0,0,0,2
release-engineering_pom-manipulation-ext.org.commonjava.maven.ext.common.util.ManifestUtils,2,0,0,0,0,2,0,0,4
release-engineering_pom-manipulation-ext.org.commonjava.maven.ext.common.model.SimpleScopedArtifactRef,0,0,0,0,0,0,0,0,0
release-engineering_pom-manipulation-ext.org.commonjava.maven.ext.io.rest.DefaultTranslator,13,0,0,1,0,7,0,0,21
release-engineering_pom-manipulation-ext.org.commonjava.maven.ext.io.rest.Translator,1,0,0,0,0,1,0,0,2
release-engineering_pom-manipulation-ext.org.commonjava.maven.ext.io.JSONIO,8,0,0,7,0,1,0,0,16
release-engineering_pom-manipulation-ext.org.commonjava.maven.ext.io.FileIO,0,0,0,0,0,0,0,0,0
release-engineering_pom-manipulation-ext.org.commonjava.maven.ext.io.resolver.GalleyInfrastructure,3,0,0,3,0,0,0,0,6
release-engineering_pom-manipulation-ext.org.commonjava.maven.ext.common.ManipulationUncheckedException,2,0,0,0,0,2,0,0,4
release-engineering_pom-manipulation-ext.org.commonjava.maven.ext.io.PomIO,19,5,0,16,0,1,0,0,41
release-engineering_pom-manipulation-ext.org.commonjava.maven.ext.io.XMLIO,4,0,0,4,0,0,0,0,8
release-engineering_pom-manipulation-ext.org.commonjava.maven.ext.common.ManipulationException,3,0,0,0,0,3,0,0,6
release-engineering_pom-manipulation-ext.org.commonjava.maven.ext.io.SettingsIO,2,0,0,0,0,0,0,0,2
release-engineering_pom-manipulation-ext.org.commonjava.maven.ext.core.impl.Manipulator,1,0,0,0,0,0,0,0,1
release-engineering_pom-manipulation-ext.org.commonjava.maven.ext.core.state.VersioningState,0,0,0,0,0,0,0,0,0
release-engineering_pom-manipulation-ext.org.commonjava.maven.ext.core.state.RelocationState,0,0,0,0,0,0,0,0,0
release-engineering_pom-manipulation-ext.org.commonjava.maven.ext.core.state.SuffixState,4,0,0,2,0,0,0,0,6
release-engineering_pom-manipulation-ext.org.commonjava.maven.ext.core.util.PropertiesUtils,8,0,0,2,0,1,0,0,11
release-engineering_pom-manipulation-ext.org.commonjava.maven.ext.common.util.PropertyResolver,1,0,0,0,0,0,0,0,1
release-engineering_pom-manipulation-ext.org.commonjava.maven.ext.common.model.Project,2,0,0,2,0,0,0,0,4
release-engineering_pom-manipulation-ext.org.commonjava.maven.ext.common.util.PropertyInterpolator,2,0,0,2,0,0,0,0,4
release-engineering_pom-manipulation-ext.org.commonjava.maven.ext.common.util.ProjectComparator,3,0,0,3,0,0,0,0,6
release-engineering_pom-manipulation-ext.org.commonjava.maven.ext.core.impl.Version,23,0,0,7,0,0,0,0,30
release-engineering_pom-manipulation-ext.org.commonjava.maven.ext.core.impl.VersionCalculator,3,0,0,0,0,0,0,0,3
release-engineering_pom-manipulation-ext.org.commonjava.maven.ext.core.groovy.BaseScript,1,1,0,1,0,1,0,0,4
release-engineering_pom-manipulation-ext.org.commonjava.maven.ext.cli.Cli,14,0,0,0,0,0,0,0,14
release-engineering_pom-manipulation-ext.org.commonjava.maven.ext.core.ManipulationSession,0,0,0,0,0,0,0,0,0
release-engineering_pom-manipulation-ext.org.commonjava.maven.ext.integrationtest.ITestUtils,5,0,0,0,0,0,0,22,27
vert-x3_vertx-codegen.io.vertx.core.json.JsonObject,8,0,0,6,0,0,0,0,14
vert-x3_vertx-codegen.io.vertx.codegen.ClassModel,127,0,0,127,0,1,0,3,258
vert-x3_vertx-codegen.io.vertx.codegen.DataObjectModel,56,0,0,50,0,0,0,0,106
vert-x3_vertx-codegen.io.vertx.codegen.EnumModel,4,0,0,4,0,0,0,0,8
vert-x3_vertx-codegen.io.vertx.codegen.ModuleModel,3,0,0,3,0,0,0,0,6
vert-x3_vertx-codegen.io.vertx.codegen.PackageModel,3,0,0,0,0,0,0,0,3
vert-x3_vertx-codegen.io.vertx.codegen.type.TypeInfo,2,0,0,2,0,0,0,0,4
vert-x3_vertx-codegen.io.vertx.codegen.type.TypeVariableInfo,1,0,0,1,0,0,0,0,2
vert-x3_vertx-codegen.io.vertx.codegen.type.ParameterizedTypeInfo,0,0,0,0,0,0,0,3,3
vert-x3_vertx-codegen.io.vertx.codegen.type.DataObjectInfo,1,0,0,1,0,0,0,0,2
vert-x3_vertx-codegen.io.vertx.codegen.type.ClassTypeInfo,2,0,0,2,0,0,0,0,4
vert-x3_vertx-codegen.io.vertx.codegen.type.TypeReflectionFactory,2,0,0,2,0,0,0,0,4
vert-x3_vertx-codegen.io.vertx.codegen.PropertyInfo,1,0,0,1,0,0,0,0,2
vert-x3_vertx-codegen.io.vertx.codegen.format.Case,1,0,0,0,0,0,0,0,1
vert-x3_vertx-codegen.io.vertx.codegen.Helper,1,0,0,0,0,0,0,0,1
vert-x3_vertx-codegen.io.vertx.codegen.doc.Token,5,0,0,5,0,0,0,0,10
vert-x3_vertx-codegen.io.vertx.codegen.doc.Doc,4,0,0,4,0,0,0,0,8
vert-x3_vertx-codegen.io.vertx.codegen.Compiler,8,0,0,4,0,0,0,0,12
vert-x3_vertx-codegen.io.vertx.codegen.writer.CodeWriter,2,0,0,2,0,0,0,7,11
twitter_cloudhopper-commons.com.cloudhopper.commons.util.DecimalUtil,1,0,0,0,0,0,0,0,1
twitter_cloudhopper-commons.com.cloudhopper.commons.util.EncryptUtil,2,0,0,0,0,0,0,0,2
twitter_cloudhopper-commons.com.cloudhopper.commons.util.PeriodFormatterUtil,2,0,0,0,0,0,0,0,2
twitter_cloudhopper-commons.com.cloudhopper.commons.util.MetaFieldUtil,2,0,0,1,0,0,0,1,4
twitter_cloudhopper-commons.com.cloudhopper.commons.util.HexUtil,16,0,0,1,0,0,0,0,17
twitter_cloudhopper-commons.com.cloudhopper.commons.util.CircularIndex,4,0,0,3,0,0,0,0,7
twitter_cloudhopper-commons.com.cloudhopper.commons.util.RunningAverage,1,0,0,1,0,0,0,0,2
twitter_cloudhopper-commons.com.cloudhopper.commons.util.ThreadUtil,1,0,0,0,0,0,0,0,1
twitter_cloudhopper-commons.com.cloudhopper.commons.util.ByteBuffer,23,0,0,19,0,0,0,0,42
twitter_cloudhopper-commons.com.cloudhopper.commons.util.StringLookupMap,1,0,0,1,0,0,0,0,2
twitter_cloudhopper-commons.com.cloudhopper.commons.util.URL,1,0,0,1,0,0,0,0,2
twitter_cloudhopper-commons.com.cloudhopper.commons.util.URLParser,11,0,0,11,0,0,0,0,22
twitter_cloudhopper-commons.com.cloudhopper.commons.util.RandomUtil,1,0,0,0,0,0,0,0,1
twitter_cloudhopper-commons.com.cloudhopper.commons.util.RoundRobinLoadBalancedList,7,0,0,6,0,0,0,0,13
twitter_cloudhopper-commons.com.cloudhopper.commons.util.ClassUtil,4,2,0,0,0,2,0,0,8
twitter_cloudhopper-commons.com.cloudhopper.commons.util.DateTimeUtil,11,0,0,0,0,0,0,0,11
twitter_cloudhopper-commons.com.cloudhopper.commons.util.StringUtil,13,1,0,0,0,0,0,0,14
twitter_cloudhopper-commons.com.cloudhopper.commons.util.FileUtil,9,0,0,1,0,0,0,0,10
twitter_cloudhopper-commons.com.cloudhopper.commons.util.LoadBalancedList,2,0,0,0,0,0,0,0,2
twitter_cloudhopper-commons.com.cloudhopper.commons.util.BeanUtil,6,0,0,6,0,1,0,0,13
twitter_cloudhopper-commons.com.cloudhopper.commons.util.Hasher,4,0,0,0,0,0,0,0,4
twitter_cloudhopper-commons.com.cloudhopper.commons.util.DigitLookupMap,1,0,0,1,0,0,0,0,2
twitter_cloudhopper-commons.com.cloudhopper.commons.util.EnvironmentUtil,1,0,0,0,0,0,0,0,1
twitter_cloudhopper-commons.com.cloudhopper.commons.util.CompressionUtil,2,0,0,0,0,0,0,0,2
twitter_cloudhopper-commons.com.cloudhopper.commons.util.ByteArrayUtil,8,0,0,7,0,0,0,0,15
twitter_cloudhopper-commons.com.cloudhopper.commons.util.windowing.Window,4,0,0,3,0,1,0,1,9
twitter_cloudhopper-commons.com.cloudhopper.commons.util.windowing.WindowFuture,3,0,0,3,0,0,0,0,6
twitter_cloudhopper-commons.com.cloudhopper.commons.util.time.DateTimePeriod,21,0,0,21,0,0,0,0,42
twitter_cloudhopper-commons.com.cloudhopper.commons.util.time.DateTimePeriodSelector,0,0,0,0,0,0,0,0,0
searchisko_elasticsearch-river-sysinfo.org.jboss.elasticsearch.river.sysinfo.SourceClientBase,1,0,0,0,0,0,0,0,1
searchisko_elasticsearch-river-sysinfo.org.jboss.elasticsearch.river.sysinfo.Utils,4,0,0,0,0,0,0,0,4
searchisko_elasticsearch-river-sysinfo.org.jboss.elasticsearch.river.sysinfo.SourceClientREST,11,0,0,0,0,0,0,0,11
searchisko_elasticsearch-river-sysinfo.org.jboss.elasticsearch.river.sysinfo.SysinfoIndexer,1,0,0,1,0,0,0,1,3
searchisko_elasticsearch-river-sysinfo.org.jboss.elasticsearch.river.sysinfo.SysinfoRiver,8,0,0,7,0,1,0,0,16
searchisko_elasticsearch-river-sysinfo.org.jboss.elasticsearch.river.sysinfo.esclient.SourceClientESClient,4,0,0,0,0,4,0,7,15
searchisko_elasticsearch-river-sysinfo.org.jboss.elasticsearch.river.sysinfo.esclient.LocalRestRequest,1,0,0,1,0,0,0,0,2
searchisko_elasticsearch-river-sysinfo.org.jboss.elasticsearch.river.sysinfo.esclient.SourceClientESTransportClient,1,0,0,0,0,0,0,0,1
searchisko_elasticsearch-river-sysinfo.org.jboss.elasticsearch.river.sysinfo.esclient.LocalRestChannel,0,0,0,0,0,0,0,0,0
searchisko_elasticsearch-river-sysinfo.org.jboss.elasticsearch.river.sysinfo.mgm.TransportJRMgmBaseAction,0,0,0,0,0,0,0,0,0
searchisko_elasticsearch-river-sysinfo.org.jboss.elasticsearch.river.sysinfo.mgm.riverslist.TransportListRiversAction,2,0,0,1,0,0,0,0,3
searchisko_elasticsearch-river-sysinfo.org.jboss.elasticsearch.river.sysinfo.mgm.NodeJRMgmBaseResponse,2,0,0,0,0,0,0,0,2
searchisko_elasticsearch-river-sysinfo.org.jboss.elasticsearch.river.sysinfo.mgm.riverslist.ListRiversAction,0,0,0,0,0,0,0,0,0
searchisko_elasticsearch-river-sysinfo.org.jboss.elasticsearch.river.sysinfo.mgm.lifecycle.JRLifecycleAction,0,0,0,0,0,0,0,0,0
searchisko_elasticsearch-river-sysinfo.org.jboss.elasticsearch.river.sysinfo.mgm.lifecycle.JRLifecycleRequest,3,0,0,3,0,0,0,0,6
searchisko_elasticsearch-river-sysinfo.org.jboss.elasticsearch.river.sysinfo.mgm.lifecycle.TransportJRLifecycleAction,5,0,0,2,0,0,0,0,7
searchisko_elasticsearch-river-sysinfo.org.jboss.elasticsearch.river.sysinfo.mgm.lifecycle.JRLifecycleRequestBuilder,1,0,0,1,0,0,0,0,2
searchisko_elasticsearch-river-sysinfo.org.jboss.elasticsearch.river.sysinfo.mgm.NodeJRMgmBaseRequest,2,0,0,0,0,0,0,0,2
searchisko_elasticsearch-river-sysinfo.org.jboss.elasticsearch.river.sysinfo.mgm.JRMgmBaseResponse,2,0,0,0,0,0,0,0,2
searchisko_elasticsearch-river-sysinfo.org.jboss.elasticsearch.river.sysinfo.mgm.period.JRPeriodRequest,3,0,0,3,0,0,0,0,6
searchisko_elasticsearch-river-sysinfo.org.jboss.elasticsearch.river.sysinfo.mgm.period.TransportJRPeriodAction,5,0,0,2,0,0,0,0,7
searchisko_elasticsearch-river-sysinfo.org.jboss.elasticsearch.river.sysinfo.mgm.period.JRPeriodAction,0,0,0,0,0,0,0,0,0
searchisko_elasticsearch-river-sysinfo.org.jboss.elasticsearch.river.sysinfo.mgm.period.NodeJRPeriodResponse,1,0,0,1,0,0,0,0,2
searchisko_elasticsearch-river-sysinfo.org.jboss.elasticsearch.river.sysinfo.mgm.period.JRPeriodRequestBuilder,1,0,0,1,0,0,0,0,2
addthis_hydra.com.addthis.hydra.common.hash.PluggableHashFunction,0,0,0,0,0,0,0,1,1
addthis_hydra.com.addthis.hydra.store.util.SeenFilterBasic,1,0,0,1,0,0,0,0,2
addthis_hydra.com.addthis.hydra.store.kv.ByteStore,2,0,0,2,0,2,0,0,6
addthis_hydra.com.addthis.hydra.store.kv.BdbUtils,1,0,0,0,0,0,0,0,1
sanity_quickml.quickml.supervised.tree.decisionTree.DecisionTreeBuilder,1,0,0,1,0,0,2,7,11
sanity_quickml.quickml.data.instances.InstanceWithAttributesMap,2,0,0,2,0,0,0,0,4
sanity_quickml.quickml.supervised.crossValidation.attributeImportance.LossFunctionTracker,0,0,0,0,0,0,0,0,0
sanity_quickml.quickml.supervised.PredictiveModelsFromPreviousVersionsToBenchMarkAgainst.OldTreeBuilder,0,0,0,0,0,0,0,1,1
sanity_quickml.quickml.supervised.crossValidation.attributeImportance.AttributeLossSummary,2,0,0,0,0,0,0,0,2
sanity_quickml.quickml.supervised.crossValidation.lossfunctions.classifierLossFunctions.WeightedAUCCrossValLossFunction,1,0,0,0,0,0,0,0,1
sanity_quickml.quickml.supervised.crossValidation.lossfunctions.classifierLossFunctions.ClassifierMSELossFunction,0,0,0,0,0,0,0,0,0
sanity_quickml.quickml.supervised.crossValidation.lossfunctions.rankingLossFunctions.NDCG,0,0,0,0,0,0,0,0,0
sanity_quickml.quickml.supervised.crossValidation.data.FoldedData,1,0,0,1,0,0,0,0,2
sanity_quickml.quickml.supervised.crossValidation.data.OutOfTimeData,2,0,0,2,0,0,0,0,4
sanity_quickml.quickml.data.AttributesMap,2,0,0,2,0,0,0,0,4
sanity_quickml.quickml.supervised.predictiveModelOptimizer.PredictiveModelOptimizer,0,0,0,0,0,0,0,1,1
sanity_quickml.quickml.supervised.predictiveModelOptimizer.fieldValueRecommenders.MonotonicConvergenceRecommender,0,0,0,0,0,0,0,0,0
sanity_quickml.quickml.supervised.inspection.NumericDistributionSampler,1,0,0,0,0,0,0,0,1
sanity_quickml.quickml.supervised.inspection.CategoricalDistributionSampler,1,0,0,0,0,0,0,0,1
sanity_quickml.quickml.supervised.dataProcessing.instanceTranformer.CommonCoocurrenceProductFeatureAppender,3,0,0,3,0,0,2,3,11
sanity_quickml.quickml.supervised.tree.decisionTree.reducers.DTBinaryCatBranchReducer,2,0,0,2,0,0,0,1,5
sanity_quickml.quickml.supervised.tree.decisionTree.reducers.DTNumBranchReducer,3,0,0,1,0,0,0,0,4
sanity_quickml.quickml.supervised.tree.decisionTree.valueCounters.ClassificationCounter,3,0,0,3,0,0,0,0,6
sanity_quickml.quickml.supervised.tree.decisionTree.scorers.PenalizedInformationGainScorer,0,0,0,0,0,0,0,0,0
sanity_quickml.quickml.supervised.tree.decisionTree.scorers.PenalizedMSEScorer,0,0,0,0,0,0,0,0,0
sanity_quickml.quickml.supervised.tree.decisionTree.reducers.DTCatBranchReducer,0,0,0,0,0,0,0,0,0
sanity_quickml.quickml.supervised.tree.reducers.AttributeStats,1,0,0,1,0,0,0,0,2
sanity_quickml.quickml.supervised.predictiveModelOptimizer.MultiLossModelTester,0,0,0,0,0,0,1,0,1
sanity_quickml.quickml.supervised.classifier.temporallyWeightClassifier.TemporallyReweightedClassifierBuilder,0,0,0,0,0,0,1,0,1
sanity_quickml.quickml.supervised.regressionModel.LinearRegression2.SimpleRidgeRegressionBuilder,0,0,0,0,0,0,0,0,0
sanity_quickml.quickml.supervised.regressionModel.LinearRegression.RidgeLinearModelBuilder,0,0,0,0,0,0,0,0,0
sanity_quickml.quickml.supervised.regressionModel.IsotonicRegression.PoolAdjacentViolatorsModel,2,0,0,0,0,0,0,0,2
sanity_quickml.quickml.collections.ValueSummingMap,1,0,0,1,0,0,0,0,2
sanity_quickml.quickml.supervised.featureEngineering1.enrichStrategies.probabilityInjector.ProbabilityEnrichStrategy,1,0,0,1,0,0,0,0,2
sanity_quickml.quickml.supervised.featureEngineering1.enrichStrategies.attributeCombiner.AttributeCombiningEnricher,1,0,0,1,0,0,0,0,2
sanity_quickml.quickml.supervised.featureEngineering1.enrichStrategies.probabilityInjector.ProbabilityInjectingEnricher,1,0,0,1,0,0,0,0,2
sanity_quickml.quickml.supervised.featureEngineering1.FeatureEngineeringClassifierBuilder,0,0,0,0,0,0,0,1,1
sanity_quickml.quickml.supervised.classifier.logisticRegression.SparseSGD,8,0,0,4,0,0,0,0,12
sanity_quickml.quickml.data.instances.Instance,0,0,0,0,0,0,0,0,0
sanity_quickml.quickml.supervised.classifier.Classifier,0,0,0,0,0,0,0,0,0
swagger-api_swagger-parser.io.swagger.v3.parser.processors.ComponentsProcessor,1,0,0,1,0,0,0,2,4
swagger-api_swagger-parser.io.swagger.v3.parser.processors.ExternalRefProcessor,3,0,0,1,0,0,0,0,4
swagger-api_swagger-parser.io.swagger.v3.parser.processors.ResponseProcessor,0,0,0,0,0,0,0,1,1
swagger-api_swagger-parser.io.swagger.v3.parser.processors.SchemaProcessor,2,0,0,1,0,0,0,0,3
swagger-api_swagger-parser.io.swagger.v3.parser.processors.ParameterProcessor,2,0,0,0,0,0,0,0,2
swagger-api_swagger-parser.io.swagger.v3.parser.processors.RequestBodyProcessor,0,0,0,0,0,0,0,1,1
swagger-api_swagger-parser.io.swagger.v3.parser.util.ClasspathHelper,0,0,0,0,0,0,0,0,0
swagger-api_swagger-parser.io.swagger.v3.parser.core.models.ParseOptions,62,1,0,60,0,3,0,7,133
swagger-api_swagger-parser.io.swagger.v3.parser.util.InlineModelResolver,33,0,0,0,0,0,0,1,34
swagger-api_swagger-parser.io.swagger.v3.parser.util.PathUtils,0,0,0,0,0,0,0,0,0
swagger-api_swagger-parser.io.swagger.v3.parser.util.RefUtils,5,0,0,0,0,0,0,2,7
swagger-api_swagger-parser.io.swagger.v3.parser.OpenAPIV3Parser,171,3,0,133,0,1,0,3,311
swagger-api_swagger-parser.io.swagger.v3.parser.util.OpenAPIDeserializer,4,0,0,4,0,0,0,0,8
swagger-api_swagger-parser.io.swagger.v3.parser.util.RemoteUrl,12,0,0,10,0,0,0,0,22
swagger-api_swagger-parser.io.swagger.v3.parser.core.models.SwaggerParseResult,0,0,0,0,0,0,0,0,0
swagger-api_swagger-parser.io.swagger.v3.parser.util.DeserializationUtils,1,0,0,1,0,0,0,0,2
swagger-api_swagger-parser.io.swagger.v3.parser.OpenAPIResolver,4,0,0,3,0,0,0,1,8
swagger-api_swagger-parser.io.swagger.v3.parser.ResolverCache,2,0,0,2,0,0,0,0,4
swagger-api_swagger-parser.io.swagger.v3.parser.converter.SwaggerConverter,0,0,0,0,0,0,0,0,0
swagger-api_swagger-parser.io.swagger.parser.OpenAPIParser,20,0,0,20,0,0,0,0,40
swagger-api_swagger-parser.io.swagger.v3.parser.SwaggerParser,2,0,0,0,0,0,0,0,2
OrbitzWorldwide_consul-client.com.orbitz.consul.Consul,18,5,0,16,0,3,3,6,51
OrbitzWorldwide_consul-client.com.orbitz.consul.model.agent.ImmutableRegistration,6,5,0,6,0,0,5,1,23
OrbitzWorldwide_consul-client.com.orbitz.consul.model.ConsulResponse,2,0,0,2,0,0,3,1,8
OrbitzWorldwide_consul-client.com.orbitz.consul.KeyValueClient,21,0,0,20,0,1,2,2,46
OrbitzWorldwide_consul-client.com.orbitz.consul.cache.ServiceHealthCache,4,0,0,4,0,0,1,1,10
OrbitzWorldwide_consul-client.com.orbitz.consul.StatusClient,0,0,0,0,0,0,2,2,4
OrbitzWorldwide_consul-client.com.orbitz.consul.option.ImmutableQueryOptions,0,0,0,0,0,0,0,1,1
OrbitzWorldwide_consul-client.com.orbitz.consul.option.QueryOptions,0,0,0,0,0,0,0,1,1
OrbitzWorldwide_consul-client.com.orbitz.consul.model.agent.Agent,1,0,0,1,0,0,0,0,2
OrbitzWorldwide_consul-client.com.orbitz.consul.model.health.Service,3,3,0,3,0,0,3,0,12
OrbitzWorldwide_consul-client.com.orbitz.consul.model.health.HealthCheck,3,0,0,3,0,0,0,0,6
OrbitzWorldwide_consul-client.com.orbitz.consul.model.health.ImmutableService,2,0,0,2,0,0,0,0,4
OrbitzWorldwide_consul-client.com.orbitz.consul.model.agent.ImmutableFullService,0,0,0,0,0,0,0,0,0
OrbitzWorldwide_consul-client.com.orbitz.consul.model.agent.FullService,0,0,0,0,0,0,0,0,0
OrbitzWorldwide_consul-client.com.orbitz.consul.CatalogClient,3,0,0,2,0,0,0,0,5
OrbitzWorldwide_consul-client.com.orbitz.consul.model.catalog.ImmutableCatalogService,0,0,0,0,0,0,0,2,2
OrbitzWorldwide_consul-client.com.orbitz.consul.model.catalog.ImmutableCatalogRegistration,1,0,0,1,0,0,0,0,2
OrbitzWorldwide_consul-client.com.orbitz.consul.EventClient,0,0,0,0,0,0,0,0,0
OrbitzWorldwide_consul-client.com.orbitz.consul.model.EventResponse,1,1,0,1,0,0,0,0,3
OrbitzWorldwide_consul-client.com.orbitz.consul.SessionClient,1,0,0,1,0,0,0,0,2
OrbitzWorldwide_consul-client.com.orbitz.consul.model.kv.ImmutableOperation,1,0,0,1,0,0,1,0,3
OrbitzWorldwide_consul-client.com.orbitz.consul.model.session.ImmutableSession,6,0,0,6,0,0,0,0,12
OrbitzWorldwide_consul-client.com.orbitz.consul.cache.ServiceCatalogCache,1,0,0,1,0,0,0,0,2
OrbitzWorldwide_consul-client.com.orbitz.consul.cache.HealthCheckCache,1,0,0,1,0,0,0,0,2
OrbitzWorldwide_consul-client.com.orbitz.consul.cache.ConsulCache,3,0,0,3,0,0,0,0,6
OrbitzWorldwide_consul-client.com.orbitz.consul.cache.KVCache,0,0,0,0,0,0,0,0,0
OrbitzWorldwide_consul-client.com.orbitz.consul.util.LeaderElectionUtil,1,0,0,1,0,0,0,0,2
OrbitzWorldwide_consul-client.com.orbitz.consul.util.TrustManagerUtils,0,0,0,0,0,0,0,0,0
OrbitzWorldwide_consul-client.com.orbitz.consul.model.event.ImmutableEvent,0,0,0,0,0,0,0,0,0
OrbitzWorldwide_consul-client.com.orbitz.consul.config.CacheConfig,4,1,0,4,0,1,0,0,10
OrbitzWorldwide_consul-client.com.orbitz.consul.util.failover.strategy.BlacklistingConsulFailoverStrategy,3,0,0,2,0,0,0,0,5
OrbitzWorldwide_consul-client.com.orbitz.consul.model.catalog.ImmutableTaggedAddresses,0,0,0,0,0,0,0,2,2
OrbitzWorldwide_consul-client.com.orbitz.consul.model.agent.Check,1,0,0,1,0,0,0,0,2
OrbitzWorldwide_consul-client.com.orbitz.consul.model.query.ImmutableFailover,0,0,0,0,0,0,0,3,3
OrbitzWorldwide_consul-client.com.orbitz.consul.option.ConsistencyMode,2,0,0,2,0,0,0,0,4
sonyxperiadev_gerrit-events.com.sonymobile.tools.gerrit.gerritevents.GerritConnection,1,0,0,1,0,0,0,0,2
sonyxperiadev_gerrit-events.com.sonymobile.tools.gerrit.gerritevents.GerritHandler,6,0,0,2,0,0,0,5,13
sonyxperiadev_gerrit-events.com.sonymobile.tools.gerrit.gerritevents.ssh.SshConnectionFactory,0,0,0,0,0,0,0,2,2
sonyxperiadev_gerrit-events.com.sonymobile.tools.gerrit.gerritevents.ssh.SshUtil,4,0,0,0,0,0,0,0,4
sonyxperiadev_gerrit-events.com.sonymobile.tools.gerrit.gerritevents.dto.rest.ChangeId,0,0,0,0,0,0,0,0,0
sonyxperiadev_gerrit-events.com.sonymobile.tools.gerrit.gerritevents.dto.attr.Change,6,0,0,6,0,0,0,0,12
sonyxperiadev_gerrit-events.com.sonymobile.tools.gerrit.gerritevents.dto.attr.Account,1,0,0,1,0,0,0,0,2
sonyxperiadev_gerrit-events.com.sonymobile.tools.gerrit.gerritevents.dto.attr.RefUpdate,3,0,0,3,0,0,0,0,6
sonyxperiadev_gerrit-events.com.sonymobile.tools.gerrit.gerritevents.dto.events.GerritTriggeredEvent,1,0,0,1,0,0,0,0,2
sonyxperiadev_gerrit-events.com.sonymobile.tools.gerrit.gerritevents.dto.attr.Approval,1,0,0,1,0,0,0,0,2
sonyxperiadev_gerrit-events.com.sonymobile.tools.gerrit.gerritevents.dto.attr.PatchSet,4,0,0,4,0,0,0,0,8
sonyxperiadev_gerrit-events.com.sonymobile.tools.gerrit.gerritevents.GerritJsonEventFactory,0,0,0,0,0,0,0,0,0
sonyxperiadev_gerrit-events.com.sonymobile.tools.gerrit.gerritevents.dto.events.RefReplicationDone,9,0,0,9,0,0,0,0,18
sonyxperiadev_gerrit-events.com.sonymobile.tools.gerrit.gerritevents.dto.events.VoteDeleted,1,0,0,1,0,0,0,0,2
sonyxperiadev_gerrit-events.com.sonymobile.tools.gerrit.gerritevents.dto.events.HashtagsChanged,1,0,0,1,0,0,0,0,2
sonyxperiadev_gerrit-events.com.sonymobile.tools.gerrit.gerritevents.dto.events.RefReplicated,11,0,0,11,0,0,0,0,22
sonyxperiadev_gerrit-events.com.sonymobile.tools.gerrit.gerritevents.watchdog.WatchTimeExceptionData,0,0,0,0,0,0,0,0,0
sonyxperiadev_gerrit-events.com.sonymobile.tools.gerrit.gerritevents.workers.rest.AbstractRestCommandJob2,1,0,0,1,0,0,0,0,2
sonyxperiadev_gerrit-events.com.sonymobile.tools.gerrit.gerritevents.workers.rest.AbstractRestCommandJob,1,0,0,1,0,0,0,0,2
sonyxperiadev_gerrit-events.com.sonymobile.tools.gerrit.gerritevents.workers.cmd.AbstractSendCommandJob,3,0,0,3,0,0,0,0,6
sonyxperiadev_gerrit-events.com.sonymobile.tools.gerrit.gerritevents.workers.cmd.AbstractSendCommandJob2,0,0,0,0,0,0,0,0,0
sonyxperiadev_gerrit-events.com.sonymobile.tools.gerrit.gerritevents.workers.GerritEventWork,0,0,0,0,0,0,0,0,0
sonyxperiadev_gerrit-events.com.sonymobile.tools.gerrit.gerritevents.workers.StreamEventsStringWork,1,0,0,1,0,0,0,0,2
mybatis_ibatis-2.com.ibatis.common.resources.Resources,7,0,0,3,0,6,0,0,16
mybatis_ibatis-2.com.ibatis.common.util.PaginatedArrayList,3,0,0,3,0,0,0,0,6
mybatis_ibatis-2.com.ibatis.common.beans.ProbeFactory,5,0,0,5,0,1,0,0,11
mybatis_ibatis-2.com.ibatis.common.beans.ClassInfo,5,0,0,3,0,2,0,0,10
mybatis_ibatis-2.com.ibatis.common.beans.Probe,5,0,0,1,0,0,0,0,6
mybatis_ibatis-2.com.ibatis.sqlmap.engine.accessplan.AccessPlanFactory,0,0,0,0,0,0,0,1,1
mybatis_ibatis-2.com.ibatis.common.xml.NodeletUtils,3,0,0,0,0,0,0,0,3
mybatis_ibatis-2.com.ibatis.sqlmap.engine.mapping.result.loader.EnhancedLazyResultLoader,0,0,0,0,0,0,0,1,1
mybatis_ibatis-2.com.ibatis.sqlmap.engine.mapping.parameter.InlineParameterMapParser,1,0,0,1,0,1,0,0,3
mybatis_ibatis-2.com.ibatis.sqlmap.engine.cache.CacheKey,3,0,0,3,0,0,0,0,6
mybatis_ibatis-2.com.ibatis.sqlmap.engine.cache.CacheController,4,0,0,4,0,0,0,0,8
mybatis_ibatis-2.com.ibatis.sqlmap.engine.execution.BatchResult,1,0,0,0,0,1,0,0,2
mybatis_ibatis-2.com.ibatis.sqlmap.engine.execution.BatchException,1,0,0,1,0,1,0,0,3
mybatis_ibatis-2.com.ibatis.sqlmap.engine.transaction.TransactionConfig,1,0,0,1,0,0,0,0,2
mybatis_ibatis-2.com.ibatis.common.util.PaginatedList,2,0,0,2,0,2,0,0,6
nhl_link-rest.io.agrest.converter.jsonvalue.UtcDateConverter,0,0,0,0,0,0,0,2,2
nhl_link-rest.io.agrest.encoder.DateTimeFormatters,0,0,0,0,0,0,0,1,1
nhl_link-rest.io.agrest.protocol.Exp,4,0,0,1,0,0,0,0,5
nhl_link-rest.io.agrest.id.AgObjectId,2,0,0,0,0,0,0,0,2
nhl_link-rest.io.agrest.cayenne.exp.CayenneExpParser,1,0,0,1,0,0,0,0,2
nhl_link-rest.io.agrest.cayenne.path.PathOps,0,0,0,0,0,0,0,0,0
nhl_link-rest.io.agrest.cayenne.path.EntityPathCache,4,0,0,4,0,0,0,0,8
nhl_link-rest.io.agrest.access.PropertyFilteringRulesBuilder,0,0,0,0,0,0,0,6,6
nhl_link-rest.io.agrest.SimpleResponse,1,0,0,1,0,0,0,0,2
nhl_link-rest.io.agrest.AgException,7,0,0,1,0,0,0,0,8
nhl_link-rest.io.agrest.DataResponse,1,0,0,1,0,0,0,0,2
nhl_link-rest.io.agrest.meta.AgEntity,4,0,0,3,0,0,0,0,7
nhl_link-rest.io.agrest.compiler.AnnotationsAgEntityBuilder,3,0,0,3,0,0,0,0,6
nhl_link-rest.io.agrest.id.MultiValueId,3,0,0,0,0,0,0,0,3
nhl_link-rest.io.agrest.access.ReadFilter,2,0,0,2,0,0,0,0,4
nhl_link-rest.io.agrest.converter.jsonvalue.JsonValueConverters,2,0,0,1,0,0,0,0,3
nhl_link-rest.io.agrest.converter.jsonvalue.JsonValueConverter,1,0,0,0,0,0,0,1,2
nhl_link-rest.io.agrest.converter.jsonvalue.Base64Converter,1,0,0,0,0,0,0,0,1
nhl_link-rest.io.agrest.converter.jsonvalue.ISOLocalDateTimeConverter,1,0,0,1,0,0,0,0,2
nhl_link-rest.io.agrest.converter.jsonvalue.AbstractConverter,1,0,0,0,0,0,0,0,1
nhl_link-rest.io.agrest.converter.jsonvalue.ISOLocalDateConverter,1,0,0,1,0,0,0,0,2
nhl_link-rest.io.agrest.converter.jsonvalue.Normalizer,4,0,0,0,0,0,0,0,4
nhl_link-rest.io.agrest.converter.jsonvalue.ISOLocalTimeConverter,1,0,0,1,0,0,0,0,2
nhl_link-rest.io.agrest.converter.valuestring.ValueStringConverter,0,0,0,0,0,0,0,0,0
nhl_link-rest.io.agrest.runtime.AgExceptionMappers,3,0,0,1,0,0,0,2,6
nhl_link-rest.io.agrest.runtime.AgRuntimeBuilder,6,0,0,6,0,0,0,2,14
nhl_link-rest.io.agrest.runtime.jackson.JacksonService,1,0,0,1,0,1,0,0,3
nhl_link-rest.io.agrest.runtime.entity.SortMerger,2,0,0,2,0,0,0,0,4
nhl_link-rest.io.agrest.runtime.protocol.SortParser,7,0,0,7,0,0,0,0,14
nhl_link-rest.io.agrest.runtime.protocol.ExpParser,8,0,0,8,0,0,0,0,16
nhl_link-rest.io.agrest.runtime.entity.ExpMerger,0,0,0,0,0,0,0,0,0
nhl_link-rest.io.agrest.runtime.request.IAgRequestBuilderFactory,15,0,0,15,0,0,0,0,30
nhl_link-rest.io.agrest.ResourceEntity,2,0,0,2,0,0,0,0,4
nhl_link-rest.io.agrest.SizeConstraints,2,0,0,2,0,0,0,0,4
nhl_link-rest.io.agrest.runtime.request.DefaultRequestBuilder,13,0,0,13,0,0,0,0,26
nhl_link-rest.io.agrest.AgRequestBuilder,2,0,0,2,0,0,0,0,4
nhl_link-rest.io.agrest.runtime.entity.IncludeMerger,5,0,0,5,0,0,0,0,10
nhl_link-rest.io.agrest.reflect.BeanAnalyzer,1,0,0,0,0,0,0,0,1
nhl_link-rest.io.agrest.jaxrs2.AgJaxrsFeatureBuilder,0,0,0,0,0,0,0,2,2
nhl_link-rest.io.agrest.jaxrs2.AgJaxrsFeature,0,0,0,0,0,0,0,2,2
nhl_link-rest.io.agrest.jaxrs3.AgJaxrsFeatureBuilder,0,0,0,0,0,0,0,2,2
nhl_link-rest.io.agrest.jaxrs3.AgJaxrsFeature,0,0,0,0,0,0,0,2,2
OAuth-Apis_apis.org.surfnet.oaaas.auth.principal.AuthenticatedPrincipal,3,0,0,2,0,0,0,0,5
OAuth-Apis_apis.org.surfnet.oaaas.auth.AuthorizationServerFilter,1,0,0,0,0,0,0,0,1
OAuth-Apis_apis.org.surfnet.oaaas.model.AuthorizationRequest,0,0,0,0,0,0,0,9,9
OAuth-Apis_apis.org.surfnet.oaaas.model.Client,3,0,0,2,0,0,0,1,6
OAuth-Apis_apis.org.surfnet.oaaas.auth.OAuth2ValidatorImpl,1,0,0,1,0,1,0,1,4
OAuth-Apis_apis.org.surfnet.oaaas.auth.LocalResourceOwnerAuthenticator,1,0,0,1,0,0,0,0,2
OAuth-Apis_apis.org.surfnet.oaaas.auth.principal.BasicAuthCredentials,1,0,0,1,0,0,0,0,2
OAuth-Apis_apis.org.surfnet.oaaas.model.TokenResponseCache,3,0,0,3,0,0,0,0,6
OAuth-Apis_apis.org.surfnet.oaaas.model.AccessToken,1,0,0,0,0,0,0,0,1
OAuth-Apis_apis.org.surfnet.oaaas.model.ResourceServer,7,0,0,4,0,0,0,0,11
OAuth-Apis_apis.org.surfnet.oaaas.model.ResourceOwner,1,0,0,0,0,0,0,0,1
OAuth-Apis_apis.org.surfnet.oaaas.resource.VerifyResource,1,0,0,0,0,0,0,0,1
OAuth-Apis_apis.org.surfnet.oaaas.conext.SAMLAuthenticatedPrincipal,1,0,0,1,0,0,0,0,2
OAuth-Apis_apis.org.surfnet.oaaas.repository.AccessTokenRepository,0,0,0,0,0,0,0,0,0
OAuth-Apis_apis.org.surfnet.oaaas.repository.AuthorizationRequestRepository,0,0,0,0,0,0,0,0,0
OAuth-Apis_apis.org.surfnet.oaaas.repository.ResourceOwnerRepository,1,0,0,0,0,0,0,0,1
OAuth-Apis_apis.org.surfnet.oaaas.repository.ResourceServerRepository,1,0,0,1,0,0,0,0,2
OAuth-Apis_apis.org.surfnet.oaaas.repository.ClientRepository,0,0,0,0,0,0,0,0,0
OAuth-Apis_apis.org.surfnet.oaaas.resource.TokenResource,1,0,0,1,0,0,0,0,2
OAuth-Apis_apis.org.surfnet.oaaas.resource.resourceserver.AccessTokenResource,1,0,0,0,0,0,0,0,1
OAuth-Apis_apis.org.surfnet.oaaas.resource.resourceserver.ResourceServerResource,1,0,0,1,0,0,0,0,2
OAuth-Apis_apis.org.surfnet.oaaas.resource.resourceserver.ResourceOwnerResource,1,0,0,0,0,0,0,0,1
OAuth-Apis_apis.org.surfnet.oaaas.resource.resourceserver.ClientResource,2,0,0,1,0,0,0,0,3
OAuth-Apis_apis.org.surfnet.oaaas.model.AccessTokenResponse,3,0,0,3,0,0,0,0,6
OAuth-Apis_apis.org.surfnet.oaaas.model.AbstractEntity,4,0,0,1,0,0,0,0,5
OAuth-Apis_apis.org.surfnet.oaaas.model.StatisticsResponse,1,0,0,0,0,0,0,0,1
OAuth-Apis_apis.org.surfnet.oaaas.jetty.SelectChannelConnectorHttps,0,0,0,0,0,0,0,0,0
google_closure-stylesheets.com.google.common.css.SubstitutionMap,6,0,0,0,0,0,0,0,6
google_closure-stylesheets.com.google.common.css.MinimalSubstitutionMap,6,0,0,0,0,0,0,0,6
google_closure-stylesheets.com.google.common.css.SourceCodeLocation,30,0,0,16,0,2,4,0,52
google_closure-stylesheets.com.google.common.css.RecordingSubstitutionMap,6,0,0,4,0,2,0,0,12
google_closure-stylesheets.com.google.common.css.IdentitySubstitutionMap,2,0,0,0,0,0,0,0,2
google_closure-stylesheets.com.google.common.css.JobDescriptionBuilder,18,0,0,16,0,0,0,0,34
google_closure-stylesheets.com.google.common.css.SubstitutionMapProvider,8,0,0,6,0,0,0,0,14
google_closure-stylesheets.com.google.common.css.compiler.commandline.ClosureCommandLineCompiler,0,0,0,0,0,0,0,0,0
google_closure-stylesheets.com.google.common.css.compiler.ast.CssStringNode,10,0,0,4,0,0,0,0,14
google_closure-stylesheets.com.google.common.css.compiler.ast.CssDeclarationNode,6,0,0,6,0,0,0,6,18
google_closure-stylesheets.com.google.common.css.compiler.ast.DefaultVisitController,24,0,0,20,0,0,0,14,58
google_closure-stylesheets.com.google.common.css.compiler.ast.VisitController,2,0,0,2,0,0,0,0,4
google_closure-stylesheets.com.google.common.css.compiler.ast.CssValueNode,42,0,0,40,0,0,0,0,82
google_closure-stylesheets.com.google.common.css.compiler.ast.CssNode,14,0,0,14,0,0,0,0,28
google_closure-stylesheets.com.google.common.css.compiler.ast.CssNodesListNode,30,0,0,30,0,0,0,0,60
google_closure-stylesheets.com.google.common.css.compiler.ast.CssAtRuleNode,0,0,0,0,0,0,0,0,0
google_closure-stylesheets.com.google.common.css.compiler.ast.CssRulesetNode,4,0,0,4,0,0,0,0,8
google_closure-stylesheets.com.google.common.css.compiler.ast.CssCustomFunctionNode,4,0,0,4,0,0,0,0,8
google_closure-stylesheets.com.google.common.css.compiler.ast.CssPropertyNode,18,0,0,16,0,0,0,0,34
google_closure-stylesheets.com.google.common.css.compiler.ast.Property,8,0,0,8,0,0,0,0,16
google_closure-stylesheets.com.google.common.css.compiler.ast.CssFunctionNode,8,0,0,8,0,0,0,0,16
google_closure-stylesheets.com.google.common.css.compiler.ast.CssAbstractBlockNode,0,0,0,0,0,4,0,0,4
google_closure-stylesheets.com.google.common.css.compiler.ast.CssTree,10,0,0,8,0,0,0,0,18
google_closure-stylesheets.com.google.common.css.compiler.ast.CssSelectorNode,2,0,0,2,0,0,0,0,4
google_closure-stylesheets.com.google.common.css.compiler.ast.StringCharStream,4,0,0,4,0,0,0,2,10
google_closure-stylesheets.com.google.common.css.compiler.ast.CssDefinitionNode,4,0,0,4,0,0,0,0,8
google_closure-stylesheets.com.google.common.css.compiler.ast.GssParser,2,2,0,2,0,0,0,0,6
google_closure-stylesheets.com.google.common.css.compiler.ast.CssPseudoClassNode,8,0,0,8,0,0,0,0,16
google_closure-stylesheets.com.google.common.css.compiler.ast.CssCompositeValueNode,2,0,0,2,0,0,0,0,4
google_closure-stylesheets.com.google.common.css.compiler.passes.ConstantDefinitions,4,0,0,4,0,0,0,0,8
google_closure-stylesheets.com.google.common.css.compiler.passes.MapChunkAwareNodesToChunk,0,0,0,0,0,0,0,0,0
google_closure-stylesheets.com.google.common.css.compiler.ast.CssTreeVisitor,0,0,0,0,0,0,0,4,4
google_closure-stylesheets.com.google.common.css.compiler.passes.ColorValueOptimizer,8,0,0,0,0,0,0,2,10
google_closure-stylesheets.com.google.common.css.compiler.passes.MergeAdjacentRulesetNodesWithSameDeclarations,6,0,0,6,0,0,0,2,14
google_closure-stylesheets.com.google.common.css.compiler.ast.CssMixinDefinitionNode,2,0,0,2,0,0,0,0,4
google_closure-stylesheets.com.google.common.css.compiler.passes.EliminateEmptyRulesetNodes,0,0,0,0,0,0,0,6,6
google_closure-stylesheets.com.google.common.css.compiler.passes.CheckDependencyNodes,0,0,0,0,0,0,0,0,0
google_closure-stylesheets.com.google.common.css.compiler.passes.EliminateUselessRulesetNodes,0,0,0,0,0,0,0,4,4
google_closure-stylesheets.com.google.common.css.compiler.passes.MarkRemovableRulesetNodes,0,0,0,0,0,0,0,2,2
google_closure-stylesheets.com.google.common.css.compiler.passes.MergeAdjacentRulesetNodesWithSameSelector,6,0,0,6,0,0,0,2,14
google_closure-stylesheets.com.google.common.css.compiler.passes.CreateConditionalNodes,4,2,0,4,0,0,0,0,10
google_closure-stylesheets.com.google.common.css.compiler.passes.CreateStandardAtRuleNodes,2,0,0,2,0,0,0,0,4
google_closure-stylesheets.com.google.common.css.compiler.passes.HasConditionalNodes,0,0,0,0,0,0,0,2,2
google_closure-stylesheets.com.google.common.css.compiler.passes.CssClassRenaming,0,0,0,0,0,0,0,8,8
google_closure-stylesheets.com.google.common.css.compiler.passes.AbbreviatePositionalValues,8,0,0,2,0,0,0,0,10
google_closure-stylesheets.com.google.common.css.compiler.passes.RemoveDefaultDeclarations,0,0,0,0,0,0,0,18,18
google_closure-stylesheets.com.google.common.css.compiler.passes.BiDiFlipper,0,0,0,0,0,0,0,4,4
google_closure-stylesheets.com.google.common.css.compiler.passes.ReplaceConstantReferences,2,0,0,2,0,0,0,8,12
google_closure-stylesheets.com.google.common.css.compiler.passes.LocationBoundingVisitor,2,0,0,2,0,0,0,0,4
google_closure-stylesheets.com.google.common.css.compiler.passes.SplitRulesetNodes,2,0,0,2,0,0,0,4,8
google_closure-stylesheets.com.google.common.css.compiler.passes.LoopVariableReplacementPass,0,0,0,0,0,0,0,14,14
google_closure-stylesheets.com.google.common.css.compiler.passes.CodeBuffer,30,0,0,30,0,0,0,0,60
google_closure-stylesheets.com.google.common.css.compiler.passes.CreateDefinitionNodes,0,0,0,0,0,0,0,0,0
google_closure-stylesheets.com.google.common.css.compiler.passes.SExprPrinter,0,0,0,0,0,0,0,0,0
google_closure-stylesheets.com.google.common.css.compiler.passes.CompactPrinter,0,0,0,0,0,0,0,0,0
google_closure-stylesheets.com.google.common.css.compiler.ast.CssForLoopRuleNode,4,0,0,4,0,0,0,0,8
google_closure-stylesheets.com.google.common.css.compiler.passes.EliminateUnitsFromZeroNumericValues,18,0,0,18,0,0,0,2,38
google_closure-stylesheets.com.google.common.css.compiler.passes.BooleanExpressionEvaluator,22,0,0,22,0,0,0,0,44
unitsofmeasurement_unit-api.javax.measure.spi.ServiceProvider,5,0,0,1,0,0,0,0,6
unitsofmeasurement_unit-api.javax.measure.spi.FormatService,0,0,0,0,0,0,0,0,0
unitsofmeasurement_unit-api.javax.measure.Quantity,14,2,0,14,0,0,0,0,30
unitsofmeasurement_unit-api.javax.measure.Unit,9,0,0,8,0,0,0,0,17
unitsofmeasurement_unit-api.javax.measure.UnitConverter,0,0,0,0,0,0,0,0,0
unitsofmeasurement_unit-api.javax.measure.Dimension,1,0,0,0,0,0,0,0,1
unitsofmeasurement_unit-api.javax.measure.format.QuantityFormat,1,0,0,1,0,0,0,0,2
unitsofmeasurement_unit-api.javax.measure.format.MeasurementParseException,4,0,0,4,0,4,0,0,12
unitsofmeasurement_unit-api.javax.measure.format.UnitFormat,0,0,0,0,0,0,0,0,0
hal_circuit.org.jboss.gwt.circuit.Dispatcher,18,0,0,0,0,0,0,0,18
hal_circuit.org.jboss.gwt.circuit.dag.BoundedQueue,2,0,0,2,0,0,0,0,4
gwizard_gwizard.org.gwizard.swagger.SwaggerServletContextListener,1,0,0,0,0,0,0,0,1
primecloud-controller-org_primecloud-controller.jp.primecloud.auto.common.component.PasswordGenerator,2,0,0,0,0,0,0,0,2
primecloud-controller-org_primecloud-controller.jp.primecloud.auto.common.component.FreeMarkerGenerator,0,0,0,0,0,0,0,1,1
primecloud-controller-org_primecloud-controller.jp.primecloud.auto.util.CommandUtils,1,0,0,0,0,1,2,0,4
primecloud-controller-org_primecloud-controller.jp.primecloud.auto.util.JSchUtils,3,0,0,3,0,0,4,1,11
primecloud-controller-org_primecloud-controller.jp.primecloud.auto.util.IpAddressUtils,4,0,0,2,0,0,0,0,6
marschall_threeten-jpa.com.github.marschall.threeten.jpa.LocalTimeConverter,1,0,0,0,0,0,0,0,1
marschall_threeten-jpa.com.github.marschall.threeten.jpa.LocalDateTimeConverter,1,0,0,0,0,0,0,0,1
marschall_threeten-jpa.com.github.marschall.threeten.jpa.mssql.impl.DateTimeOffsetConverter,3,0,0,3,0,0,0,0,6
marschall_threeten-jpa.com.github.marschall.threeten.jpa.oracle.impl.IntervalConverter,4,0,0,4,0,0,0,0,8
marschall_threeten-jpa.com.github.marschall.threeten.jpa.oracle.impl.UuidConverter,0,0,0,0,0,0,0,0,0
marschall_threeten-jpa.com.github.marschall.threeten.jpa.oracle.impl.TimestamptzConverter,1,0,0,0,0,0,0,0,1
oswetto_Loboevolution.org.loboevolution.driver.LoboUnitTest,46,0,0,43,0,6,0,1005,1100
oswetto_Loboevolution.org.loboevolution.html.node.Document,62,0,0,59,0,14,0,1,136
oswetto_Loboevolution.org.loboevolution.html.node.Node,4,0,0,4,0,0,0,1,9
oswetto_Loboevolution.org.loboevolution.http.UserAgentContext,1,0,0,0,0,1,0,0,2
oswetto_Loboevolution.org.loboevolution.html.node.ParentNode,1,0,0,0,0,1,0,0,2
oswetto_Loboevolution.org.loboevolution.html.dom.HTMLCollection,5,0,0,5,0,1,0,0,11
oswetto_Loboevolution.org.loboevolution.html.node.css.StyleSheetList,1,0,0,1,0,0,0,0,2
oswetto_Loboevolution.org.loboevolution.html.dom.domimpl.DocumentImpl,2,0,0,2,0,0,0,0,4
oswetto_Loboevolution.org.loboevolution.html.dom.domimpl.DOMImplementationImpl,34,0,0,31,0,17,0,0,82
cglib_cglib.net.sf.cglib.samples.Trace,0,0,0,0,0,0,0,1,1
cglib_cglib.net.sf.cglib.reflect.FastClass,1,0,0,1,0,0,0,0,2
cglib_cglib.net.sf.cglib.core.AsmApi,0,0,0,0,0,0,0,0,0
fluo-io_fluo.org.apache.fluo.api.client.AbstractTransactionBase,22,0,0,22,0,0,0,0,44
fluo-io_fluo.org.apache.fluo.mapreduce.FluoMutationGenerator,1,0,0,1,0,0,0,0,2
fluo-io_fluo.org.apache.fluo.command.AppCommand,1,0,0,1,0,0,0,0,2
fluo-io_fluo.org.apache.fluo.command.CommandUtil,1,0,0,1,0,0,0,0,2
fluo-io_fluo.org.apache.fluo.command.FluoProgram,0,0,0,0,0,0,0,0,0
fluo-io_fluo.org.apache.fluo.command.ConfigCommand,2,0,0,2,0,0,0,0,4
fluo-io_fluo.org.apache.fluo.api.data.Span,8,0,0,7,0,0,0,0,15
fluo-io_fluo.org.apache.fluo.accumulo.iterators.TimestampSkippingIterator,1,0,0,1,0,0,0,0,2
fluo-io_fluo.org.apache.fluo.accumulo.util.ZookeeperUtil,2,0,0,2,0,0,0,0,4
fluo-io_fluo.org.apache.fluo.accumulo.util.LongUtil,1,0,0,1,0,0,0,0,2
fluo-io_fluo.org.apache.fluo.api.data.Column,6,0,0,5,0,0,0,0,11
fluo-io_fluo.org.apache.fluo.core.util.SpanUtil,2,0,0,0,0,0,0,0,2
fluo-io_fluo.org.apache.fluo.core.util.ByteUtil,2,0,0,2,0,0,0,0,4
fluo-io_fluo.org.apache.fluo.accumulo.util.ByteArrayUtil,1,0,0,1,0,0,0,0,2
fluo-io_fluo.org.apache.fluo.core.util.ColumnUtil,0,0,0,0,0,0,0,0,0
fluo-io_fluo.org.apache.fluo.core.impl.FluoConfigurationImpl,1,0,0,0,0,0,0,0,1
fluo-io_fluo.org.apache.fluo.core.worker.finder.hash.TableRange,3,0,0,1,0,0,0,0,4
fluo-io_fluo.org.apache.fluo.core.worker.finder.hash.PartitionManager,1,1,0,1,0,0,0,0,3
fluo-io_fluo.org.apache.fluo.core.worker.finder.hash.SerializedSplits,1,0,0,1,0,0,0,0,2
fluo-io_fluo.org.apache.fluo.core.observer.ObserverStore,1,0,0,1,0,0,0,0,2
fluo-io_fluo.org.apache.fluo.api.client.FluoClient,26,2,0,24,0,2,0,0,54
fluo-io_fluo.org.apache.fluo.api.config.FluoConfiguration,16,0,0,16,0,0,0,0,32
fluo-io_fluo.org.apache.fluo.api.client.FluoFactory,4,0,0,3,0,1,0,0,8
fluo-io_fluo.org.apache.fluo.core.impl.Environment,1,0,0,1,0,0,0,0,2
fluo-io_fluo.org.apache.fluo.core.impl.TransactorCache,1,0,0,1,0,0,0,0,2
fluo-io_fluo.org.apache.fluo.core.impl.TransactorID,2,0,0,2,0,0,0,0,4
fluo-io_fluo.org.apache.fluo.api.mini.MiniFluo,1,0,0,1,0,0,0,0,2
fluo-io_fluo.org.apache.fluo.core.observer.RegisteredObservers,0,0,0,0,0,1,0,0,1
fluo-io_fluo.org.apache.fluo.core.worker.NotificationFinder,1,0,0,1,0,0,0,0,2
fluo-io_fluo.org.apache.fluo.api.client.AbstractSnapshotBase,3,0,0,1,0,0,0,0,4
fluo-io_fluo.org.apache.fluo.integration.TestTransaction,1,0,0,1,0,0,0,0,2
fluo-io_fluo.org.apache.fluo.core.impl.TimestampTracker,1,0,0,1,0,0,0,0,2
fluo-io_fluo.org.apache.fluo.core.oracle.Stamp,2,0,0,2,0,0,0,0,4
fluo-io_fluo.org.apache.fluo.core.impl.SharedResources,2,0,0,2,0,0,0,0,4
fluo-io_fluo.org.apache.fluo.core.util.HostUtil,0,0,0,0,0,0,0,0,0
fluo-io_fluo.org.apache.fluo.core.util.PortUtils,2,0,0,2,0,0,0,0,4
fluo-io_fluo.org.apache.fluo.api.client.TransactionBase,0,0,0,0,0,0,0,3,3
fluo-io_fluo.org.apache.fluo.api.client.SnapshotBase,0,0,0,0,0,0,0,1,1
fluo-io_fluo.org.apache.fluo.api.data.ColumnValue,3,0,0,1,0,0,0,0,4
fluo-io_fluo.org.apache.fluo.api.data.RowColumnValue,3,0,0,1,0,0,0,0,4
fluo-io_fluo.org.apache.fluo.api.data.Bytes,18,0,0,11,0,2,0,0,31
fluo-io_fluo.org.apache.fluo.api.data.RowColumn,3,0,0,2,0,0,0,0,5
fluo-io_fluo.org.apache.fluo.api.config.SimpleConfiguration,1,0,0,1,0,0,0,0,2
fluo-io_fluo.org.apache.fluo.api.client.scanner.RowScanner,0,0,0,0,0,0,0,0,0
fluo-io_fluo.org.apache.fluo.core.oracle.OracleServer,3,0,0,2,0,0,0,0,5
fluo-io_fluo.org.apache.fluo.api.client.FluoAdmin,1,0,0,1,0,0,0,0,2
fluo-io_fluo.org.apache.fluo.core.client.FluoAdminImpl,3,0,0,3,0,0,0,0,6
fluo-io_fluo.org.apache.fluo.core.util.CuratorUtil,0,0,0,0,0,0,0,0,0
serenity-bdd_serenity-core.net.serenitybdd.screenplay.Actor,13,0,0,4,0,0,0,61,78
serenity-bdd_serenity-core.net.serenitybdd.screenplay.GivenWhenThen,0,0,0,0,0,0,0,45,45
serenity-bdd_serenity-core.net.thucydides.core.util.EnvironmentVariables,17,0,0,14,0,3,0,14,48
serenity-bdd_serenity-core.net.serenitybdd.core.webdriver.driverproviders.AddCustomDriverCapabilities,0,0,0,0,0,0,0,0,0
serenity-bdd_serenity-core.net.thucydides.junit.internals.MethodInvoker,0,0,0,0,0,0,0,0,0
serenity-bdd_serenity-core.net.thucydides.junit.listeners.JUnitStepListener,5,0,0,5,0,0,0,0,10
serenity-bdd_serenity-core.net.serenitybdd.junit.runners.SerenityRunner,20,0,0,16,0,3,1,3,43
serenity-bdd_serenity-core.net.thucydides.core.annotations.TestCaseAnnotations,0,0,0,0,0,0,0,0,0
serenity-bdd_serenity-core.net.serenitybdd.junit.runners.DataDrivenAnnotations,8,0,0,4,0,0,0,0,12
serenity-bdd_serenity-core.net.serenitybdd.junit.runners.QualifierFinder,0,0,0,0,0,0,0,0,0
serenity-bdd_serenity-core.net.thucydides.core.adapters.TestStrategyAdapter,4,0,0,4,0,0,0,0,8
serenity-bdd_serenity-core.net.serenitybdd.junit.runners.ParameterizedRunnerScheduler,1,0,0,1,0,0,0,0,2
serenity-bdd_serenity-core.net.serenitybdd.junit.runners.SerenityParameterizedRunner,11,0,0,10,0,0,0,0,21
serenity-bdd_serenity-core.net.serenitybdd.core.steps.ScenarioActor,0,0,0,0,0,0,0,0,0
serenity-bdd_serenity-core.net.thucydides.core.steps.ExampleTables,0,0,0,0,0,0,0,1,1
serenity-bdd_serenity-core.net.thucydides.core.steps.stepdata.StepData,0,0,0,0,0,0,0,10,10
serenity-bdd_serenity-core.net.thucydides.core.pages.Pages,0,0,0,0,0,0,0,4,4
serenity-bdd_serenity-core.net.thucydides.core.environment.MockEnvironmentVariables,23,0,0,16,0,0,0,1,40
serenity-bdd_serenity-core.net.serenitybdd.maven.plugins.MavenProjectHelper,0,0,0,0,0,0,0,0,0
serenity-bdd_serenity-core.net.serenitybdd.maven.plugins.SerenityAggregatorMojo,0,0,0,0,0,0,0,2,2
serenity-bdd_serenity-core.net.serenitybdd.maven.plugins.SerenityAdaptorMojo,0,0,0,0,0,0,0,0,0
serenity-bdd_serenity-core.net.serenitybdd.screenplay.rest.interactions.Get,0,0,0,0,0,0,0,3,3
serenity-bdd_serenity-core.net.serenitybdd.screenplay.rest.interactions.RestInteraction,0,0,0,0,0,0,0,4,4
serenity-bdd_serenity-core.net.serenitybdd.screenplay.rest.interactions.Delete,0,0,0,0,0,0,0,1,1
serenity-bdd_serenity-core.net.serenitybdd.rest.filters.BlacklistFilter,0,0,0,0,0,0,0,0,0
serenity-bdd_serenity-core.net.serenitybdd.rest.SerenityRest,1,0,0,1,0,0,0,0,2
serenity-bdd_serenity-core.net.serenitybdd.screenplay.abilities.BrowseTheWeb,4,0,0,2,0,0,0,20,26
serenity-bdd_serenity-core.net.serenitybdd.core.pages.PageObject,6,0,0,1,0,0,0,59,66
serenity-bdd_serenity-core.net.serenitybdd.screenplay.actions.Open,0,0,0,0,0,0,0,2,2
serenity-bdd_serenity-core.net.serenitybdd.screenplay.targets.TargetBuilder,0,0,0,0,0,0,0,0,0
serenity-bdd_serenity-core.net.serenitybdd.screenplay.questions.TextValue,0,0,0,0,0,0,0,0,0
serenity-bdd_serenity-core.net.serenitybdd.screenplay.questions.Displayed,0,0,0,0,0,0,0,0,0
serenity-bdd_serenity-core.net.serenitybdd.screenplay.questions.SelectedValue,2,0,0,2,0,0,0,0,4
serenity-bdd_serenity-core.net.serenitybdd.screenplay.questions.CurrentlyEnabled,0,0,0,0,0,0,0,0,0
serenity-bdd_serenity-core.net.serenitybdd.screenplay.questions.SelectOptionValues,0,0,0,0,0,0,0,0,0
serenity-bdd_serenity-core.net.serenitybdd.screenplay.questions.Presence,0,0,0,0,0,0,0,0,0
serenity-bdd_serenity-core.net.serenitybdd.screenplay.questions.Enabled,0,0,0,0,0,0,0,0,0
serenity-bdd_serenity-core.net.serenitybdd.screenplay.questions.CSSValue,0,0,0,0,0,0,0,0,0
serenity-bdd_serenity-core.net.serenitybdd.screenplay.questions.QuestionForName,0,0,0,0,0,0,0,0,0
serenity-bdd_serenity-core.net.serenitybdd.screenplay.questions.Attribute,0,0,0,0,0,0,0,0,0
serenity-bdd_serenity-core.net.serenitybdd.screenplay.questions.QuestionForNames,0,0,0,0,0,0,0,0,0
serenity-bdd_serenity-core.net.serenitybdd.screenplay.questions.SelectedStatus,3,0,0,0,0,0,0,0,3
serenity-bdd_serenity-core.net.serenitybdd.screenplay.questions.SelectedValues,2,0,0,2,0,0,0,0,4
serenity-bdd_serenity-core.net.serenitybdd.screenplay.questions.CurrentVisibility,0,0,0,0,0,0,0,0,0
serenity-bdd_serenity-core.net.serenitybdd.screenplay.questions.CheckboxValue,0,0,0,0,0,0,0,0,0
serenity-bdd_serenity-core.net.serenitybdd.screenplay.questions.Absence,0,0,0,0,0,0,0,0,0
serenity-bdd_serenity-core.net.serenitybdd.screenplay.questions.Value,3,0,0,0,0,0,0,0,3
serenity-bdd_serenity-core.net.serenitybdd.screenplay.questions.Disabled,0,0,0,0,0,0,0,0,0
serenity-bdd_serenity-core.net.serenitybdd.screenplay.questions.SelectOptions,0,0,0,0,0,0,0,0,0
serenity-bdd_serenity-core.net.serenitybdd.screenplay.questions.Text,5,0,0,0,0,0,0,0,5
serenity-bdd_serenity-core.net.serenitybdd.screenplay.waits.WaitUntil,0,0,0,0,0,0,0,0,0
serenity-bdd_serenity-core.net.serenitybdd.screenplay.matchers.WebElementStateMatchers,0,0,0,0,0,0,0,0,0
serenity-bdd_serenity-core.net.serenitybdd.screenplay.targets.Target,0,0,0,0,0,0,0,0,0
serenity-bdd_serenity-core.net.serenitybdd.screenplay.actions.SetCheckbox,4,0,0,4,0,0,0,0,8
serenity-bdd_serenity-core.net.serenitybdd.screenplay.actions.SetCheckboxInteraction,3,0,0,1,0,0,0,0,4
serenity-bdd_serenity-core.net.serenitybdd.screenplay.actions.ClickInteraction,1,0,0,1,0,0,0,0,2
serenity-bdd_serenity-core.net.serenitybdd.screenplay.actions.SendKeys,2,0,0,2,0,0,0,0,4
serenity-bdd_serenity-core.net.serenitybdd.screenplay.actions.Upload,0,0,0,0,0,0,0,0,0
serenity-bdd_serenity-core.net.serenitybdd.screenplay.actions.JavaScriptClick,2,0,0,2,0,0,0,0,4
serenity-bdd_serenity-core.net.serenitybdd.screenplay.actions.Click,4,0,0,4,0,0,0,0,8
serenity-bdd_serenity-core.net.serenitybdd.screenplay.actions.Clear,2,0,0,2,0,0,0,0,4
serenity-bdd_serenity-core.net.serenitybdd.screenplay.Question,0,0,0,0,0,0,0,0,0
serenity-bdd_serenity-core.net.serenitybdd.screenplay.webtests.actions.LastScriptExecution,0,0,0,0,0,0,0,0,0
serenity-bdd_serenity-core.net.serenitybdd.screenplay.actions.Evaluate,0,0,0,0,0,0,0,0,0
serenity-bdd_serenity-core.net.serenitybdd.screenplay.actions.MoveMouse,3,0,0,3,0,0,0,0,6
serenity-bdd_serenity-core.net.serenitybdd.screenplay.actions.RightClick,2,0,0,2,0,0,0,0,4
serenity-bdd_serenity-core.net.serenitybdd.screenplay.actions.WithDevTools,0,0,0,0,0,0,0,0,0
serenity-bdd_serenity-core.net.serenitybdd.screenplay.actions.DevToolsQuery,0,0,0,0,0,0,0,0,0
serenity-bdd_serenity-core.net.serenitybdd.screenplay.actions.Scroll,0,0,0,0,0,0,0,2,2
serenity-bdd_serenity-core.net.serenitybdd.screenplay.actions.ScrollTo,0,0,0,0,0,0,0,2,2
serenity-bdd_serenity-core.net.serenitybdd.screenplay.actions.Enter,1,0,0,1,0,0,0,0,2
serenity-bdd_serenity-core.net.serenitybdd.screenplay.actions.PerformOn,2,0,0,2,0,0,0,0,4
serenity-bdd_serenity-core.net.serenitybdd.screenplay.actions.DoubleClick,2,0,0,2,0,0,0,0,4
serenity-bdd_serenity-core.net.serenitybdd.screenplay.actions.Switch,6,0,0,6,0,0,0,0,12
serenity-bdd_serenity-core.net.serenitybdd.screenplay.actions.SelectFromOptions,0,0,0,0,0,0,0,0,0
serenity-bdd_serenity-core.net.thucydides.core.issues.IssueTracking,2,0,0,2,0,0,0,0,4
serenity-bdd_serenity-core.net.thucydides.core.reports.html.Formatter,1,0,0,0,0,0,0,0,1
serenity-bdd_serenity-core.net.thucydides.core.model.formatters.ReportFormatter,0,0,0,0,0,0,0,0,0
serenity-bdd_serenity-core.net.thucydides.core.model.NumericalFormatter,0,0,0,0,0,0,0,0,0
serenity-bdd_serenity-core.net.thucydides.core.requirements.reports.RenderMarkdown,0,0,0,0,0,0,0,0,0
serenity-bdd_serenity-core.net.thucydides.core.reports.html.DescriptionSplitter,0,0,0,0,0,0,0,0,0
serenity-bdd_serenity-core.net.thucydides.core.reports.html.screenshots.ScreenshotFormatter,2,0,0,2,0,0,0,0,4
serenity-bdd_serenity-core.net.thucydides.core.model.screenshots.Screenshot,0,0,0,0,0,0,0,0,0
serenity-bdd_serenity-core.net.thucydides.core.model.TestOutcome,28,0,0,28,0,3,0,2,61
serenity-bdd_serenity-core.net.thucydides.core.model.TestTag,2,0,0,2,0,0,0,0,4
serenity-bdd_serenity-core.net.thucydides.core.reports.ReportService,1,0,0,0,0,0,0,2,3
serenity-bdd_serenity-core.net.thucydides.core.reports.html.MarkdownTables,0,0,0,0,0,0,0,0,0
serenity-bdd_serenity-core.net.thucydides.core.reports.ThucydidesReporter,0,0,0,0,0,0,0,0,0
serenity-bdd_serenity-core.net.thucydides.core.matchers.FileMatchers,0,0,0,0,0,0,0,0,0
serenity-bdd_serenity-core.net.thucydides.core.reports.html.ReportNameProvider,1,0,0,1,0,0,0,0,2
serenity-bdd_serenity-core.net.thucydides.core.reports.html.ReportProperties,0,0,0,0,0,0,0,0,0
serenity-bdd_serenity-core.net.thucydides.core.util.TestResources,1,0,0,1,0,1,0,1,4
serenity-bdd_serenity-core.net.thucydides.core.reports.templates.FreeMarkerTemplateManager,0,0,0,0,0,0,0,0,0
serenity-bdd_serenity-core.net.thucydides.core.util.VersionProvider,0,0,0,0,0,0,0,0,0
serenity-bdd_serenity-core.net.thucydides.core.util.TagInflector,0,0,0,0,0,0,0,0,0
serenity-bdd_serenity-core.net.thucydides.core.util.FileSeparatorUtil,0,0,0,0,0,0,0,0,0
serenity-bdd_serenity-core.net.thucydides.core.util.NameConverter,0,0,0,0,0,0,0,0,0
serenity-bdd_serenity-core.net.thucydides.core.util.PropertiesFileLocalPreferences,0,0,0,0,0,0,0,0,0
serenity-bdd_serenity-core.net.thucydides.core.util.PropertiesUtil,0,0,0,0,0,0,0,0,0
serenity-bdd_serenity-core.net.thucydides.core.util.EqualsUtils,1,0,0,0,0,0,0,0,1
serenity-bdd_serenity-core.net.serenitybdd.ant.util.PathProcessor,0,0,0,0,0,0,0,0,0
serenity-bdd_serenity-core.net.serenitybdd.screenplay.playwright.interactions.Open,0,0,0,0,0,0,0,11,11
serenity-bdd_serenity-core.net.serenitybdd.cucumber.util.TagParser,7,0,0,0,0,0,0,0,7
serenity-bdd_serenity-core.net.serenitybdd.cucumber.util.StepDefinitionAnnotationReader,0,0,0,0,0,0,0,0,0
serenity-bdd_serenity-core.net.serenitybdd.cucumber.suiteslicing.TestStatistics,0,0,0,0,0,0,0,0,0
serenity-bdd_serenity-core.net.serenitybdd.cucumber.suiteslicing.CucumberSuiteSlicer,0,0,0,0,0,0,0,0,0
serenity-bdd_serenity-core.net.serenitybdd.cucumber.suiteslicing.WeightedCucumberScenarios,1,0,0,0,0,0,0,0,1
serenity-bdd_serenity-core.io.cucumber.gherkin.CucumberScenarioLoader,0,0,0,0,0,0,0,0,0
serenity-bdd_serenity-core.net.serenitybdd.cucumber.suiteslicing.CucumberScenarioVisualiser,0,0,0,0,0,0,0,4,4
serenity-bdd_serenity-core.io.cucumber.gherkin.ScenarioLineCountStatistics,0,0,0,0,0,0,0,0,0
serenity-bdd_serenity-core.net.thucydides.core.reports.TestOutcomeLoader,5,0,0,5,0,0,0,0,10
serenity-bdd_serenity-core.net.serenitybdd.plugins.saucelabs.SaucelabsRemoteDriverCapabilities,0,0,0,0,0,0,0,0,0
serenity-bdd_serenity-core.net.serenitybdd.plugins.saucelabs.SauceLabsTestSession,0,0,0,0,0,0,0,0,0
serenity-bdd_serenity-core.net.thucydides.core.logging.ConsoleLoggingListener,0,0,0,0,0,0,0,7,7
serenity-bdd_serenity-core.net.thucydides.core.logging.ConsoleHeading,0,0,0,0,0,0,0,1,1
serenity-bdd_serenity-core.net.thucydides.core.model.Story,6,0,0,6,0,0,0,2,14
serenity-bdd_serenity-core.net.thucydides.core.steps.StepEventBus,45,3,0,45,0,0,3,18,114
serenity-bdd_serenity-core.net.thucydides.core.steps.WaitForBuilder,0,0,0,0,0,0,0,11,11
serenity-bdd_serenity-core.net.thucydides.core.steps.TestResultTally,0,0,0,0,0,0,0,1,1
serenity-bdd_serenity-core.net.thucydides.core.steps.BaseStepListener,15,0,0,15,0,0,0,0,30
serenity-bdd_serenity-core.net.thucydides.core.steps.ScenarioSteps,0,0,0,0,0,0,0,0,0
serenity-bdd_serenity-core.net.thucydides.core.steps.StepFactory,0,0,0,0,0,0,0,0,0
serenity-bdd_serenity-core.net.thucydides.core.steps.StepsAnnotatedField,0,0,0,0,0,0,0,0,0
serenity-bdd_serenity-core.net.thucydides.core.steps.StepAnnotations,0,0,0,0,0,0,0,0,0
serenity-bdd_serenity-core.net.thucydides.core.steps.ExecutedStepDescription,3,0,0,3,0,0,0,0,6
serenity-bdd_serenity-core.net.thucydides.core.model.TestStep,3,0,0,3,0,0,0,0,6
serenity-bdd_serenity-core.net.thucydides.core.steps.StepArgumentWriter,0,0,0,0,0,0,0,0,0
serenity-bdd_serenity-core.net.thucydides.core.steps.DefaultValue,0,0,0,0,0,0,0,0,0
serenity-bdd_serenity-core.net.thucydides.core.steps.TestDescription,0,0,0,0,0,0,0,0,0
serenity-bdd_serenity-core.net.thucydides.core.steps.StepListener,1,0,0,1,0,0,0,0,2
serenity-bdd_serenity-core.net.thucydides.core.steps.AnnotatedStepDescription,0,0,0,0,0,0,0,0,0
serenity-bdd_serenity-core.net.thucydides.core.steps.ErrorConvertor,3,0,0,0,0,3,0,0,6
serenity-bdd_serenity-core.net.thucydides.core.resources.ResourceList,0,0,0,0,0,0,0,1,1
serenity-bdd_serenity-core.net.thucydides.core.resources.FileResources,1,0,0,1,0,1,0,0,3
serenity-bdd_serenity-core.net.thucydides.core.reports.remoteTesting.RemoteTestingLinkManager,0,0,0,0,0,0,0,0,0
serenity-bdd_serenity-core.net.thucydides.core.environment.TestLocalEnvironmentVariables,0,0,0,0,0,0,0,0,0
serenity-bdd_serenity-core.net.thucydides.core.matchers.BeanMatchers,3,0,0,0,0,0,0,19,22
serenity-bdd_serenity-core.net.thucydides.core.files.TheDirectoryStructure,0,0,0,0,0,0,0,0,0
serenity-bdd_serenity-core.net.serenitybdd.core.CurrentOS,0,1,0,0,0,0,0,0,1
serenity-bdd_serenity-core.net.thucydides.core.statistics.service.TagProviderService,0,0,0,0,0,0,0,0,0
serenity-bdd_serenity-core.net.thucydides.core.statistics.service.TagProviderStrategy,0,0,0,0,0,0,0,0,0
serenity-bdd_serenity-core.net.thucydides.core.requirements.FileSystemRequirementsTagProvider,1,0,0,0,0,0,0,0,1
serenity-bdd_serenity-core.net.thucydides.core.reports.TestOutcomeStream,1,0,0,1,0,0,0,0,2
serenity-bdd_serenity-core.net.thucydides.core.model.ContextIcon,0,0,0,0,0,0,0,0,0
serenity-bdd_serenity-core.net.thucydides.core.model.stacktrace.FailureCause,1,0,0,1,0,0,0,0,2
serenity-bdd_serenity-core.net.thucydides.core.model.TestResultList,0,0,0,0,0,0,0,0,0
serenity-bdd_serenity-core.net.thucydides.core.matchers.BeanPropertyMatcher,0,0,0,0,0,0,0,0,0
serenity-bdd_serenity-core.net.thucydides.core.matchers.BeanFieldMatcher,0,0,0,0,0,0,0,0,0
serenity-bdd_serenity-core.net.thucydides.core.matchers.BeanMatcher,0,0,0,0,0,0,0,0,0
serenity-bdd_serenity-core.net.thucydides.core.matchers.dates.DateMatchers,2,0,0,0,0,0,0,0,2
serenity-bdd_serenity-core.net.thucydides.core.images.ResizableImage,6,2,0,6,0,0,0,0,14
serenity-bdd_serenity-core.net.thucydides.core.images.ResizedImage,0,0,0,0,0,0,0,0,0
serenity-bdd_serenity-core.net.thucydides.core.webdriver.WebdriverInstances,0,0,0,0,0,0,0,5,5
serenity-bdd_serenity-core.net.thucydides.core.webdriver.WebdriverManager,0,0,0,0,0,0,0,0,0
serenity-bdd_serenity-core.net.thucydides.core.webdriver.SerenityWebdriverManager,3,0,0,3,0,0,0,0,6
serenity-bdd_serenity-core.net.thucydides.core.annotations.locators.SmartAjaxElementLocator,0,0,0,0,0,0,0,1,1
serenity-bdd_serenity-core.net.thucydides.core.webdriver.TimeoutStack,1,0,0,1,0,0,0,0,2
serenity-bdd_serenity-core.net.thucydides.core.webdriver.Configuration,0,0,0,0,0,0,0,1,1
serenity-bdd_serenity-core.net.thucydides.core.webdriver.WebDriverFacade,2,0,0,0,0,0,0,6,8
serenity-bdd_serenity-core.net.thucydides.core.configuration.SystemPropertiesConfiguration,0,0,0,0,0,0,0,0,0
serenity-bdd_serenity-core.net.thucydides.core.annotations.ManagedWebDriverAnnotatedField,0,0,0,0,0,0,0,0,0
serenity-bdd_serenity-core.net.thucydides.core.annotations.TestAnnotations,5,0,0,5,0,0,0,0,10
serenity-bdd_serenity-core.net.thucydides.core.screenshots.ScreenshotAndHtmlSource,1,0,0,0,0,0,0,0,1
serenity-bdd_serenity-core.net.thucydides.core.requirements.reports.RequirementsOutcomeFactory,1,0,0,1,0,0,0,0,2
serenity-bdd_serenity-core.net.serenitybdd.core.Serenity,2,0,0,0,0,1,0,0,3
serenity-bdd_serenity-core.net.serenitybdd.core.SerenitySystemProperties,3,0,0,3,0,0,0,0,6
serenity-bdd_serenity-core.net.serenitybdd.junit5.SerenityTestExecutionListener,1,0,0,0,0,0,0,0,1
serenity-bdd_serenity-core.net.serenitybdd.junit5.JUnit5DataDrivenAnnotations,8,0,0,7,0,0,0,0,15
serenity-bdd_serenity-core.net.serenitybdd.junit5.ParameterizedTestsOutcomeAggregator,1,0,0,1,0,0,0,0,2
serenity-bdd_serenity-core.net.thucydides.core.webelements.Checkbox,0,0,0,0,0,0,0,4,4
serenity-bdd_serenity-core.net.thucydides.core.scheduling.TimeSchedule,0,0,0,0,0,0,0,14,14
serenity-bdd_serenity-core.net.thucydides.core.scheduling.fluent.TimeSchedule,0,0,0,0,0,0,0,2,2
serenity-bdd_serenity-core.net.thucydides.core.csv.FieldName,0,0,0,0,0,0,0,0,0
serenity-bdd_serenity-core.net.thucydides.core.steps.stepdata.TestDataSource,9,0,0,0,0,0,0,0,9
serenity-bdd_serenity-core.net.thucydides.core.webdriver.javascript.JavascriptSupport,1,0,0,0,0,0,0,0,1
serenity-bdd_serenity-core.net.thucydides.core.webdriver.capabilities.W3CCapabilities,16,0,0,16,0,0,0,0,32
serenity-bdd_serenity-core.net.serenitybdd.core.pages.PageUrls,0,0,0,0,0,0,0,0,0
serenity-bdd_serenity-core.net.serenitybdd.core.time.InternalSystemClock,1,0,0,0,0,0,0,0,1
serenity-bdd_serenity-core.net.serenitybdd.core.pages.PagesAnnotatedField,0,0,0,0,0,0,0,0,0
serenity-bdd_serenity-core.net.serenitybdd.core.pages.HtmlTag,0,0,0,0,0,0,0,0,0
serenity-bdd_serenity-core.net.thucydides.core.pages.jquery.JQueryEnabledPage,0,0,0,0,0,0,0,0,0
serenity-bdd_serenity-core.net.serenitybdd.core.lifecycle.LifecycleRegister,1,0,0,1,0,0,0,0,2
serenity-bdd_serenity-core.net.serenitybdd.core.parallel.Agency,0,0,0,0,0,0,0,0,0
serenity-bdd_serenity-core.net.thucydides.core.batches.SystemVariableBasedBatchManager,2,0,0,2,0,0,0,0,4
serenity-bdd_serenity-core.net.thucydides.core.batches.TestCountBasedBatchManager,0,0,0,0,0,0,0,0,0
serenity-bdd_serenity-core.net.serenitybdd.core.pages.WebElementFacade,12,0,0,0,0,0,0,0,12
serenity-bdd_serenity-core.net.serenitybdd.core.pages.WebElementFacadeImpl,0,0,0,0,0,0,0,1,1
serenity-bdd_serenity-core.net.thucydides.core.webelements.RadioButtonGroup,0,0,0,0,0,0,0,0,0
serenity-bdd_serenity-core.net.serenitybdd.core.pages.WebElementState,0,0,0,0,0,0,0,1,1
serenity-bdd_serenity-core.net.thucydides.core.pages.components.FileToUpload,0,0,0,0,0,0,0,0,0
serenity-bdd_serenity-core.net.thucydides.core.webdriver.jquery.ByJQuery,0,0,0,0,0,0,0,0,0
serenity-bdd_serenity-core.net.thucydides.core.pages.components.HtmlTable,10,0,0,1,0,0,0,2,13
serenity-bdd_serenity-core.net.thucydides.core.webdriver.javascript.ByShadowDom,2,0,0,1,0,0,0,0,3
serenity-bdd_serenity-core.net.thucydides.core.webdriver.WebDriverFactory,1,0,0,1,0,0,0,0,2
serenity-bdd_serenity-core.net.thucydides.core.pages.components.FileToDownload,0,0,0,0,0,0,0,0,0
serenity-bdd_serenity-core.net.thucydides.core.webdriver.shadow.ByShadow,0,0,0,0,0,0,0,0,0
serenity-bdd_serenity-core.net.thucydides.core.environment.SystemEnvironmentVariables,0,0,0,0,0,0,0,0,0
serenity-bdd_serenity-core.net.thucydides.core.issues.SystemPropertiesIssueTracking,0,0,0,0,0,0,0,0,0
serenity-bdd_serenity-core.net.thucydides.junit.spring.RunBeforeTestMethodCallbacks,0,0,0,0,0,0,0,2,2
serenity-bdd_serenity-core.net.thucydides.junit.spring.RunAfterTestMethodCallbacks,1,0,0,0,0,3,0,1,5
serenity-bdd_serenity-core.net.serenitybdd.screenplay.conditions.Check,2,0,0,0,0,0,0,0,2
serenity-bdd_serenity-core.net.serenitybdd.screenplay.waits.Wait,0,0,0,0,0,0,0,1,1
wikimedia_search-highlighter.org.wikimedia.search.highlighter.experimental.hit.ReplayingHitEnum,36,0,0,18,0,0,0,0,54
wikimedia_search-highlighter.org.wikimedia.search.highlighter.experimental.hit.MergingHitEnum,0,0,0,0,0,0,0,0,0
wikimedia_search-highlighter.org.wikimedia.search.highlighter.experimental.hit.PositionBoostingHitEnumWrapper,0,0,0,0,0,0,0,0,0
wikimedia_search-highlighter.org.wikimedia.search.highlighter.experimental.Segment,4,0,0,0,0,0,0,0,4
wikimedia_search-highlighter.org.wikimedia.search.highlighter.experimental.Snippet,12,0,0,0,0,0,0,0,12
wikimedia_search-highlighter.org.wikimedia.search.highlighter.experimental.Segmenter,42,4,0,32,0,0,0,0,78
wikimedia_search-highlighter.org.wikimedia.search.highlighter.experimental.SnippetChooser,6,0,0,6,0,0,0,0,12
wikimedia_search-highlighter.org.wikimedia.search.highlighter.experimental.SourceExtracter,4,0,0,0,0,0,0,0,4
wikimedia_search-highlighter.org.wikimedia.search.highlighter.experimental.source.StringSourceExtracter,8,0,0,8,0,0,0,0,16
wikimedia_search-highlighter.org.wikimedia.highlighter.experimental.lucene.QueryFlattener,0,0,0,0,0,0,0,24,24
pac4j_pac4j.org.pac4j.core.config.Config,6,0,0,6,0,0,0,3,15
pac4j_pac4j.org.pac4j.core.client.Clients,6,0,0,5,0,0,1,2,14
pac4j_pac4j.org.pac4j.saml.util.ConfigurationManager,4,0,0,4,0,0,0,0,8
pac4j_pac4j.org.pac4j.saml.metadata.SAML2MetadataResolver,1,0,0,0,0,0,0,0,1
pac4j_pac4j.org.pac4j.saml.metadata.SAML2IdentityProviderMetadataResolver,2,0,0,2,0,2,0,0,6
pac4j_pac4j.org.pac4j.saml.config.SAML2Configuration,3,0,0,3,0,0,0,1,7
pac4j_pac4j.org.pac4j.saml.util.SAML2HttpClientBuilder,2,0,0,2,0,0,0,0,4
pac4j_pac4j.org.pac4j.saml.crypto.KeyStoreCredentialProvider,0,0,0,0,0,0,0,0,0
pac4j_pac4j.org.pac4j.saml.store.HazelcastSAMLMessageStore,1,0,0,1,0,0,0,1,3
pac4j_pac4j.org.pac4j.saml.util.VelocityEngineFactory,1,0,0,0,0,0,0,0,1
pac4j_pac4j.org.pac4j.saml.util.SAML2Utils,7,0,0,0,0,0,0,0,7
pac4j_pac4j.org.pac4j.saml.logout.impl.SAML2LogoutValidator,0,0,0,0,0,2,0,0,2
pac4j_pac4j.org.pac4j.saml.profile.impl.AbstractSAML2MessageReceiver,2,0,0,2,0,2,0,0,6
pac4j_pac4j.org.pac4j.core.util.InitializableObject,9,0,0,9,0,3,0,9,30
pac4j_pac4j.org.pac4j.core.exception.http.FoundAction,1,0,0,0,0,0,0,0,1
pac4j_pac4j.org.pac4j.core.context.session.SessionStore,8,0,0,8,0,1,0,0,17
pac4j_pac4j.org.pac4j.saml.metadata.SAML2MetadataContactPerson,0,0,0,0,0,0,0,0,0
pac4j_pac4j.org.pac4j.core.exception.http.OkAction,0,0,0,0,0,0,0,0,0
pac4j_pac4j.org.pac4j.saml.credentials.authenticator.SAML2Authenticator,4,0,0,4,0,0,0,0,8
pac4j_pac4j.org.pac4j.saml.credentials.SAML2Credentials,6,0,0,1,0,0,0,0,7
pac4j_pac4j.org.pac4j.saml.util.Configuration,1,0,0,1,0,0,0,0,2
pac4j_pac4j.org.pac4j.saml.context.SAML2MessageContext,4,0,0,4,0,0,0,1,9
pac4j_pac4j.org.pac4j.core.context.WebContext,0,0,0,0,0,0,0,0,0
pac4j_pac4j.org.pac4j.saml.sso.impl.SAML2AuthnRequestBuilder,1,0,0,0,0,0,0,0,1
pac4j_pac4j.org.pac4j.core.client.IndirectClient,8,0,0,7,0,1,0,13,29
pac4j_pac4j.org.pac4j.core.profile.service.AbstractProfileService,5,0,0,5,0,0,0,5,15
pac4j_pac4j.org.pac4j.core.profile.BasicUserProfile,33,0,0,33,0,1,0,3,70
pac4j_pac4j.org.pac4j.core.authorization.authorizer.IsAuthenticatedAuthorizer,0,0,0,0,0,0,0,0,0
pac4j_pac4j.org.pac4j.core.authorization.authorizer.Authorizer,0,0,0,0,0,0,0,0,0
pac4j_pac4j.org.pac4j.core.authorization.authorizer.AbstractCheckAuthenticationAuthorizer,0,0,0,0,0,0,0,4,4
pac4j_pac4j.org.pac4j.core.authorization.authorizer.AbstractRequireElementAuthorizer,0,0,0,0,0,0,0,0,0
pac4j_pac4j.org.pac4j.core.authorization.authorizer.IsAnonymousAuthorizer,0,0,0,0,0,0,0,0,0
pac4j_pac4j.org.pac4j.core.authorization.checker.DefaultAuthorizationChecker,1,0,0,1,0,0,0,0,2
pac4j_pac4j.org.pac4j.core.matching.matcher.csrf.DefaultCsrfTokenGenerator,1,0,0,1,0,0,0,0,2
pac4j_pac4j.org.pac4j.core.authorization.generator.FromAttributesAuthorizationGenerator,7,0,0,7,0,0,0,0,14
pac4j_pac4j.org.pac4j.core.http.ajax.AjaxRequestResolver,0,0,0,0,0,0,0,0,0
pac4j_pac4j.org.pac4j.core.http.callback.QueryParameterCallbackUrlResolver,0,0,0,0,0,0,0,0,0
pac4j_pac4j.org.pac4j.core.http.callback.NoParameterCallbackUrlResolver,0,0,0,0,0,0,0,0,0
pac4j_pac4j.org.pac4j.core.http.callback.PathParameterCallbackUrlResolver,0,0,0,0,0,0,0,0,0
pac4j_pac4j.org.pac4j.core.http.url.DefaultUrlResolver,0,0,0,0,0,0,0,0,0
pac4j_pac4j.org.pac4j.core.http.url.UrlResolver,0,0,0,0,0,0,0,0,0
pac4j_pac4j.org.pac4j.core.matching.matcher.PathMatcher,6,0,0,5,0,0,0,0,11
pac4j_pac4j.org.pac4j.core.matching.matcher.HeaderMatcher,0,0,0,0,0,0,0,0,0
pac4j_pac4j.org.pac4j.core.matching.matcher.HttpMethodMatcher,0,0,0,0,0,0,0,0,0
pac4j_pac4j.org.pac4j.core.matching.checker.DefaultMatchingChecker,9,0,0,4,0,0,0,0,13
pac4j_pac4j.org.pac4j.core.profile.definition.ProfileDefinition,1,0,0,0,0,0,0,0,1
pac4j_pac4j.org.pac4j.core.profile.ProfileManager,5,0,0,5,0,0,0,0,10
pac4j_pac4j.org.pac4j.core.profile.ProfileHelper,1,0,0,0,0,0,0,0,1
pac4j_pac4j.org.pac4j.core.util.serializer.AbstractSerializer,3,0,0,3,0,0,0,0,6
pac4j_pac4j.org.pac4j.core.profile.creator.AuthenticatorProfileCreator,0,0,0,0,0,0,0,0,0
pac4j_pac4j.org.pac4j.core.credentials.Credentials,0,0,0,0,0,0,0,0,0
pac4j_pac4j.org.pac4j.core.profile.converter.AbstractAttributeConverter,3,0,0,2,0,0,0,0,5
pac4j_pac4j.org.pac4j.core.profile.converter.ChainingConverter,1,0,0,0,0,0,0,0,1
pac4j_pac4j.org.pac4j.core.store.GuavaStore,0,0,0,0,0,0,0,3,3
pac4j_pac4j.org.pac4j.core.util.HttpUtils,0,0,0,0,0,0,0,0,0
pac4j_pac4j.org.pac4j.core.util.HttpActionHelper,10,0,0,10,0,0,0,0,20
pac4j_pac4j.org.pac4j.core.util.CommonHelper,9,0,0,1,0,2,0,5,17
pac4j_pac4j.org.pac4j.core.util.serializer.JavaSerializer,0,0,0,0,0,0,0,0,0
pac4j_pac4j.org.pac4j.core.exception.http.HttpAction,7,0,0,6,0,0,0,0,13
pac4j_pac4j.org.pac4j.core.client.finder.DefaultSecurityClientFinder,2,0,0,0,0,0,0,0,2
pac4j_pac4j.org.pac4j.core.client.finder.ClientFinder,1,0,0,0,0,0,0,0,1
pac4j_pac4j.org.pac4j.core.client.finder.DefaultCallbackClientFinder,4,0,0,0,0,0,0,0,4
pac4j_pac4j.org.pac4j.core.credentials.extractor.HeaderExtractor,0,0,0,0,0,0,0,0,0
pac4j_pac4j.org.pac4j.core.credentials.password.JBCryptPasswordEncoder,1,0,0,1,0,0,0,0,2
pac4j_pac4j.org.pac4j.core.engine.DefaultSecurityLogic,1,0,0,1,0,0,0,3,5
pac4j_pac4j.org.pac4j.core.engine.savedrequest.DefaultSavedRequestHandler,7,0,0,7,0,0,0,0,14
pac4j_pac4j.org.pac4j.scribe.extractors.WeiboJsonExtractor,1,1,0,1,0,0,0,0,3
pac4j_pac4j.org.pac4j.oauth.profile.JsonHelper,2,0,0,2,0,0,0,0,4
pac4j_pac4j.org.pac4j.oauth.profile.facebook.FacebookObject,0,0,0,0,0,0,0,0,0
pac4j_pac4j.org.pac4j.oauth.profile.hiorgserver.HiOrgServerProfile,1,0,0,1,0,0,0,0,2
pac4j_pac4j.org.pac4j.oauth.profile.OAuth20Profile,1,0,0,1,0,0,0,0,2
pac4j_pac4j.org.pac4j.oauth.profile.facebook.converter.FacebookRelationshipStatusConverter,0,0,0,0,0,0,0,0,0
pac4j_pac4j.org.pac4j.oauth.profile.converter.JsonConverter,5,0,0,2,0,0,0,0,7
pac4j_pac4j.org.pac4j.core.client.BaseClient,2,0,0,2,0,0,0,4,8
pac4j_pac4j.org.pac4j.oauth.client.OAuth20Client,2,0,0,2,0,0,0,3,7
pac4j_pac4j.org.pac4j.oauth.client.Google2Client,0,0,0,0,0,0,0,1,1
pac4j_pac4j.org.pac4j.oauth.client.LinkedIn2Client,0,0,0,0,0,0,0,1,1
pac4j_pac4j.org.pac4j.oauth.client.GenericOAuth20Client,1,0,0,1,0,0,0,0,2
pac4j_pac4j.org.pac4j.oauth.credentials.OAuth10Credentials,1,0,0,1,0,0,0,0,2
pac4j_pac4j.org.pac4j.jee.context.JEEContext,1,0,0,1,0,0,0,0,2
pac4j_pac4j.org.pac4j.jee.http.adapter.JEEHttpActionAdapter,0,0,0,0,0,0,0,6,6
pac4j_pac4j.org.pac4j.mongo.profile.service.MongoProfileService,0,0,0,0,0,0,0,2,2
pac4j_pac4j.org.pac4j.oidc.profile.OidcProfile,7,0,0,7,0,0,0,0,14
pac4j_pac4j.org.pac4j.oidc.config.OidcConfiguration,1,0,0,1,0,0,0,1,3
pac4j_pac4j.org.pac4j.oidc.profile.creator.TokenValidator,0,0,0,0,0,0,0,0,0
pac4j_pac4j.org.pac4j.jwt.profile.JwtGenerator,4,0,0,4,0,0,0,2,10
pac4j_pac4j.org.pac4j.oidc.credentials.OidcCredentials,1,0,0,1,0,0,0,0,2
pac4j_pac4j.org.pac4j.oidc.config.OidcConfigurationContext,0,0,0,0,0,0,0,0,0
pac4j_pac4j.org.pac4j.oidc.credentials.authenticator.UserInfoOidcAuthenticator,1,0,0,1,0,0,0,0,2
pac4j_pac4j.org.pac4j.jwt.config.signature.SecretSignatureConfiguration,1,0,0,1,0,0,0,0,2
pac4j_pac4j.org.pac4j.jwt.config.encryption.AbstractEncryptionConfiguration,0,0,0,0,0,0,0,4,4
pac4j_pac4j.org.pac4j.jwt.config.encryption.SecretEncryptionConfiguration,0,0,0,0,0,0,0,0,0
pac4j_pac4j.org.pac4j.jwt.util.JWKHelper,0,0,0,0,0,0,0,3,3
pac4j_pac4j.org.pac4j.jwt.config.signature.RSASignatureConfiguration,0,0,0,0,0,0,0,1,1
pac4j_pac4j.org.pac4j.jwt.config.signature.ECSignatureConfiguration,0,0,0,0,0,0,0,1,1
pac4j_pac4j.org.pac4j.jwt.credentials.authenticator.JwtAuthenticator,2,0,0,0,0,0,0,3,5
pac4j_pac4j.org.pac4j.core.client.DirectClient,2,0,0,2,0,0,0,0,4
pac4j_pac4j.org.pac4j.kerberos.credentials.authenticator.KerberosTicketValidator,1,0,0,1,0,0,0,0,2
pac4j_pac4j.org.pac4j.cas.profile.CasRestProfile,0,0,0,0,0,0,0,0,0
pac4j_pac4j.org.pac4j.cas.redirect.CasRedirectionActionBuilder,5,0,0,5,0,0,0,0,10
pac4j_pac4j.org.pac4j.cas.config.CasConfiguration,9,0,0,9,0,2,0,6,26
pac4j_pac4j.org.pac4j.cas.client.direct.DirectCasProxyClient,0,0,0,0,0,0,0,1,1
pac4j_pac4j.org.pac4j.http.authorization.authorizer.IpRegexpAuthorizer,0,0,0,0,0,0,0,0,0
pac4j_pac4j.org.pac4j.http.client.direct.DirectDigestAuthClient,1,0,0,1,0,0,0,0,2
pac4j_pac4j.org.pac4j.http.client.direct.ParameterClient,0,0,0,0,0,0,0,1,1
pac4j_pac4j.org.pac4j.core.credentials.extractor.ParameterExtractor,0,0,0,0,0,0,0,0,0
pac4j_pac4j.org.pac4j.http.credentials.extractor.DigestAuthExtractor,1,0,0,1,0,0,0,0,2
pac4j_pac4j.org.pac4j.http.credentials.extractor.IpExtractor,2,0,0,2,0,0,0,0,4
pac4j_pac4j.org.pac4j.http.credentials.authenticator.RestAuthenticator,1,0,0,1,0,0,0,1,3
pac4j_pac4j.org.pac4j.http.credentials.authenticator.IpRegexpAuthenticator,0,0,0,0,0,0,0,0,0
michaelwittig_java-q.info.michaelwittig.javaq.connector.impl.QConnectorAsyncImpl,0,0,0,0,0,0,0,0,0
michaelwittig_java-q.info.michaelwittig.javaq.connector.impl.QConnectorSyncImpl,2,0,0,1,0,0,0,0,3
michaelwittig_java-q.info.michaelwittig.javaq.connector.impl.QConnectorSyncTSImpl,3,0,0,2,0,0,0,0,5
michaelwittig_java-q.info.michaelwittig.javaq.query.TableResult,2,0,0,2,0,0,0,0,4
michaelwittig_java-q.info.michaelwittig.javaq.query.PrimitiveResult,0,0,0,0,0,0,0,0,0
michaelwittig_java-q.info.michaelwittig.javaq.query.ListResult,0,0,0,0,0,0,0,0,0
michaelwittig_java-q.info.michaelwittig.javaq.query.value.impl.RealValue,0,0,0,0,0,0,0,0,0
michaelwittig_java-q.info.michaelwittig.javaq.query.value.impl.TimeValue,0,0,0,0,0,0,0,0,0
michaelwittig_java-q.info.michaelwittig.javaq.query.value.impl.SymbolValue,0,0,0,0,0,0,0,0,0
michaelwittig_java-q.info.michaelwittig.javaq.query.value.impl.ListValue,0,0,0,0,0,0,0,0,0
michaelwittig_java-q.info.michaelwittig.javaq.query.value.impl.FloatValue,0,0,0,0,0,0,0,0,0
michaelwittig_java-q.info.michaelwittig.javaq.query.value.impl.TimestampValue,0,0,0,0,0,0,0,0,0
michaelwittig_java-q.info.michaelwittig.javaq.query.value.impl.BooleanValue,0,0,0,0,0,0,0,0,0
michaelwittig_java-q.info.michaelwittig.javaq.query.value.impl.LongValue,0,0,0,0,0,0,0,0,0
michaelwittig_java-q.info.michaelwittig.javaq.query.value.impl.IntegerValue,0,0,0,0,0,0,0,0,0
michaelwittig_java-q.info.michaelwittig.javaq.query.filter.impl.FilterImpl,0,0,0,0,0,0,0,0,0
michaelwittig_java-q.info.michaelwittig.javaq.query.column.impl.ASimpleNominalColumn,0,0,0,0,0,0,0,0,0
michaelwittig_java-q.info.michaelwittig.javaq.Q,0,0,0,0,0,0,0,0,0
michaelwittig_java-q.info.michaelwittig.javaq.Builder,0,0,0,0,0,0,0,0,0
spring-cloud_spring-cloud-cli.org.springframework.cloud.launcher.deployer.DeployerApplication,0,1,0,0,0,0,1,0,2
spring-cloud_spring-cloud-cli.org.springframework.cloud.cli.compiler.SpringCloudBomAstTransformation,0,0,0,0,0,0,0,0,0
rpau_walkmod-core.org.walkmod.OptionsBuilder,9,0,0,8,0,0,0,3,20
rpau_walkmod-core.org.walkmod.WalkModFacade,1,0,0,1,0,0,0,0,2
rpau_walkmod-core.org.walkmod.Options,14,0,0,14,0,0,0,0,28
rpau_walkmod-core.org.walkmod.util.FileResource,5,0,0,5,0,0,0,0,10
rpau_walkmod-core.org.walkmod.conf.providers.PluginsConfigurationProvider,1,0,0,1,0,0,0,0,2
rpau_walkmod-core.org.walkmod.conf.providers.IvyConfigurationProvider,0,0,0,0,0,0,0,0,0
rpau_walkmod-core.org.walkmod.conf.providers.LanguageConfigurationProvider,1,0,0,1,0,0,0,0,2
rpau_walkmod-core.org.walkmod.conf.providers.YAMLConfigurationProvider,7,0,0,7,0,0,0,0,14
rpau_walkmod-core.org.walkmod.conf.providers.XMLConfigurationProvider,12,0,0,12,0,0,0,0,24
rpau_walkmod-core.org.walkmod.writers.AbstractFileWriter,1,0,0,0,0,0,0,0,1
schema-repo_schema-repo.org.schemarepo.server.RepositoryServer,0,0,0,0,0,0,0,1,1
schema-repo_schema-repo.org.schemarepo.server.RESTRepository,2,0,0,2,0,0,0,0,4
schema-repo_schema-repo.org.schemarepo.server.AuxiliaryRESTRepository,1,0,0,1,0,0,0,0,2
schema-repo_schema-repo.org.schemarepo.Repository,5,0,0,5,0,0,0,0,10
schema-repo_schema-repo.org.schemarepo.config.ConfigModule,0,0,0,0,0,0,0,1,1
schema-repo_schema-repo.org.schemarepo.ValidatorFactory,0,0,0,0,0,0,0,0,0
schema-repo_schema-repo.org.schemarepo.Subject,3,0,0,3,0,0,0,0,6
schema-repo_schema-repo.org.schemarepo.AbstractBackendRepository,1,0,0,1,0,0,0,0,2
schema-repo_schema-repo.org.schemarepo.LocalFileSystemRepository,0,0,0,0,0,0,0,0,0
schema-repo_schema-repo.org.schemarepo.ReadOnlyRepository,1,0,0,1,0,0,0,0,2
schema-repo_schema-repo.org.schemarepo.SubjectConfig,2,0,0,2,0,0,0,0,4
schema-repo_schema-repo.org.schemarepo.SchemaEntry,2,0,0,2,0,0,0,0,4
schema-repo_schema-repo.org.schemarepo.RepositoryUtil,1,0,0,1,0,0,0,1,3
schema-repo_schema-repo.org.schemarepo.json.JsonUtil,1,0,0,1,0,0,0,0,2
schema-repo_schema-repo.org.schemarepo.config.Config,1,0,0,0,0,0,0,0,1
SurveyMan_SurveyMan.edu.umass.cs.surveyman.server.StaticAnalysisServer,0,0,0,0,0,0,1,0,1
SurveyMan_SurveyMan.edu.umass.cs.surveyman.utils.Slurpie,3,0,0,3,0,0,0,0,6
SurveyMan_SurveyMan.edu.umass.cs.surveyman.input.csv.CSVEntry,0,1,0,0,0,0,0,1,2
SurveyMan_SurveyMan.edu.umass.cs.surveyman.input.csv.CSVParser,6,0,0,6,0,0,0,3,15
SurveyMan_SurveyMan.edu.umass.cs.surveyman.input.json.JSONParser,1,0,0,1,0,0,0,1,3
SurveyMan_SurveyMan.edu.umass.cs.surveyman.qc.QCMetrics,3,0,0,0,0,0,0,0,3
SurveyMan_SurveyMan.edu.umass.cs.surveyman.survey.Block,2,0,0,2,0,0,0,0,4
SurveyMan_SurveyMan.edu.umass.cs.surveyman.survey.Question,0,0,0,0,0,1,0,2,3
SurveyMan_SurveyMan.edu.umass.cs.surveyman.survey.Survey,2,0,0,2,0,0,0,0,4
SurveyMan_SurveyMan.edu.umass.cs.surveyman.qc.SurveyDAG,1,0,0,1,0,0,0,0,2
SurveyMan_SurveyMan.edu.umass.cs.surveyman.qc.classifiers.LPOClassifier,1,0,0,1,0,0,0,0,2
SurveyMan_SurveyMan.edu.umass.cs.surveyman.qc.classifiers.AbstractClassifier,2,1,0,1,0,0,0,0,4
SurveyMan_SurveyMan.edu.umass.cs.surveyman.qc.respondents.LexicographicRespondent,1,0,0,0,0,0,0,0,1
SurveyMan_SurveyMan.edu.umass.cs.surveyman.qc.respondents.AbstractRespondent,1,0,0,1,0,0,0,0,2
SurveyMan_SurveyMan.edu.umass.cs.surveyman.output.CorrelationStruct,1,0,0,0,0,0,0,0,1
neo4j-contrib_graph-collections.org.neo4j.collections.sortedtree.SortedTree,1,1,0,1,0,0,0,0,3
neo4j-contrib_graph-collections.org.neo4j.collections.graphdb.ReferenceNodes,5,0,0,5,0,0,1,0,11
neo4j-contrib_graph-collections.org.neo4j.collections.rtree.Envelope,2,0,0,2,0,0,0,0,4
neo4j-contrib_graph-collections.org.neo4j.collections.graphdb.DatabaseService,1,0,0,1,0,0,0,0,2
neo4j-contrib_graph-collections.org.neo4j.collections.timeline.Timeline,6,1,0,5,0,0,1,3,16
neo4j-contrib_graph-collections.org.neo4j.collections.list.UnrolledLinkedList,14,2,0,14,0,0,1,0,31
neo4j-contrib_graph-collections.org.neo4j.collections.list.List,1,0,0,1,0,0,0,0,2
neo4j-contrib_graph-collections.org.neo4j.collections.indexedrelationship.IndexedRelationship,17,10,0,17,0,0,0,0,44
digidotcom_XBeeJavaLibrary.com.digi.xbee.api.IPv6Device,6,0,0,6,0,0,0,30,42
digidotcom_XBeeJavaLibrary.com.digi.xbee.api.ThreadDevice,0,0,0,0,0,0,0,6,6
digidotcom_XBeeJavaLibrary.com.digi.xbee.api.models.ATCommandResponse,4,0,0,4,0,4,0,2,14
digidotcom_XBeeJavaLibrary.com.digi.xbee.api.AbstractXBeeDevice,66,0,0,65,0,2,0,49,182
digidotcom_XBeeJavaLibrary.com.digi.xbee.api.DigiPointDevice,0,0,0,0,0,0,0,12,12
digidotcom_XBeeJavaLibrary.com.digi.xbee.api.DigiMeshDevice,0,0,0,0,0,0,0,10,10
digidotcom_XBeeJavaLibrary.com.digi.xbee.api.XBeeDevice,10,0,0,9,0,4,0,17,40
digidotcom_XBeeJavaLibrary.com.digi.xbee.api.CellularDevice,2,0,0,2,0,0,0,16,20
digidotcom_XBeeJavaLibrary.com.digi.xbee.api.XBeeNetwork,37,0,0,36,0,0,0,16,89
digidotcom_XBeeJavaLibrary.com.digi.xbee.api.ZigBeeDevice,0,0,0,0,0,0,0,14,14
digidotcom_XBeeJavaLibrary.com.digi.xbee.api.IPDevice,6,0,0,6,0,1,0,23,36
digidotcom_XBeeJavaLibrary.com.digi.xbee.api.models.IPMessage,6,0,0,6,0,0,0,0,12
digidotcom_XBeeJavaLibrary.com.digi.xbee.api.Raw802Device,0,0,0,0,0,0,0,7,7
digidotcom_XBeeJavaLibrary.com.digi.xbee.api.WiFiDevice,2,0,0,1,0,3,0,15,21
digidotcom_XBeeJavaLibrary.com.digi.xbee.api.utils.ByteUtils,8,0,0,0,0,0,0,21,29
digidotcom_XBeeJavaLibrary.com.digi.xbee.api.NodeDiscovery,1,0,0,0,0,0,0,1,2
digidotcom_XBeeJavaLibrary.com.digi.xbee.api.models.AccessPoint,5,0,0,5,0,0,0,0,10
digidotcom_XBeeJavaLibrary.com.digi.xbee.api.connection.serial.AbstractSerialPort,13,0,0,3,0,1,0,33,50
digidotcom_XBeeJavaLibrary.com.digi.xbee.api.RemoteDigiMeshDevice,0,0,0,0,0,0,0,4,4
digidotcom_XBeeJavaLibrary.com.digi.xbee.api.RemoteDigiPointDevice,0,0,0,0,0,0,0,4,4
digidotcom_XBeeJavaLibrary.com.digi.xbee.api.RemoteRaw802Device,1,0,0,1,0,0,0,3,5
digidotcom_XBeeJavaLibrary.com.digi.xbee.api.RemoteZigBeeDevice,0,0,0,0,0,0,0,4,4
digidotcom_XBeeJavaLibrary.com.digi.xbee.api.RemoteXBeeDevice,1,0,0,0,0,1,0,1,3
digidotcom_XBeeJavaLibrary.com.digi.xbee.api.XBee,1,0,0,1,0,0,0,0,2
digidotcom_XBeeJavaLibrary.com.digi.xbee.api.NBIoTDevice,0,0,0,0,0,0,0,1,1
digidotcom_XBeeJavaLibrary.com.digi.xbee.api.LPWANDevice,0,0,0,0,0,0,0,10,10
digidotcom_XBeeJavaLibrary.com.digi.xbee.api.utils.HexUtils,0,0,0,0,0,0,0,29,29
digidotcom_XBeeJavaLibrary.com.digi.xbee.api.io.IOSample,17,9,0,15,0,0,0,0,41
digidotcom_XBeeJavaLibrary.com.digi.xbee.api.DataReader,49,0,0,16,0,2,0,27,94
digidotcom_XBeeJavaLibrary.com.digi.xbee.api.packet.common.ExplicitRxIndicatorPacket,14,0,0,11,0,0,0,4,29
digidotcom_XBeeJavaLibrary.com.digi.xbee.api.models.ExplicitXBeeMessage,2,0,0,2,0,0,0,0,4
digidotcom_XBeeJavaLibrary.com.digi.xbee.api.models.ATCommand,3,0,0,3,0,3,0,0,9
digidotcom_XBeeJavaLibrary.com.digi.xbee.api.models.SMSMessage,1,0,0,1,0,0,0,0,2
digidotcom_XBeeJavaLibrary.com.digi.xbee.api.models.XBeeMessage,2,0,0,2,0,0,0,0,4
digidotcom_XBeeJavaLibrary.com.digi.xbee.api.models.XBeeIMEIAddress,11,0,0,2,0,4,0,0,17
digidotcom_XBeeJavaLibrary.com.digi.xbee.api.models.HardwareVersion,13,0,0,12,0,1,0,0,26
digidotcom_XBeeJavaLibrary.com.digi.xbee.api.models.XBee16BitAddress,13,0,0,8,0,6,0,0,27
digidotcom_XBeeJavaLibrary.com.digi.xbee.api.models.XBee64BitAddress,13,0,0,8,0,6,0,0,27
digidotcom_XBeeJavaLibrary.com.digi.xbee.api.models.XBeePacketsQueue,13,0,0,13,0,0,0,0,26
digidotcom_XBeeJavaLibrary.com.digi.xbee.api.packet.ip.RXIPv4Packet,13,0,0,10,0,0,0,11,34
digidotcom_XBeeJavaLibrary.com.digi.xbee.api.packet.thread.RXIPv6Packet,11,0,0,8,0,0,0,12,31
digidotcom_XBeeJavaLibrary.com.digi.xbee.api.packet.XBeePacketParser,40,0,0,40,0,0,0,13,93
digidotcom_XBeeJavaLibrary.com.digi.xbee.api.packet.XBeePacket,57,0,0,51,0,0,0,14,122
digidotcom_XBeeJavaLibrary.com.digi.xbee.api.packet.UnknownXBeePacket,10,0,0,6,0,0,0,2,18
digidotcom_XBeeJavaLibrary.com.digi.xbee.api.packet.XBeeAPIPacket,10,0,0,10,0,0,0,2,22
digidotcom_XBeeJavaLibrary.com.digi.xbee.api.packet.GenericXBeePacket,11,0,0,7,0,0,0,3,21
digidotcom_XBeeJavaLibrary.com.digi.xbee.api.packet.XBeeChecksum,0,0,0,0,0,0,0,0,0
digidotcom_XBeeJavaLibrary.com.digi.xbee.api.packet.common.TransmitStatusPacket,9,0,0,9,0,0,0,4,22
digidotcom_XBeeJavaLibrary.com.digi.xbee.api.packet.common.ATCommandPacket,14,0,0,10,0,0,0,4,28
digidotcom_XBeeJavaLibrary.com.digi.xbee.api.packet.common.RemoteATCommandPacket,13,0,0,13,0,0,0,4,30
digidotcom_XBeeJavaLibrary.com.digi.xbee.api.packet.common.ReceivePacket,11,0,0,9,0,0,0,4,24
digidotcom_XBeeJavaLibrary.com.digi.xbee.api.packet.common.ATCommandResponsePacket,16,0,0,13,0,0,0,4,33
digidotcom_XBeeJavaLibrary.com.digi.xbee.api.packet.common.TransmitPacket,11,0,0,9,0,0,0,4,24
digidotcom_XBeeJavaLibrary.com.digi.xbee.api.packet.common.ModemStatusPacket,3,0,0,3,0,0,0,4,10
digidotcom_XBeeJavaLibrary.com.digi.xbee.api.packet.common.ATCommandQueuePacket,14,0,0,10,0,0,0,4,28
digidotcom_XBeeJavaLibrary.com.digi.xbee.api.packet.common.IODataSampleRxIndicatorPacket,21,1,0,18,0,0,0,4,44
digidotcom_XBeeJavaLibrary.com.digi.xbee.api.packet.common.RemoteATCommandResponsePacket,11,0,0,11,0,0,0,4,26
digidotcom_XBeeJavaLibrary.com.digi.xbee.api.packet.common.ExplicitAddressingPacket,12,0,0,9,0,0,0,4,25
digidotcom_XBeeJavaLibrary.com.digi.xbee.api.packet.raw.RX64IOPacket,21,1,0,18,0,0,0,4,44
digidotcom_XBeeJavaLibrary.com.digi.xbee.api.packet.raw.RX16IOPacket,21,1,0,18,0,0,0,4,44
digidotcom_XBeeJavaLibrary.com.digi.xbee.api.packet.raw.TX64Packet,11,0,0,9,0,0,0,4,24
digidotcom_XBeeJavaLibrary.com.digi.xbee.api.packet.raw.TX16Packet,11,0,0,9,0,0,0,4,24
digidotcom_XBeeJavaLibrary.com.digi.xbee.api.packet.raw.TXStatusPacket,6,0,0,6,0,0,0,4,16
digidotcom_XBeeJavaLibrary.com.digi.xbee.api.packet.raw.RX16Packet,11,0,0,9,0,0,0,4,24
digidotcom_XBeeJavaLibrary.com.digi.xbee.api.packet.raw.RX64Packet,11,0,0,9,0,0,0,4,24
digidotcom_XBeeJavaLibrary.com.digi.xbee.api.packet.devicecloud.SendDataRequestPacket,12,0,0,12,0,0,0,5,29
digidotcom_XBeeJavaLibrary.com.digi.xbee.api.packet.devicecloud.DeviceResponseStatusPacket,3,0,0,3,0,0,0,5,11
digidotcom_XBeeJavaLibrary.com.digi.xbee.api.packet.devicecloud.DeviceRequestPacket,9,0,0,9,0,0,0,7,25
digidotcom_XBeeJavaLibrary.com.digi.xbee.api.packet.devicecloud.DeviceResponsePacket,6,0,0,6,0,0,0,6,18
digidotcom_XBeeJavaLibrary.com.digi.xbee.api.packet.devicecloud.SendDataResponsePacket,3,0,0,3,0,0,0,5,11
digidotcom_XBeeJavaLibrary.com.digi.xbee.api.packet.devicecloud.FrameErrorPacket,3,0,0,3,0,0,0,5,11
digidotcom_XBeeJavaLibrary.com.digi.xbee.api.packet.cellular.TXSMSPacket,12,0,0,11,0,0,0,5,28
digidotcom_XBeeJavaLibrary.com.digi.xbee.api.packet.cellular.RXSMSPacket,12,0,0,11,0,0,0,5,28
digidotcom_XBeeJavaLibrary.com.digi.xbee.api.packet.wifi.RemoteATCommandResponseWifiPacket,11,0,0,11,0,0,0,5,27
digidotcom_XBeeJavaLibrary.com.digi.xbee.api.packet.wifi.RemoteATCommandWifiPacket,13,0,0,13,0,0,0,5,31
digidotcom_XBeeJavaLibrary.com.digi.xbee.api.packet.wifi.IODataSampleRxIndicatorWifiPacket,6,1,0,6,0,0,0,10,23
digidotcom_XBeeJavaLibrary.com.digi.xbee.api.packet.thread.TXIPv6Packet,10,0,0,8,0,0,0,11,29
digidotcom_XBeeJavaLibrary.com.digi.xbee.api.packet.thread.CoAPTxRequestPacket,10,0,0,8,0,0,0,9,27
digidotcom_XBeeJavaLibrary.com.digi.xbee.api.packet.thread.IPv6RemoteATCommandRequestPacket,13,0,0,13,0,0,0,4,30
digidotcom_XBeeJavaLibrary.com.digi.xbee.api.packet.thread.CoAPRxResponsePacket,10,0,0,8,0,0,0,13,31
digidotcom_XBeeJavaLibrary.com.digi.xbee.api.packet.thread.IPv6RemoteATCommandResponsePacket,13,0,0,13,0,0,0,5,31
digidotcom_XBeeJavaLibrary.com.digi.xbee.api.packet.thread.IPv6IODataSampleRxIndicator,20,1,0,16,0,0,0,5,42
digidotcom_XBeeJavaLibrary.com.digi.xbee.api.packet.ip.TXIPv4Packet,12,0,0,10,0,0,0,12,34
digidotcom_XBeeJavaLibrary.com.digi.xbee.api.exceptions.XBeeException,97,0,0,0,0,0,0,0,97
digidotcom_XBeeJavaLibrary.com.digi.xbee.api.exceptions.ATCommandException,14,0,0,14,0,0,0,0,28
digidotcom_XBeeJavaLibrary.com.digi.xbee.api.exceptions.TransmitException,14,0,0,14,0,0,0,0,28
digidotcom_XBeeJavaLibrary.com.digi.xbee.api.connection.serial.SerialPortParameters,11,0,0,2,0,0,0,0,13
digidotcom_XBeeJavaLibrary.com.digi.xbee.api.connection.serial.SerialPortInfo,7,0,0,7,0,0,0,0,14
jvirtanen_nassau.com.paritytrading.nassau.moldudp64.MoldUDP64DownstreamPacket,5,0,0,5,0,0,0,0,10
jvirtanen_nassau.com.paritytrading.nassau.moldudp64.MoldUDP64Server,4,0,0,4,0,0,0,0,8
jvirtanen_nassau.com.paritytrading.nassau.moldudp64.MoldUDP64DefaultMessageStore,5,0,0,5,0,0,0,0,10
jvirtanen_nassau.com.paritytrading.nassau.moldudp64.MoldUDP64Client,2,0,0,2,0,0,0,0,4
jvirtanen_nassau.com.paritytrading.nassau.soupbintcp.SoupBinTCPSession,0,0,0,0,0,0,0,0,0
jvirtanen_nassau.com.paritytrading.nassau.soupbintcp.SoupBinTCPClient,0,0,0,0,0,0,0,1,1
jvirtanen_nassau.com.paritytrading.nassau.soupbintcp.SoupBinTCPServer,0,0,0,0,0,0,0,1,1
jvirtanen_nassau.com.paritytrading.nassau.binaryfile.BinaryFILEWriter,0,0,0,0,0,0,0,0,0
jvirtanen_nassau.com.paritytrading.nassau.binaryfile.BinaryFILEReader,1,0,0,0,0,0,0,0,1
benjiman_expressions.uk.co.benjiweber.expressions.ChainableVoid,1,0,0,0,0,0,0,0,1
benjiman_expressions.uk.co.benjiweber.expressions.properties.Property,4,0,0,1,0,0,0,0,5
benjiman_expressions.uk.co.benjiweber.expressions.properties.Named,2,0,0,0,0,0,0,0,2
benjiman_expressions.uk.co.benjiweber.expressions.Times,0,0,0,0,0,0,0,0,0
benjiman_expressions.uk.co.benjiweber.expressions.InstanceOf,0,0,0,0,0,1,0,0,1
benjiman_expressions.uk.co.benjiweber.expressions.exceptions.Exceptions,0,0,0,0,0,0,0,0,0
benjiman_expressions.uk.co.benjiweber.expressions.caseclass.Case,1,0,0,0,0,0,0,0,1
lesaint_damapping.fr.javatronic.damapping.util.FluentIterable,1,0,0,0,0,0,0,0,1
lesaint_damapping.fr.javatronic.damapping.processor.model.factory.DATypeFactory,8,0,0,8,0,0,0,2,18
lesaint_damapping.fr.javatronic.damapping.processor.model.factory.DANameFactory,1,1,0,1,0,0,0,0,3
lesaint_damapping.fr.javatronic.damapping.processor.model.predicate.DAMethodPredicates,3,0,0,3,0,0,0,0,6
lesaint_damapping.fr.javatronic.damapping.processor.model.predicate.DAAnnotationPredicates,1,0,0,1,0,0,0,0,2
lesaint_damapping.fr.javatronic.damapping.processor.model.predicate.DAInterfacePredicates,1,0,0,1,0,0,0,0,2
lesaint_damapping.fr.javatronic.damapping.processor.model.DAType,1,0,0,1,0,0,0,0,2
lesaint_damapping.fr.javatronic.damapping.processor.sourcegenerator.imports.DATypeImportComputer,2,0,0,1,0,0,0,0,3
lesaint_damapping.fr.javatronic.damapping.processor.sourcegenerator.imports.ImportListBuilder,3,0,0,2,0,0,0,1,6
lesaint_damapping.fr.javatronic.damapping.processor.sourcegenerator.writer.DAClassWriter,1,0,0,1,0,0,0,0,2
lesaint_damapping.fr.javatronic.damapping.processor.sourcegenerator.writer.DAFileWriter,0,0,0,0,0,0,0,0,0
lesaint_damapping.fr.javatronic.damapping.processor.model.impl.DAParameterImpl,0,0,0,0,0,0,0,0,0
lesaint_damapping.fr.javatronic.damapping.processor.sourcegenerator.writer.DAClassMethodWriter,0,0,0,0,0,0,0,0,0
lesaint_damapping.fr.javatronic.damapping.processor.sourcegenerator.writer.DAStatementWriter,0,0,0,0,0,0,0,0,0
lesaint_damapping.fr.javatronic.damapping.processor.sourcegenerator.writer.DAInterfaceMethodWriter,0,0,0,0,0,0,0,0,0
manuzhang_storm-benchmark.storm.benchmark.tools.producer.kafka.KafkaProducer,0,0,0,0,0,0,0,0,0
manuzhang_storm-benchmark.storm.benchmark.tools.FileReader,1,0,0,0,0,0,0,1,2
manuzhang_storm-benchmark.storm.benchmark.tools.PageViewGenerator,0,0,0,0,0,0,0,1,1
manuzhang_storm-benchmark.storm.benchmark.util.TupleHelpers,1,0,0,0,0,0,0,0,1
manuzhang_storm-benchmark.storm.benchmark.util.FileUtils,2,0,0,0,0,0,0,0,2
manuzhang_storm-benchmark.storm.benchmark.util.MetricsUtils,2,0,0,0,0,0,0,0,2
manuzhang_storm-benchmark.storm.benchmark.util.BenchmarkUtils,2,0,0,0,0,0,0,0,2
manuzhang_storm-benchmark.storm.benchmark.api.IApplication,0,0,0,0,0,0,0,0,0
manuzhang_storm-benchmark.storm.benchmark.lib.reducer.SetReducer,0,0,0,0,0,0,0,0,0
manuzhang_storm-benchmark.storm.benchmark.lib.reducer.LongSummer,1,0,0,0,0,0,0,0,1
manuzhang_storm-benchmark.storm.benchmark.lib.bolt.ConstBolt,0,0,0,0,0,0,0,2,2
manuzhang_storm-benchmark.storm.benchmark.lib.bolt.FilterBolt,0,0,0,0,0,0,0,3,3
manuzhang_storm-benchmark.storm.benchmark.lib.operation.Distinct,0,0,0,0,0,0,0,0,0
manuzhang_storm-benchmark.storm.benchmark.lib.operation.One,0,0,0,0,0,0,0,0,0
manuzhang_storm-benchmark.storm.benchmark.lib.spout.RandomMessageSpout,0,0,0,0,0,0,0,3,3
manuzhang_storm-benchmark.storm.benchmark.lib.spout.FileReadSpout,0,0,0,0,0,0,0,3,3
manuzhang_storm-benchmark.storm.benchmark.lib.spout.TridentFileReadSpout,2,0,0,2,0,0,0,0,4
manuzhang_storm-benchmark.storm.benchmark.lib.spout.pageview.PageViewSpout,0,0,0,0,0,0,0,3,3
manuzhang_storm-benchmark.storm.benchmark.lib.spout.pageview.PageView,1,0,0,1,0,0,0,0,2
rmagen_elastic-gremlin.org.elasticgremlin.queryhandler.elasticsearch.helpers.TimingAccessor,0,0,0,0,0,0,0,1,1
openhab_openhab2.org.openhab.binding.astro.internal.handler.AstroThingHandler,0,0,0,0,0,0,0,1,1
openhab_openhab2.org.openhab.binding.mqtt.generic.tools.WaitForTopicValue,0,0,0,0,0,0,0,0,0
openhab_openhab2.org.openhab.binding.mqtt.homie.internal.homie300.Property,1,0,0,1,0,0,0,0,2
openhab_openhab2.org.openhab.binding.mqtt.homie.internal.homie300.Device,4,1,0,4,0,0,0,1,10
openhab_openhab2.org.openhab.binding.systeminfo.internal.SysteminfoHandlerFactory,0,0,0,0,0,0,0,0,0
openhab_openhab2.org.openhab.binding.systeminfo.internal.model.SysteminfoInterface,0,0,0,0,0,0,0,45,45
openhab_openhab2.org.openhab.binding.systeminfo.internal.handler.SysteminfoHandler,1,0,0,0,0,1,0,0,2
openhab_openhab2.org.openhab.binding.mielecloud.internal.webservice.api.DeviceState,66,0,0,66,0,0,0,0,132
openhab_openhab2.org.openhab.binding.mielecloud.internal.webservice.api.ActionsState,18,0,0,18,0,0,0,0,36
openhab_openhab2.org.openhab.binding.mielecloud.internal.handler.AbstractMieleThingHandler,1,0,0,0,0,0,0,20,21
openhab_openhab2.org.openhab.binding.mielecloud.internal.handler.MieleBridgeHandler,1,0,0,1,0,0,0,19,21
openhab_openhab2.org.openhab.binding.mielecloud.internal.util.OpenHabOsgiTest,0,0,0,0,0,0,0,2,2
openhab_openhab2.org.openhab.binding.mielecloud.internal.discovery.ThingDiscoveryService,6,0,0,1,0,0,0,0,7
openhab_openhab2.org.openhab.binding.mielecloud.internal.webservice.api.json.DeviceIdentLabel,2,0,0,1,0,0,0,0,3
openhab_openhab2.org.openhab.binding.mielecloud.internal.config.MieleCloudConfigService,4,0,0,4,0,0,0,0,8
openhab_openhab2.org.openhab.binding.mielecloud.internal.util.Website,33,0,0,0,0,0,0,0,33
openhab_openhab2.org.openhab.binding.mielecloud.internal.util.ReflectionUtil,6,0,0,6,0,0,0,0,12
openhab_openhab2.org.openhab.binding.mielecloud.internal.webservice.language.LanguageProvider,2,0,0,2,0,0,0,0,4
openhab_openhab2.org.openhab.binding.mielecloud.internal.config.ThingsTemplateGenerator,0,0,0,0,0,0,0,0,0
openhab_openhab2.org.openhab.binding.mielecloud.internal.config.OAuthAuthorizationHandler,7,0,0,6,0,5,0,0,18
openhab_openhab2.org.openhab.binding.mielecloud.internal.util.LocaleValidator,0,0,0,0,0,0,0,0,0
openhab_openhab2.org.openhab.persistence.mapdb.internal.MapDbPersistenceService,3,0,0,3,0,0,0,0,6
openhab_openhab2.org.openhab.binding.nest.internal.wwn.dto.WWNDevices,1,0,0,1,0,0,0,0,2
openhab_openhab2.org.openhab.binding.nest.internal.wwn.dto.WWNTopLevelStreamingData,1,0,0,1,0,0,0,0,2
openhab_openhab2.org.openhab.binding.nest.internal.wwn.dto.BaseWWNDevice,3,0,0,3,0,0,0,0,6
openhab_openhab2.org.openhab.binding.nest.internal.wwn.dto.WWNThermostat,1,0,0,0,0,0,0,0,1
openhab_openhab2.org.openhab.binding.nest.internal.wwn.dto.WWNAccessTokenData,1,0,0,1,0,0,0,0,2
openhab_openhab2.org.openhab.binding.nest.internal.wwn.dto.WWNStructure,1,0,0,1,0,0,0,0,2
openhab_openhab2.org.openhab.binding.nest.internal.wwn.dto.WWNErrorData,1,0,0,1,0,0,0,0,2
openhab_openhab2.org.openhab.binding.nest.internal.wwn.handler.WWNThingHandlerOSGiTest,17,0,0,17,0,0,0,5,39
openhab_openhab2.org.openhab.binding.hue.internal.HueObject,1,0,0,1,0,0,0,0,2
openhab_openhab2.org.openhab.binding.hue.internal.discovery.HueDeviceDiscoveryService,1,0,0,0,0,0,0,0,1
openhab_openhab2.org.openhab.binding.hue.internal.ApiVersion,2,0,0,1,0,0,0,0,3
openhab_openhab2.org.openhab.binding.hue.internal.handler.LightStateConverter,10,0,0,8,0,0,0,0,18
openhab_openhab2.org.openhab.binding.hue.internal.Scene,3,0,0,0,0,0,0,0,3
openhab_openhab2.org.openhab.binding.hue.internal.HueBridge,2,0,0,2,0,0,0,0,4
openhab_openhab2.org.openhab.binding.hue.internal.handler.HueBridgeHandler,4,0,0,0,0,3,0,0,7
openhab_openhab2.org.openhab.binding.hue.internal.discovery.HueBridgeNupnpDiscovery,2,0,0,0,0,0,0,0,2
openhab_openhab2.org.openhab.binding.mqtt.homeassistant.MqttOSGiTest,0,0,0,0,0,0,0,1,1
openhab_openhab2.org.openhab.binding.mqtt.homeassistant.internal.component.AbstractComponent,2,0,0,2,0,0,0,0,4
openhab_openhab2.org.openhab.binding.mqtt.homeassistant.internal.DiscoverComponents,0,0,0,0,0,0,0,1,1
openhab_openhab2.org.openhab.binding.modbus.tests.AbstractModbusOSGiTest,11,0,0,3,0,0,0,3,17
openhab_openhab2.org.openhab.binding.modbus.handler.ModbusPollerThingHandler,8,0,0,8,0,0,0,0,16
openhab_openhab2.org.openhab.binding.modbus.internal.handler.ModbusTcpThingHandler,1,0,0,1,0,0,0,0,2
openhab_openhab2.org.openhab.binding.modbus.internal.handler.ModbusDataThingHandler,0,0,0,0,0,0,0,0,0
openhab_openhab2.org.openhab.binding.avmfritz.internal.dto.DeviceListModel,18,0,0,18,0,0,0,0,36
openhab_openhab2.org.openhab.binding.tradfri.internal.discovery.TradfriDiscoveryService,8,0,0,0,0,0,0,0,8
openhab_openhab2.org.openhab.binding.wemo.internal.test.GenericWemoOSGiTest,5,0,0,4,0,0,0,0,9
openhab_openhab2.org.openhab.binding.wemo.internal.discovery.WemoLinkDiscoveryService,0,0,0,0,0,0,0,0,0
openhab_openhab2.org.openhab.binding.deconz.internal.handler.LightThingHandler,0,0,0,0,0,0,0,1,1
openhab_openhab2.org.openhab.binding.deconz.internal.handler.SensorBaseThingHandler,0,0,0,0,0,0,0,0,0
openhab_openhab2.org.openhab.binding.deconz.internal.discovery.ThingDiscoveryService,1,0,0,1,0,0,0,0,2
openhab_openhab2.org.openhab.binding.deconz.internal.Util,1,0,0,0,0,0,0,0,1
openhab_openhab2.org.openhab.binding.pushsafer.internal.actions.PushsaferActions,0,0,0,0,0,0,0,0,0
openhab_openhab2.org.openhab.io.hueemulation.internal.ConfigStore,10,0,0,5,0,0,0,0,15
openhab_openhab2.org.openhab.io.hueemulation.internal.dto.HueStateColorBulb,1,0,0,0,0,0,0,0,1
openhab_openhab2.org.openhab.io.hueemulation.internal.RuleUtils,7,0,0,2,0,0,0,0,9
openhab_openhab2.org.openhab.io.hueemulation.internal.rest.Scenes,2,0,0,0,0,0,0,0,2
openhab_openhab2.org.openhab.io.hueemulation.internal.automation.HueRuleConditionHandler,2,0,0,0,0,0,0,0,2
openhab_openhab2.org.openhab.io.hueemulation.internal.upnp.UpnpServer,2,0,0,2,0,1,0,0,5
openhab_openhab2.org.openhab.binding.nibeheatpump.internal.models.VariableInformation,4,0,0,0,0,0,0,0,4
openhab_openhab2.org.openhab.binding.nibeheatpump.internal.protocol.NibeHeatPumpProtocolContext,1,0,0,1,0,0,0,0,2
openhab_openhab2.org.openhab.binding.nibeheatpump.internal.message.ModbusWriteResponseMessage,0,0,0,0,0,0,0,0,0
openhab_openhab2.org.openhab.binding.nibeheatpump.internal.message.ModbusDataReadOutMessage,0,0,0,0,0,0,0,0,0
openhab_openhab2.org.openhab.binding.nibeheatpump.internal.message.ModbusReadResponseMessage,2,0,0,2,0,0,0,0,4
openhab_openhab2.org.openhab.binding.nibeheatpump.internal.message.ModbusWriteRequestMessage,1,0,0,1,0,0,0,0,2
openhab_openhab2.org.openhab.binding.nibeheatpump.internal.message.ModbusReadRequestMessage,0,0,0,0,0,0,0,0,0
openhab_openhab2.org.openhab.binding.mielecloud.internal.webservice.MieleWebserviceConfiguration,1,0,0,1,0,0,0,0,2
openhab_openhab2.org.openhab.binding.mielecloud.internal.webservice.DefaultMieleWebservice,0,0,0,0,0,0,0,17,17
openhab_openhab2.org.openhab.binding.mielecloud.internal.webservice.request.RequestFactoryImpl,1,0,0,0,0,0,0,0,1
openhab_openhab2.org.openhab.binding.mielecloud.internal.webservice.HttpUtil,0,0,0,0,0,1,0,0,1
openhab_openhab2.org.openhab.binding.mielecloud.internal.webservice.DeviceStateDispatcher,0,0,0,0,0,0,0,9,9
openhab_openhab2.org.openhab.binding.mielecloud.internal.webservice.DeviceCache,2,0,0,2,0,0,0,0,4
openhab_openhab2.org.openhab.binding.mielecloud.internal.webservice.exception.TooManyRequestsException,0,0,0,0,0,0,0,0,0
openhab_openhab2.org.openhab.binding.mielecloud.internal.webservice.api.WineStorageDeviceTemperatureState,24,0,0,24,0,0,0,0,48
openhab_openhab2.org.openhab.binding.mielecloud.internal.webservice.api.TransitionState,9,0,0,9,0,0,0,0,18
openhab_openhab2.org.openhab.binding.mielecloud.internal.webservice.api.CoolingDeviceTemperatureState,6,0,0,6,0,0,0,0,12
openhab_openhab2.org.openhab.binding.mielecloud.internal.webservice.api.json.ErrorMessage,0,0,0,0,0,0,0,0,0
openhab_openhab2.org.openhab.binding.mielecloud.internal.webservice.api.json.State,2,0,0,0,0,0,0,0,2
openhab_openhab2.org.openhab.binding.mielecloud.internal.webservice.api.json.Type,2,0,0,2,0,0,0,0,4
openhab_openhab2.org.openhab.binding.mielecloud.internal.webservice.api.json.DeviceCollection,4,0,0,4,0,0,0,0,8
openhab_openhab2.org.openhab.binding.mielecloud.internal.webservice.api.json.ActionsCollection,1,0,0,1,0,0,0,0,2
openhab_openhab2.org.openhab.binding.mielecloud.internal.webservice.api.json.Actions,2,0,0,0,0,0,0,0,2
openhab_openhab2.org.openhab.binding.mielecloud.internal.webservice.api.json.Status,2,0,0,2,0,0,0,0,4
openhab_openhab2.org.openhab.binding.mielecloud.internal.webservice.sse.SseStreamParser,0,0,0,0,0,0,0,8,8
openhab_openhab2.org.openhab.binding.mielecloud.internal.webservice.sse.SseConnection,1,0,0,1,0,0,0,5,7
openhab_openhab2.org.openhab.binding.mielecloud.internal.webservice.sse.ExponentialBackoffWithJitter,0,0,0,0,0,0,0,0,0
openhab_openhab2.org.openhab.binding.mielecloud.internal.auth.OpenHabOAuthTokenRefresher,0,0,0,0,0,4,0,2,6
openhab_openhab2.org.openhab.binding.velux.internal.things.VeluxExistingProducts,1,0,0,1,0,0,0,0,2
openhab_openhab2.org.openhab.binding.velux.internal.things.VeluxProduct,11,0,0,11,0,0,0,0,22
openhab_openhab2.org.openhab.binding.velux.internal.bridge.slip.SCgetProduct,2,0,0,2,0,0,0,0,4
openhab_openhab2.org.openhab.binding.velux.internal.bridge.slip.SCgetProductStatus,2,0,0,2,0,0,0,0,4
openhab_openhab2.org.openhab.binding.velux.internal.bridge.slip.SCgetHouseStatus,2,0,0,2,0,0,0,0,4
openhab_openhab2.org.openhab.binding.velux.internal.things.VeluxProductPosition,1,0,0,1,0,0,0,0,2
openhab_openhab2.org.openhab.binding.homematic.internal.type.UidUtils,1,0,0,1,0,0,0,0,2
openhab_openhab2.org.openhab.binding.homematic.internal.model.HmDatapoint,3,0,0,0,0,0,0,0,3
openhab_openhab2.org.openhab.binding.homematic.internal.communicator.message.RpcRequest,0,0,0,0,0,0,0,0,0
openhab_openhab2.org.openhab.binding.homematic.internal.handler.SimplePortPool,0,0,0,0,0,0,0,0,0
openhab_openhab2.org.openhab.binding.homematic.internal.discovery.HomematicDeviceDiscoveryService,0,0,0,0,0,0,0,1,1
openhab_openhab2.org.openhab.binding.homematic.internal.handler.HomematicBridgeHandler,0,0,0,0,0,0,0,3,3
openhab_openhab2.org.openhab.binding.homematic.internal.converter.TypeConverter,2,0,0,0,0,0,0,0,2
openhab_openhab2.org.openhab.binding.homematic.internal.converter.ConverterFactory,3,0,0,2,0,0,0,0,5
openhab_openhab2.org.openhab.binding.boschindego.internal.DeviceStatus,0,0,0,0,0,0,0,0,0
openhab_openhab2.org.openhab.binding.doorbird.internal.api.DoorbirdInfo,2,0,0,2,0,0,0,0,4
openhab_openhab2.org.openhab.binding.doorbird.internal.api.SipStatus,1,0,0,1,0,0,0,0,2
openhab_openhab2.org.openhab.binding.groupepsa.internal.things.GroupePSAHandler,0,0,0,0,0,0,0,1,1
openhab_openhab2.org.openhab.binding.fsinternetradio.internal.handler.FSInternetRadioHandler,5,0,0,0,0,0,0,1,6
openhab_openhab2.org.openhab.binding.mqtt.homie.internal.handler.HomieThingHandler,0,0,0,0,0,0,0,1,1
openhab_openhab2.org.openhab.binding.mqtt.generic.tools.ChildMap,1,0,0,0,0,0,0,0,1
openhab_openhab2.org.openhab.binding.surepetcare.internal.dto.SurePetcareDeviceCurfewList,3,0,0,2,0,0,0,0,5
openhab_openhab2.org.openhab.binding.surepetcare.internal.dto.SurePetcareDevice,2,2,0,0,0,0,0,0,4
openhab_openhab2.org.openhab.binding.modbus.e3dc.internal.handler.E3DCThingHandler,0,0,0,0,0,0,0,1,1
openhab_openhab2.org.openhab.binding.modbus.e3dc.internal.modbus.Parser,8,0,0,2,0,0,0,0,10
openhab_openhab2.org.openhab.binding.modbus.e3dc.internal.dto.DataConverter,1,0,0,0,0,0,0,0,1
openhab_openhab2.org.openhab.binding.heos.internal.json.HeosJsonParser,9,0,0,7,0,0,0,0,16
openhab_openhab2.org.openhab.binding.heos.internal.json.dto.HeosObject,6,0,0,3,0,0,0,0,9
openhab_openhab2.org.openhab.binding.heos.internal.json.dto.HeosResponseObject,4,0,0,1,0,0,0,0,5
openhab_openhab2.org.openhab.binding.teleinfo.internal.reader.io.serialport.FrameUtil,1,2,0,0,0,0,0,0,3
openhab_openhab2.org.openhab.binding.teleinfo.internal.reader.io.TeleinfoInputStream,8,0,0,8,0,0,0,0,16
openhab_openhab2.org.openhab.binding.http.internal.http.Content,5,0,0,5,0,0,0,0,10
openhab_openhab2.org.openhab.binding.http.internal.transform.NoOpValueTransformation,2,0,0,2,0,0,0,0,4
openhab_openhab2.org.openhab.binding.http.internal.converter.GenericItemConverter,0,0,0,0,0,0,0,0,0
openhab_openhab2.org.openhab.transform.scale.internal.ScaleTransformationService,2,0,0,0,0,0,0,0,2
openhab_openhab2.org.openhab.binding.bluetooth.bluegiga.internal.eir.EirRecord,7,0,0,7,0,0,0,0,14
openhab_openhab2.org.openhab.binding.bluetooth.bluegiga.internal.command.attributeclient.BlueGigaFindInformationFoundEvent,3,0,0,3,0,0,0,0,6
openhab_openhab2.org.openhab.binding.bsblan.internal.helper.BsbLanParameterConverter,9,0,0,0,0,0,0,0,9
openhab_openhab2.org.openhab.binding.bsblan.internal.BsbLanHandlerFactory,1,0,0,0,0,0,0,0,1
openhab_openhab2.org.openhab.binding.bsblan.internal.api.BsbLanApiContentConverter,1,0,0,0,0,0,0,0,1
openhab_openhab2.org.openhab.binding.sleepiq.api.model.BedSideStatus,1,0,0,1,0,0,0,0,2
openhab_openhab2.org.openhab.binding.sleepiq.api.model.PauseMode,1,0,0,1,0,0,0,0,2
openhab_openhab2.org.openhab.binding.sleepiq.api.model.TimeSince,3,0,0,3,0,0,0,0,6
openhab_openhab2.org.openhab.binding.sleepiq.api.model.SleepersResponse,1,0,0,1,0,0,0,0,2
openhab_openhab2.org.openhab.binding.sleepiq.api.model.FamilyStatus,1,0,0,1,0,0,0,0,2
openhab_openhab2.org.openhab.binding.sleepiq.api.model.Bed,1,0,0,1,0,0,0,0,2
openhab_openhab2.org.openhab.binding.sleepiq.api.model.BedsResponse,1,0,0,1,0,0,0,0,2
openhab_openhab2.org.openhab.binding.sleepiq.api.model.Sleeper,1,0,0,1,0,0,0,0,2
openhab_openhab2.org.openhab.binding.sleepiq.api.model.BedStatus,1,0,0,1,0,0,0,0,2
openhab_openhab2.org.openhab.binding.pushover.internal.actions.PushoverActions,0,0,0,0,0,0,0,0,0
openhab_openhab2.org.openhab.binding.digitalstrom.internal.lib.util.DSJsonParser,0,0,0,0,0,0,0,0,0
openhab_openhab2.org.openhab.binding.digitalstrom.internal.lib.structure.devices.impl.DeviceImpl,0,0,0,0,0,0,0,0,0
openhab_openhab2.org.openhab.binding.rfxcom.internal.handler.RFXComHandler,0,0,0,0,0,0,0,5,5
openhab_openhab2.org.openhab.binding.rfxcom.internal.messages.RFXComSecurity2Message,1,0,0,1,0,0,0,0,2
openhab_openhab2.org.openhab.binding.rfxcom.internal.messages.RFXComThermostat3Message,16,0,0,16,0,0,0,0,32
openhab_openhab2.org.openhab.binding.rfxcom.internal.messages.RFXComLighting2Message,1,0,0,1,0,0,0,0,2
openhab_openhab2.org.openhab.binding.rfxcom.internal.messages.RFXComWindMessage,1,0,0,1,0,0,0,0,2
openhab_openhab2.org.openhab.binding.rfxcom.internal.messages.RFXComLighting1Message,4,0,0,4,0,0,0,0,8
openhab_openhab2.org.openhab.binding.rfxcom.internal.messages.RFXComLighting5Message,4,0,0,4,0,0,0,0,8
openhab_openhab2.org.openhab.binding.rfxcom.internal.messages.RFXComLighting6Message,1,0,0,1,0,0,0,0,2
openhab_openhab2.org.openhab.binding.rfxcom.internal.messages.RFXComEnergyMessage,1,0,0,1,0,0,0,0,2
openhab_openhab2.org.openhab.binding.rfxcom.internal.messages.RFXComHumidityMessage,1,0,0,1,0,0,0,0,2
openhab_openhab2.org.openhab.binding.rfxcom.internal.messages.RFXComBBQTemperatureMessage,1,0,0,1,0,0,0,0,2
openhab_openhab2.org.openhab.binding.rfxcom.internal.messages.RFXComTemperatureRainMessage,1,0,0,1,0,0,0,0,2
openhab_openhab2.org.openhab.binding.rfxcom.internal.messages.RFXComChimeMessage,1,0,0,1,0,0,0,0,2
openhab_openhab2.org.openhab.binding.rfxcom.internal.messages.RFXComTemperatureHumidityBarometricMessage,1,0,0,1,0,0,0,0,2
openhab_openhab2.org.openhab.binding.rfxcom.internal.messages.RFXComCurrentMessage,1,0,0,1,0,0,0,0,2
openhab_openhab2.org.openhab.binding.rfxcom.internal.messages.RFXComUVMessage,2,0,0,2,0,0,0,0,4
openhab_openhab2.org.openhab.binding.rfxcom.internal.messages.RFXComRainMessage,1,0,0,1,0,0,0,0,2
openhab_openhab2.org.openhab.binding.rfxcom.internal.messages.RFXComThermostat1Message,1,0,0,1,0,0,0,0,2
openhab_openhab2.org.openhab.binding.rfxcom.internal.messages.RFXComDateTimeMessage,1,0,0,1,0,0,0,0,2
openhab_openhab2.org.openhab.binding.rfxcom.internal.messages.RFXComLighting4Message,0,0,0,0,0,0,0,0,0
openhab_openhab2.org.openhab.binding.siemensrds.internal.RdsDataPoints,3,1,0,3,0,2,0,0,9
openhab_openhab2.org.openhab.binding.siemensrds.internal.RdsAccessToken,1,0,0,1,0,1,0,0,3
openhab_openhab2.org.openhab.binding.siemensrds.internal.RdsPlants,1,0,0,1,0,1,0,0,3
openhab_openhab2.org.openhab.binding.max.internal.command.CubeCommand,0,0,0,0,0,0,0,0,0
openhab_openhab2.org.openhab.binding.max.internal.command.FCommand,2,0,0,0,0,0,0,0,2
openhab_openhab2.org.openhab.binding.max.internal.command.TCommand,2,0,0,1,0,0,0,0,3
openhab_openhab2.org.openhab.binding.max.internal.command.ZCommand,3,0,0,3,0,0,0,0,6
openhab_openhab2.org.openhab.binding.max.internal.command.MCommand,1,0,0,1,0,0,0,0,2
openhab_openhab2.org.openhab.binding.max.internal.command.SCommand,1,0,0,0,0,0,0,0,1
openhab_openhab2.org.openhab.binding.max.internal.message.Message,0,0,0,0,0,0,0,0,0
openhab_openhab2.org.openhab.binding.max.internal.message.LMessage,1,0,0,1,0,0,0,0,2
openhab_openhab2.org.openhab.binding.max.internal.message.HMessage,0,0,0,0,0,0,0,0,0
openhab_openhab2.org.openhab.binding.max.internal.Utils,6,0,0,1,0,0,0,0,7
openhab_openhab2.org.openhab.binding.max.internal.message.FMessage,0,0,0,0,0,0,0,0,0
openhab_openhab2.org.openhab.binding.max.internal.message.MessageProcessor,5,0,0,2,0,0,0,0,7
openhab_openhab2.org.openhab.binding.max.internal.message.SMessage,3,0,0,1,0,0,0,0,4
openhab_openhab2.org.openhab.binding.max.internal.message.CMessage,0,0,0,0,0,0,0,0,0
openhab_openhab2.org.openhab.binding.max.internal.message.NMessage,0,0,0,0,0,0,0,0,0
openhab_openhab2.org.openhab.binding.max.internal.device.DeviceInformation,1,0,0,1,0,0,0,0,2
openhab_openhab2.org.openhab.binding.max.internal.device.RoomInformation,1,0,0,0,0,0,0,0,1
openhab_openhab2.org.openhab.binding.max.internal.device.DeviceConfiguration,3,3,0,0,0,0,0,0,6
openhab_openhab2.org.openhab.binding.bluetooth.bluez.internal.events.BlueZEvent,7,0,0,7,0,0,0,0,14
openhab_openhab2.org.openhab.binding.yeelight.internal.lib.device.DeviceBase,0,0,0,0,0,0,0,0,0
openhab_openhab2.org.openhab.binding.irobot.internal.handler.RoombaHandler,1,0,0,1,0,0,0,3,5
openhab_openhab2.org.openhab.binding.semsportal.internal.dto.BaseResponse,4,4,0,4,0,0,0,0,12
openhab_openhab2.org.openhab.binding.smhi.internal.TimeSeries,1,0,0,1,0,0,0,0,2
openhab_openhab2.org.openhab.binding.smhi.internal.ForecastAggregator,1,0,0,1,0,0,0,0,2
openhab_openhab2.org.openhab.transform.regex.internal.RegExTransformationService,0,0,0,0,0,0,0,0,0
openhab_openhab2.org.openhab.binding.dwdunwetter.internal.dto.DwdWarningsData,11,0,0,0,0,0,0,0,11
openhab_openhab2.org.openhab.binding.dwdunwetter.internal.dto.DwdWarningCache,2,0,0,1,0,0,0,0,3
openhab_openhab2.org.openhab.binding.dsmr.internal.device.SmartyDecrypter,0,0,0,0,0,0,0,0,0
openhab_openhab2.org.openhab.binding.dsmr.internal.device.DSMRSerialAutoDevice,2,0,0,2,0,0,0,0,4
openhab_openhab2.org.openhab.binding.dsmr.internal.discovery.DSMRMeterDiscoveryService,1,0,0,1,0,0,0,0,2
openhab_openhab2.org.openhab.binding.modbus.internal.CascadedValueTransformationImpl,6,0,0,6,0,0,0,0,12
openhab_openhab2.org.openhab.binding.modbus.internal.AtomicStampedValue,8,0,0,7,0,0,0,0,15
openhab_openhab2.org.openhab.binding.modbus.internal.SingleValueTransformation,4,0,0,4,0,0,0,0,8
openhab_openhab2.org.openhab.binding.modbus.internal.profiles.ModbusGainOffsetProfile,0,0,0,0,0,0,0,1,1
openhab_openhab2.org.openhab.binding.fmiweather.internal.client.FMIResponse,9,0,0,1,0,0,0,0,10
openhab_openhab2.org.openhab.binding.fmiweather.internal.client.Request,0,0,0,0,0,0,0,0,0
openhab_openhab2.org.openhab.binding.mqtt.handler.BrokerHandler,0,0,0,0,0,0,0,1,1
openhab_openhab2.org.openhab.binding.mqtt.internal.MqttBrokerHandlerFactory,0,0,0,0,0,0,0,0,0
openhab_openhab2.org.openhab.binding.mqtt.internal.ssl.PinTrustManager,1,0,0,1,0,0,0,2,4
openhab_openhab2.org.openhab.binding.mqtt.internal.ssl.PinMessageDigest,2,0,0,2,0,0,0,0,4
openhab_openhab2.org.openhab.transform.jsonpath.internal.JSonPathTransformationService,0,0,0,0,0,0,0,0,0
openhab_openhab2.org.openhab.binding.icalendar.internal.logic.AbstractPresentableCalendar,5,1,0,2,0,0,0,0,8
openhab_openhab2.org.openhab.binding.networkupstools.internal.nut.NutApi,2,0,0,0,0,0,0,0,2
openhab_openhab2.org.openhab.binding.lifx.internal.fields.MACAddress,6,0,0,4,0,0,0,0,10
openhab_openhab2.org.openhab.binding.sensibo.internal.model.SensiboSky,0,0,0,0,0,0,0,0,0
openhab_openhab2.org.openhab.binding.sensibo.internal.dto.poddetails.PodDetailsDTO,1,0,0,0,0,0,0,0,1
openhab_openhab2.org.openhab.binding.sensibo.internal.handler.SensiboSkyHandler,1,0,0,0,0,0,0,0,1
openhab_openhab2.org.openhab.binding.dmx.internal.multiverse.BaseDmxChannel,4,0,0,3,0,0,0,0,7
openhab_openhab2.org.openhab.binding.dmx.internal.multiverse.DmxChannel,5,0,0,5,0,0,0,0,10
openhab_openhab2.org.openhab.binding.dmx.internal.Util,3,0,0,0,0,0,0,0,3
openhab_openhab2.org.openhab.binding.dmx.internal.ValueSet,4,0,0,4,0,0,0,0,8
openhab_openhab2.org.openhab.binding.dmx.internal.action.FadeAction,6,0,0,6,0,0,0,0,12
openhab_openhab2.org.openhab.binding.dmx.internal.handler.TunableWhiteThingHandler,3,0,0,0,0,0,0,0,3
openhab_openhab2.org.openhab.binding.dmx.internal.handler.ChaserThingHandler,3,0,0,0,0,0,0,0,3
openhab_openhab2.org.openhab.binding.dmx.internal.DmxBridgeHandler,0,0,0,0,0,0,0,1,1
openhab_openhab2.org.openhab.binding.dmx.internal.handler.ColorThingHandler,3,0,0,0,0,0,0,0,3
openhab_openhab2.org.openhab.binding.dmx.internal.handler.DimmerThingHandler,2,0,0,0,0,0,0,0,2
openhab_openhab2.org.openhab.binding.freebox.internal.api.FreeboxApiManager,0,0,0,0,0,0,0,0,0
openhab_openhab2.org.openhab.binding.mycroft.internal.api.MycroftConnection,0,0,0,0,0,0,0,1,1
openhab_openhab2.org.openhab.binding.network.internal.toberemoved.cache.ExpiringCacheAsync,3,0,0,1,0,0,0,0,4
openhab_openhab2.org.openhab.binding.network.internal.utils.LatencyParser,2,0,0,0,0,0,0,0,2
openhab_openhab2.org.openhab.binding.network.internal.dhcp.DHCPListenService,1,0,0,1,0,0,0,0,2
openhab_openhab2.org.openhab.binding.network.internal.dhcp.DHCPPacketListenerServer,0,0,0,0,0,0,0,1,1
openhab_openhab2.org.openhab.binding.network.internal.handler.NetworkHandler,2,0,0,2,0,0,0,0,4
openhab_openhab2.org.openhab.binding.network.internal.PresenceDetectionValue,6,0,0,6,0,0,0,0,12
openhab_openhab2.org.openhab.binding.network.internal.WakeOnLanPacketSender,0,0,0,0,0,0,0,3,3
openhab_openhab2.org.openhab.binding.network.internal.PresenceDetection,4,0,0,4,0,0,0,0,8
openhab_openhab2.org.openhab.binding.tplinksmarthome.internal.CryptUtil,0,0,0,0,0,0,0,0,0
openhab_openhab2.org.openhab.binding.tplinksmarthome.internal.handler.SmartHomeHandler,0,0,0,0,0,0,0,3,3
openhab_openhab2.org.openhab.binding.millheat.internal.handler.MillheatAccountHandler,0,0,0,0,0,0,0,0,0
openhab_openhab2.org.openhab.transform.xslt.internal.XsltTransformationService,0,0,0,0,0,0,0,0,0
openhab_openhab2.org.openhab.binding.miio.internal.basic.MiIoDeviceActionCondition,1,0,0,1,0,0,0,0,2
openhab_openhab2.org.openhab.binding.miio.internal.Utils,2,0,0,1,0,0,0,0,3
openhab_openhab2.org.openhab.binding.miio.internal.basic.Conversions,2,0,0,0,0,0,0,0,2
openhab_openhab2.org.openhab.binding.upb.internal.message.UPBMessage,1,0,0,1,0,0,0,0,2
openhab_openhab2.org.openhab.binding.upb.internal.handler.SerialIoThread,3,0,0,3,0,0,0,0,6
openhab_openhab2.org.openhab.binding.upb.internal.message.MessageBuilder,0,0,0,0,0,0,0,0,0
openhab_openhab2.org.openhab.binding.bluetooth.enoceanble.internal.EnoceanBlePtm215Event,8,0,0,8,0,0,0,0,16
openhab_openhab2.org.openhab.binding.nanoleaf.internal.model.TouchEvents,1,0,0,1,0,0,0,0,2
openhab_openhab2.org.openhab.binding.nanoleaf.internal.OpenAPIUtils,1,0,0,0,0,0,0,0,1
openhab_openhab2.org.openhab.binding.nanoleaf.internal.model.Write,1,0,0,1,0,0,0,0,2
openhab_openhab2.org.openhab.binding.nanoleaf.internal.model.ControllerInfo,3,3,0,3,0,0,0,0,9
openhab_openhab2.org.openhab.binding.ihc.internal.ButtonPressDurationDetector,4,0,0,4,0,0,0,0,8
openhab_openhab2.org.openhab.binding.ihc.internal.SignalLevelConverter,1,0,0,0,0,0,0,0,1
openhab_openhab2.org.openhab.binding.ihc.internal.ws.IhcClient,0,0,0,0,0,0,0,0,0
openhab_openhab2.org.openhab.binding.ihc.internal.ws.services.IhcTimeService,1,0,0,1,0,0,0,0,2
openhab_openhab2.org.openhab.binding.ihc.internal.ws.services.IhcAirlinkManagementService,1,0,0,1,0,0,0,0,2
openhab_openhab2.org.openhab.binding.ihc.internal.ws.services.IhcResourceInteractionService,9,0,0,0,0,0,0,0,9
openhab_openhab2.org.openhab.binding.ihc.internal.ws.services.IhcAuthenticationService,2,0,0,2,0,0,0,0,4
openhab_openhab2.org.openhab.binding.ihc.internal.ws.services.IhcControllerService,0,0,0,0,0,0,0,0,0
openhab_openhab2.org.openhab.binding.ihc.internal.ws.services.IhcConfigurationService,2,0,0,2,0,0,0,0,4
openhab_openhab2.org.openhab.binding.hdpowerview.internal.database.ShadeCapabilitiesDatabase,3,0,0,2,0,0,0,0,5
openhab_openhab2.org.openhab.binding.hdpowerview.internal.builders.AutomationChannelBuilder,9,0,0,9,0,0,0,0,18
openhab_openhab2.org.openhab.binding.hdpowerview.internal.api.ShadePosition,2,0,0,2,0,0,0,1,5
openhab_openhab2.org.openhab.binding.hdpowerview.internal.builders.SceneGroupChannelBuilder,4,0,0,4,0,0,0,0,8
openhab_openhab2.org.openhab.binding.hdpowerview.internal.HDPowerViewWebTargets,1,1,0,1,0,1,0,0,4
openhab_openhab2.org.openhab.binding.hdpowerview.internal.builders.SceneChannelBuilder,4,0,0,4,0,0,0,0,8
openhab_openhab2.org.openhab.persistence.jdbc.db.JdbcBaseDAO,1,0,0,0,0,0,0,0,1
openhab_openhab2.org.openhab.binding.miele.internal.FullyQualifiedApplianceIdentifier,0,0,0,0,0,0,0,0,0
openhab_openhab2.org.openhab.binding.miele.internal.DeviceUtil,0,0,0,0,0,0,0,0,0
openhab_openhab2.org.openhab.binding.sonos.internal.SonosXMLParser,1,0,0,0,0,0,0,0,1
openhab_openhab2.org.openhab.binding.mcd.internal.handler.SensorThingHandler,1,0,0,0,0,0,0,0,1
openhab_openhab2.org.openhab.binding.mcd.internal.util.SensorEventDef,1,0,0,0,0,0,0,0,1
openhab_openhab2.org.openhab.binding.mikrotik.internal.util.Converter,2,0,0,1,0,0,0,0,3
openhab_openhab2.org.openhab.binding.openwebnet.internal.handler.OpenWebNetBridgeHandler,1,1,0,1,0,0,0,0,3
openhab_openhab2.org.openhab.binding.knx.internal.dpt.KNXCoreTypeMapper,9,0,0,0,0,0,0,0,9
openhab_openhab2.org.openhab.binding.knx.internal.channel.KNXChannelType,6,0,0,6,0,0,0,0,12
openhab_openhab2.org.openhab.binding.upnpcontrol.internal.queue.UpnpEntry,1,0,0,1,0,0,0,0,2
openhab_openhab2.org.openhab.binding.upnpcontrol.internal.handler.UpnpServerHandler,11,0,0,11,0,0,0,0,22
openhab_openhab2.org.openhab.binding.upnpcontrol.internal.handler.UpnpRendererHandler,1,0,0,1,0,0,0,12,14
openhab_openhab2.org.openhab.binding.astro.internal.calc.SunCalc,8,0,0,8,0,0,0,0,16
openhab_openhab2.org.openhab.binding.astro.internal.calc.SeasonCalc,0,0,0,0,0,0,0,2,2
openhab_openhab2.org.openhab.binding.astro.internal.util.DateTimeUtils,1,0,0,1,0,0,0,0,2
openhab_openhab2.org.openhab.binding.astro.internal.model.Sun,2,0,0,2,0,0,0,0,4
openhab_openhab2.org.openhab.binding.nest.internal.sdm.dto.SDMTraits,7,0,0,0,0,0,0,0,7
openhab_openhab2.org.openhab.transform.jinja.internal.JinjaTransformationService,0,0,0,0,0,0,0,0,0
openhab_openhab2.org.openhab.transform.javascript.internal.JavaScriptTransformationService,0,0,0,0,0,0,0,0,0
openhab_openhab2.org.openhab.binding.mqtt.homeassistant.internal.HaID,2,0,0,2,0,0,0,0,4
openhab_openhab2.org.openhab.binding.mqtt.homeassistant.internal.handler.HomeAssistantThingHandler,1,0,0,1,0,0,0,0,2
openhab_openhab2.org.openhab.binding.mqtt.homeassistant.internal.discovery.HomeAssistantDiscovery,1,0,0,0,0,0,0,0,1
openhab_openhab2.org.openhab.binding.mqtt.homeassistant.internal.config.dto.AbstractChannelConfiguration,5,4,0,5,0,0,0,0,14
openhab_openhab2.org.openhab.persistence.influxdb.internal.ItemToStorePointCreator,5,0,0,5,0,0,0,0,10
openhab_openhab2.org.openhab.persistence.influxdb.internal.influx1.Influx1FilterCriteriaQueryCreatorImpl,7,0,0,7,0,0,0,0,14
openhab_openhab2.org.openhab.persistence.influxdb.internal.influx2.Influx2FilterCriteriaQueryCreatorImpl,0,0,0,0,0,0,0,0,0
openhab_openhab2.org.openhab.persistence.influxdb.InfluxDBPersistenceService,0,0,0,0,0,0,0,6,6
openhab_openhab2.org.openhab.persistence.influxdb.internal.InfluxDBStateConvertUtils,2,0,0,0,0,0,0,0,2
openhab_openhab2.org.openhab.binding.danfossairunit.internal.DanfossAirUnit,0,0,0,0,0,0,0,0,0
openhab_openhab2.org.openhab.binding.danfossairunit.internal.CommunicationController,0,0,0,0,0,0,0,0,0
openhab_openhab2.org.openhab.binding.danfossairunit.internal.ValueCache,4,0,0,0,0,0,0,0,4
openhab_openhab2.org.openhab.voice.mactts.internal.MacTTSService,1,0,0,1,0,0,0,0,2
openhab_openhab2.org.openhab.voice.mactts.internal.MacTTSVoice,0,0,0,0,0,0,0,0,0
openhab_openhab2.org.openhab.binding.wundergroundupdatereceiver.internal.WundergroundUpdateReceiverHandler,1,0,0,1,0,0,0,0,2
openhab_openhab2.org.openhab.binding.wundergroundupdatereceiver.internal.WundergroundUpdateReceiverDiscoveryService,3,0,0,3,0,0,0,0,6
openhab_openhab2.org.openhab.binding.wundergroundupdatereceiver.internal.WundergroundUpdateReceiverServlet,5,0,0,5,0,0,0,2,12
openhab_openhab2.org.openhab.binding.onewire.internal.handler.OwBaseThingHandler,4,4,0,0,0,0,0,0,8
openhab_openhab2.org.openhab.binding.onewire.internal.handler.OwserverBridgeHandler,2,3,0,0,0,0,0,0,5
openhab_openhab2.org.openhab.binding.onewire.internal.device.DS1923,0,0,0,0,0,0,0,2,2
openhab_openhab2.org.openhab.binding.onewire.internal.device.DS2423,0,0,0,0,0,1,0,0,1
openhab_openhab2.org.openhab.binding.onewire.internal.device.DS18x20,0,0,0,0,0,0,0,2,2
openhab_openhab2.org.openhab.binding.onewire.internal.device.EDS006x,0,0,0,0,0,0,0,5,5
openhab_openhab2.org.openhab.binding.onewire.internal.device.BAE0910,2,0,0,2,0,0,0,0,4
openhab_openhab2.org.openhab.binding.onewire.internal.device.DS2438,0,0,0,0,0,0,0,7,7
openhab_openhab2.org.openhab.binding.onewire.internal.SensorId,4,0,0,3,0,0,0,0,7
openhab_openhab2.org.openhab.binding.onewire.internal.Util,0,0,0,0,0,0,0,0,0
openhab_openhab2.org.openhab.binding.onewire.internal.owserver.OwserverDeviceParameter,1,0,0,0,0,0,0,0,1
openhab_openhab2.org.openhab.binding.onewire.internal.owserver.OwserverConnection,5,8,0,3,0,0,0,0,16
openhab_openhab2.org.openhab.binding.vdr.internal.svdrp.SVDRPVolume,1,0,0,1,0,0,0,0,2
openhab_openhab2.org.openhab.binding.vdr.internal.svdrp.SVDRPTimerList,1,0,0,1,0,0,0,0,2
openhab_openhab2.org.openhab.binding.vdr.internal.svdrp.SVDRPWelcome,1,0,0,1,0,0,0,0,2
openhab_openhab2.org.openhab.binding.vdr.internal.svdrp.SVDRPChannel,1,0,0,1,0,0,0,0,2
openhab_openhab2.org.openhab.binding.vdr.internal.svdrp.SVDRPDiskStatus,1,0,0,1,0,0,0,0,2
openhab_openhab2.org.openhab.binding.vdr.internal.svdrp.SVDRPEpgEvent,3,0,0,3,0,0,0,0,6
openhab_openhab2.org.openhab.binding.boschshc.internal.services.BoschSHCSystemService,0,0,0,0,0,0,0,0,0
openhab_openhab2.org.openhab.binding.boschshc.internal.services.AbstractBoschSHCService,0,0,0,0,0,0,0,0,0
openhab_openhab2.org.openhab.binding.boschshc.internal.services.BoschSHCService,0,0,0,0,0,0,0,2,2
openhab_openhab2.org.openhab.binding.boschshc.internal.devices.bridge.BoschHttpClient,0,0,0,0,0,0,0,1,1
openhab_openhab2.org.openhab.binding.boschshc.internal.devices.bridge.BoschSslUtil,2,1,0,1,0,0,0,0,4
openhab_openhab2.org.openhab.binding.enigma2.internal.Enigma2Client,9,0,0,9,0,0,0,12,30
openhab_openhab2.org.openhab.binding.enigma2.internal.Enigma2HandlerFactory,0,0,0,0,0,0,0,0,0
openhab_openhab2.org.openhab.binding.enigma2.internal.handler.Enigma2Handler,0,0,0,0,0,0,0,40,40
openhab_openhab2.org.openhab.binding.enigma2.internal.discovery.Enigma2DiscoveryParticipant,1,0,0,1,0,0,0,0,2
openhab_openhab2.org.openhab.binding.enigma2.internal.actions.Enigma2Actions,0,0,0,0,0,0,0,18,18
openhab_openhab2.org.openhab.binding.fineoffsetweatherstation.internal.service.FineOffsetDataParser,0,0,0,0,0,0,0,0,0
openhab_openhab2.org.openhab.binding.bluetooth.BluetoothCharacteristic,3,0,0,3,0,0,0,0,6
openhab_openhab2.org.openhab.binding.bluetooth.discovery.internal.BluetoothDiscoveryService,3,0,0,3,0,0,0,11,17
openhab_openhab2.org.openhab.binding.wemo.internal.InsightParser,3,0,0,0,0,0,0,0,3
openhab_openhab2.org.openhab.binding.wemo.internal.WemoPowerBank,0,0,0,0,0,0,0,0,0
openhab_openhab2.org.openhab.binding.tr064.internal.dto.config.ChannelTypeDescription,1,0,0,0,0,1,0,0,2
openhab_openhab2.org.openhab.binding.tradfri.internal.TradfriColor,8,0,0,0,0,0,0,0,8
openhab_openhab2.org.openhab.binding.tradfri.internal.model.TradfriVersion,4,0,0,0,0,0,0,0,4
openhab_openhab2.org.openhab.binding.luxom.internal.protocol.LuxomCommand,10,0,0,10,0,0,0,0,20
openhab_openhab2.org.openhab.binding.luxom.internal.handler.util.PercentageConverter,0,0,0,0,0,0,0,0,0
openhab_openhab2.org.openhab.binding.paradoxalarm.internal.communication.crypto.EncryptionHandler,1,0,0,1,0,0,0,0,2
openhab_openhab2.org.openhab.binding.paradoxalarm.internal.communication.messages.ParadoxIPPacket,0,0,0,0,0,0,0,0,0
openhab_openhab2.org.openhab.binding.paradoxalarm.internal.communication.messages.CommandPayload,0,0,0,0,0,0,0,0,0
openhab_openhab2.org.openhab.binding.paradoxalarm.internal.communication.messages.IPayload,0,0,0,0,0,0,0,1,1
openhab_openhab2.org.openhab.binding.paradoxalarm.internal.util.ParadoxUtil,0,0,0,0,0,0,0,0,0
openhab_openhab2.org.openhab.binding.neohub.internal.NeoHubWebSocket,0,1,0,0,0,0,0,0,1
openhab_openhab2.org.openhab.binding.neohub.internal.NeoHubSocket,0,1,0,0,0,0,0,0,1
openhab_openhab2.org.openhab.binding.neohub.internal.NeoHubInfoResponse,3,0,0,3,0,0,0,0,6
openhab_openhab2.org.openhab.binding.neohub.internal.NeoHubReadDcbResponse,3,0,0,3,0,0,0,0,6
openhab_openhab2.org.openhab.binding.neohub.internal.NeoHubLiveDeviceData,1,0,0,1,0,0,0,0,2
openhab_openhab2.org.openhab.binding.neohub.internal.NeoHubGetEngineersData,1,0,0,1,0,0,0,0,2
openhab_openhab2.org.openhab.binding.dbquery.internal.Value2StateConverter,3,0,0,0,0,0,0,0,3
openhab_openhab2.org.openhab.binding.dbquery.internal.domain.QueryResultExtractor,6,0,0,6,0,0,0,0,12
openhab_openhab2.org.openhab.binding.dbquery.internal.dbimpl.influx2.Influx2Database,4,0,0,4,0,0,0,0,8
openhab_openhab2.org.openhab.binding.dbquery.internal.dbimpl.StringSubstitutionParamsParser,0,0,0,0,0,0,0,0,0
openhab_openhab2.org.openhab.binding.dbquery.internal.domain.DBQueryJSONEncoder,2,0,0,1,0,0,0,0,3
openhab_openhab2.org.openhab.binding.revogi.internal.udp.UdpSenderService,0,0,0,0,0,0,0,0,0
openhab_openhab2.org.openhab.binding.revogi.internal.api.SwitchService,0,0,0,0,0,0,0,0,0
openhab_openhab2.org.openhab.binding.revogi.internal.api.RevogiDiscoveryService,1,0,0,1,0,0,0,0,2
openhab_openhab2.org.openhab.binding.revogi.internal.api.StatusService,0,0,0,0,0,0,0,0,0
openhab_openhab2.org.openhab.binding.netatmo.internal.utils.ChannelTypeUtils,1,0,0,0,0,0,0,0,1
openhab_openhab2.org.openhab.binding.netatmo.internal.api.dto.NAObject,1,0,0,1,0,0,0,0,2
openhab_openhab2.org.openhab.binding.netatmo.internal.api.dto.WebhookEvent,0,0,0,0,0,0,0,0,0
openhab_openhab2.org.openhab.binding.netatmo.internal.api.dto.Dashboard,1,0,0,1,0,0,0,0,2
openhab_openhab2.org.openhab.binding.mqtt.generic.ChannelState,10,0,0,10,0,0,0,2,22
openhab_openhab2.org.openhab.binding.mqtt.generic.ChannelConfigBuilder,0,0,0,0,0,0,0,0,0
openhab_openhab2.org.openhab.binding.mqtt.generic.internal.handler.GenericMQTTThingHandler,2,0,0,2,0,0,0,1,5
openhab_openhab2.org.openhab.binding.mqtt.generic.values.OnOffValue,1,0,0,1,0,0,0,0,2
openhab_openhab2.org.openhab.binding.mqtt.generic.values.OpenCloseValue,1,0,0,1,0,0,0,0,2
openhab_openhab2.org.openhab.binding.mqtt.generic.values.NumberValue,2,0,0,2,0,0,0,0,4
openhab_openhab2.org.openhab.binding.mqtt.generic.values.RollershutterValue,2,0,0,2,0,0,0,0,4
openhab_openhab2.org.openhab.binding.mqtt.generic.values.PercentageValue,6,0,0,6,0,0,0,0,12
openhab_openhab2.org.openhab.binding.mqtt.generic.mapping.SubscribeFieldToMQTTtopic,1,0,0,0,0,1,0,0,2
openhab_openhab2.org.openhab.binding.mqtt.generic.mapping.AbstractMqttAttributeClass,3,1,0,2,0,0,0,0,6
openhab_openhab2.org.openhab.binding.mqtt.generic.values.TextValue,0,0,0,0,0,0,0,1,1
openhab_openhab2.org.openhab.binding.foobot.internal.handler.FoobotDeviceHandler,1,0,0,1,0,0,0,0,2
openhab_openhab2.org.openhab.binding.foobot.internal.handler.FoobotAccountHandler,1,0,0,1,0,0,0,0,2
openhab_openhab2.org.openhab.binding.robonect.internal.RobonectClient,0,0,0,0,0,0,0,4,4
openhab_openhab2.org.openhab.binding.robonect.internal.handler.RobonectHandler,5,0,0,5,0,0,0,0,10
openhab_openhab2.org.openhab.binding.robonect.internal.model.RobonectAnswer,11,0,0,11,0,0,0,0,22
openhab_openhab2.org.openhab.binding.robonect.internal.model.ErrorEntry,0,0,0,0,0,0,0,0,0
openhab_openhab2.org.openhab.binding.mail.internal.MailBuilder,2,0,0,2,0,0,0,0,4
openhab_openhab2.org.snmp4j.smi.VariableBinding,3,0,0,3,0,0,0,0,6
openhab_openhab2.org.snmp4j.smi.OctetString,0,0,0,0,0,0,0,2,2
openhab_openhab2.org.openhab.binding.bluetooth.am43.internal.command.AM43Command,0,0,0,0,0,0,0,0,0
openhab_openhab2.org.openhab.binding.bluetooth.generic.internal.BluetoothChannelUtils,0,0,0,0,0,0,0,0,0
openhab_openhab2.org.openhab.binding.bluetooth.daikinmadoka.internal.model.commands.GetIndoorOutoorTemperatures,0,0,0,0,0,0,0,0,0
openhab_openhab2.org.openhab.binding.bluetooth.daikinmadoka.internal.model.commands.GetOperationHoursCommand,1,0,0,0,0,0,0,0,1
openhab_openhab2.org.openhab.binding.bluetooth.daikinmadoka.internal.model.MadokaValue,0,0,0,0,0,0,0,0,0
openhab_openhab2.org.openhab.binding.bluetooth.daikinmadoka.internal.BRC1HUartProcessor,1,0,0,0,0,0,0,0,1
openhab_openhab2.org.openhab.binding.deutschebahn.internal.EventAttribute,0,0,0,0,0,0,0,0,0
openhab_openhab2.org.openhab.binding.deutschebahn.internal.timetable.dto.Message,0,0,0,0,0,0,0,2,2
openhab_openhab2.org.openhab.binding.deutschebahn.internal.DeutscheBahnTimetableHandler,0,0,0,0,0,0,0,5,5
openhab_openhab2.org.openhab.binding.deutschebahn.internal.DeutscheBahnTrainHandler,0,0,0,0,0,0,0,2,2
openhab_openhab2.org.openhab.binding.deutschebahn.internal.TripLabelAttribute,0,0,0,0,0,0,0,0,0
openhab_openhab2.org.openhab.binding.deutschebahn.internal.filter.FilterScanner,0,0,0,0,0,0,0,0,0
openhab_openhab2.org.openhab.binding.deutschebahn.internal.filter.TimetableStopByStringEventAttributeFilter,2,0,0,2,0,0,0,0,4
openhab_openhab2.org.openhab.binding.deutschebahn.internal.timetable.dto.TimetableStop,1,0,0,1,0,0,0,0,2
openhab_openhab2.org.openhab.binding.deutschebahn.internal.filter.FilterParser,0,0,0,0,0,0,0,5,5
openhab_openhab2.org.openhab.binding.deutschebahn.internal.timetable.TimetablesV1Api,3,0,0,3,0,0,0,0,6
openhab_openhab2.org.openhab.binding.deutschebahn.internal.timetable.TimetableLoader,6,0,0,5,0,0,0,0,11
openhab_openhab2.org.openhab.binding.yamahareceiver.internal.handler.YamahaBridgeHandler,1,0,0,0,0,0,0,0,1
openhab_openhab2.org.openhab.binding.yamahareceiver.internal.protocol.xml.XMLProtocolFactory,0,0,0,0,0,0,0,0,0
openhab_openhab2.org.openhab.binding.yamahareceiver.internal.protocol.xml.InputConverterXML,2,0,0,0,0,0,0,0,2
openhab_openhab2.org.openhab.binding.yamahareceiver.internal.protocol.xml.ZoneControlXML,4,0,0,0,0,0,0,12,16
openhab_openhab2.org.openhab.binding.yamahareceiver.internal.protocol.xml.SystemControlXML,2,0,0,0,0,0,0,2,4
openhab_openhab2.org.openhab.binding.yamahareceiver.internal.protocol.xml.DeviceInformationXML,2,0,0,0,0,0,0,0,2
openhab_openhab2.org.openhab.binding.yamahareceiver.internal.protocol.xml.InputWithPlayControlXML,5,0,0,0,0,0,0,7,12
openhab_openhab2.org.openhab.binding.yamahareceiver.internal.protocol.xml.InputWithPresetControlXML,2,0,0,0,0,0,0,2,4
openhab_openhab2.org.openhab.binding.omnikinverter.internal.OmnikInverterMessage,0,0,0,0,0,0,0,0,0
openhab_openhab2.org.openhab.binding.anel.internal.state.AnelState,8,0,0,0,0,1,0,0,9
openhab_openhab2.org.openhab.binding.anel.internal.state.AnelStateUpdater,2,0,0,2,0,0,0,0,4
openhab_openhab2.org.openhab.binding.anel.internal.state.AnelCommandHandler,3,0,0,0,0,0,0,0,3
openhab_openhab2.org.openhab.binding.mybmw.internal.handler.simulation.Injector,0,0,0,0,0,0,0,0,0
openhab_openhab2.org.openhab.binding.mybmw.internal.handler.MyBMWBridgeHandler,1,0,0,0,0,0,0,0,1
openhab_openhab2.org.openhab.binding.mybmw.internal.utils.Converter,7,0,0,4,0,1,0,0,12
openhab_openhab2.org.openhab.binding.mybmw.internal.discovery.VehicleDiscovery,1,0,0,1,0,0,0,0,2
openhab_openhab2.org.openhab.binding.mybmw.internal.utils.RemoteServiceUtils,0,0,0,0,0,0,0,0,0
openhab_openhab2.org.openhab.transform.xpath.internal.XPathTransformationService,0,0,0,0,0,0,0,0,0
openhab_openhab2.org.openhab.binding.buienradar.internal.buienradarapi.BuienradarPredictionAPI,1,0,0,1,0,0,0,0,2
openhab_openhab2.org.openhab.binding.luftdateninfo.internal.utils.NumberUtils,3,0,0,0,0,0,0,0,3
openhab_openhab2.org.openhab.binding.luftdateninfo.internal.dto.SensorData,2,1,0,1,0,0,0,0,4
openhab_openhab2.org.openhab.binding.luftdateninfo.internal.handler.HTTPHandler,4,0,0,0,0,0,0,0,4
openhab_openhab2.org.openhab.binding.ahawastecollection.internal.AhaCollectionScheduleImpl,0,0,0,0,0,0,0,0,0
openhab_openhab2.org.openhab.persistence.dynamodb.internal.DynamoDBConfig,9,0,0,9,0,0,0,0,18
openhab_openhab2.org.openhab.persistence.dynamodb.internal.DynamoDBTableNameResolver,1,0,0,1,0,0,0,0,2
openhab_openhab2.org.openhab.binding.bluetooth.airthings.internal.AirthingsDataParser,2,0,0,0,0,0,0,0,2
openhab_openhab2.org.openhab.transform.map.internal.MapTransformationService,1,0,0,1,0,0,0,0,2
openhab_openhab2.org.openhab.binding.innogysmarthome.internal.handler.InnogyBridgeHandler,3,0,0,3,0,0,0,0,6
openhab_openhab2.org.openhab.binding.innogysmarthome.internal.InnogyWebSocket,7,0,0,3,0,0,0,0,10
openhab_openhab2.org.openhab.binding.innogysmarthome.internal.client.InnogyClient,0,0,0,0,0,0,0,0,0
openhab_openhab2.org.openhab.binding.innogysmarthome.internal.client.entity.device.Device,8,0,0,8,0,0,0,0,16
openhab_openhab2.org.openhab.binding.lametrictime.api.local.model.Audio,0,0,0,0,0,0,0,0,0
openhab_openhab2.org.openhab.binding.lametrictime.api.local.model.Frame,2,0,0,2,0,0,0,0,4
openhab_openhab2.org.openhab.binding.lametrictime.api.local.model.Widget,1,0,0,1,0,0,0,0,2
openhab_openhab2.org.openhab.binding.lametrictime.api.local.model.Action,1,0,0,0,0,0,0,0,1
openhab_openhab2.org.openhab.binding.lametrictime.api.local.model.GoalData,1,0,0,1,0,0,0,0,2
openhab_openhab2.org.openhab.binding.lametrictime.api.local.model.UpdateAction,0,0,0,0,0,0,0,0,0
openhab_openhab2.org.openhab.binding.lametrictime.api.local.model.WidgetUpdates,1,0,0,1,0,0,0,0,2
openhab_openhab2.org.openhab.binding.lametrictime.api.local.model.Bluetooth,2,0,0,2,0,0,0,0,4
openhab_openhab2.org.openhab.binding.lametrictime.api.local.model.Application,2,0,0,2,0,0,0,0,4
openhab_openhab2.org.openhab.binding.lametrictime.api.local.impl.LaMetricTimeLocalImpl,0,0,0,0,0,0,0,24,24
openhab_openhab2.org.openhab.binding.lametrictime.api.impl.AbstractDataIcon,0,0,0,0,0,0,0,0,0
openhab_openhab2.org.openhab.binding.livisismarthome.internal.LivisiWebSocket,7,0,0,3,0,0,0,0,10
openhab_openhab2.org.openhab.binding.livisismarthome.internal.handler.LivisiDeviceHandler,40,0,0,32,0,0,0,24,96
openhab_openhab2.org.openhab.binding.livisismarthome.internal.handler.LivisiBridgeHandler,7,0,0,7,0,0,0,0,14
openhab_openhab2.org.openhab.binding.livisismarthome.internal.client.URLCreator,0,0,0,0,0,0,0,0,0
openhab_openhab2.org.openhab.binding.livisismarthome.internal.client.LivisiClient,0,0,0,0,0,0,0,0,0
openhab_openhab2.org.openhab.binding.livisismarthome.internal.client.api.entity.device.DeviceDTO,8,0,0,8,0,0,0,0,16
openhab_openhab2.org.openhab.binding.avmfritz.internal.dto.HeatingModel,3,0,0,0,0,0,0,0,3
openhab_openhab2.org.openhab.binding.avmfritz.internal.dto.AVMFritzBaseModel,16,0,0,16,0,0,0,0,32
openhab_openhab2.org.openhab.binding.avmfritz.internal.dto.templates.TemplateListModel,1,0,0,1,0,0,0,0,2
openhab_openhab2.org.openhab.binding.avmfritz.internal.dto.templates.TemplateModel,2,0,0,2,0,0,0,0,4
openhab_openhab2.org.openhab.binding.avmfritz.internal.dto.ColorControlModel,0,0,0,0,0,0,0,0,0
openhab_openhab2.org.openhab.binding.avmfritz.internal.actions.AVMFritzHeatingActions,0,0,0,0,0,0,0,2,2
openhab_openhab2.org.openhab.automation.pidcontroller.internal.LowpassFilter,0,0,0,0,0,0,0,0,0
openhab_openhab2.org.openhab.binding.lcn.internal.LcnModuleActions,0,0,0,0,0,0,0,15,15
openhab_openhab2.org.openhab.binding.lcn.internal.pchkdiscovery.Server,0,0,0,0,0,0,0,0,0
openhab_openhab2.org.openhab.binding.lcn.internal.pchkdiscovery.ExtService,0,0,0,0,0,0,0,0,0
openhab_openhab2.org.openhab.binding.lcn.internal.subhandler.LcnModuleVariableSubHandler,0,0,0,0,0,0,0,2,2
openhab_openhab2.org.openhab.binding.lcn.internal.subhandler.LcnModuleThresholdSubHandler,0,0,0,0,0,0,0,8,8
openhab_openhab2.org.openhab.binding.lcn.internal.subhandler.LcnModuleRelaySubHandler,0,0,0,0,0,0,0,6,6
openhab_openhab2.org.openhab.binding.lcn.internal.subhandler.LcnModuleRvarModeSubHandler,0,0,0,0,0,0,0,4,4
openhab_openhab2.org.openhab.binding.lcn.internal.subhandler.LcnModuleRollershutterOutputSubHandler,0,0,0,0,0,0,0,6,6
openhab_openhab2.org.openhab.binding.lcn.internal.subhandler.AbstractLcnModuleSubHandler,0,0,0,0,0,0,0,8,8
openhab_openhab2.org.openhab.binding.lcn.internal.subhandler.LcnModuleRvarLockSubHandler,0,0,0,0,0,0,0,4,4
openhab_openhab2.org.openhab.binding.lcn.internal.subhandler.AbstractLcnModuleRollershutterRelaySubHandler,0,0,0,0,0,0,0,10,10
openhab_openhab2.org.openhab.binding.lcn.internal.subhandler.LcnModuleRvarSetpointSubHandler,0,0,0,0,0,0,0,8,8
openhab_openhab2.org.openhab.binding.lcn.internal.subhandler.LcnModuleLedSubHandler,0,0,0,0,0,0,0,7,7
openhab_openhab2.org.openhab.binding.lcn.internal.subhandler.LcnModuleOutputSubHandler,0,0,0,0,0,0,0,18,18
openhab_openhab2.org.openhab.binding.lcn.internal.subhandler.LcnModuleKeyLockTableSubHandler,0,0,0,0,0,0,0,16,16
openhab_openhab2.org.openhab.binding.smartmeter.internal.MeterDevice,0,0,0,0,0,2,0,4,6
openhab_openhab2.org.openhab.binding.smartmeter.internal.conformity.negate.NegateBitParser,1,0,0,1,0,0,0,0,2
openhab_openhab2.org.openhab.binding.wifiled.internal.handler.LEDStateDTO,1,0,0,1,0,0,0,0,2
openhab_openhab2.org.openhab.binding.webthing.internal.client.DescriptionLoader,0,0,0,0,0,0,0,0,0
openhab_openhab2.org.openhab.binding.webthing.internal.link.TypeConverter,1,0,0,1,0,0,0,0,2
openhab_openhab2.org.openhab.binding.webthing.internal.channel.Channels,0,0,0,0,0,0,0,2,2
openhab_openhab2.org.openhab.voice.actiontemplatehli.internal.ActionTemplateInterpreter,2,0,0,0,0,0,0,0,2
timolson_cointrader.org.cryptocoinpartners.schema.Position,2,0,0,2,0,0,0,1,5
timolson_cointrader.org.cryptocoinpartners.schema.Exchange,2,0,0,2,0,0,0,2,6
timolson_cointrader.org.cryptocoinpartners.schema.Portfolio,0,0,0,0,0,0,0,1,1
timolson_cointrader.org.cryptocoinpartners.module.BaseOrderService,0,0,0,0,0,0,0,1,1
timolson_cointrader.org.cryptocoinpartners.schema.DiscreteAmount,0,0,0,0,0,0,0,1,1
timolson_cointrader.org.cryptocoinpartners.esper.LongestPositiveSequence,1,0,0,1,0,0,0,0,2
Linfar_TeamCity.SonarQubePlugin.jetbrains.buildserver.sonarplugin.SQRBuildService,2,0,0,0,0,0,0,1,3
Linfar_TeamCity.SonarQubePlugin.jetbrains.buildserver.sonarplugin.util.SSLTools,0,0,0,0,0,0,0,0,0
Linfar_TeamCity.SonarQubePlugin.jetbrains.buildserver.sonarplugin.SonarQubeServerPropertiesProcessorProviderImpl,0,0,0,0,0,0,0,1,1
Linfar_TeamCity.SonarQubePlugin.jetbrains.buildserver.sonarplugin.SQRParametersAccessor,0,0,0,0,0,0,0,0,0
Linfar_TeamCity.SonarQubePlugin.jetbrains.buildserver.sonarplugin.buildfeatures.BranchesAndPullRequestsBuildStartContextProcessor,1,0,0,0,0,0,0,0,1
Linfar_TeamCity.SonarQubePlugin.jetbrains.buildserver.sonarplugin.buildfeatures.BranchesAndPullRequestsParametersPreprocessor,1,0,0,0,0,0,0,0,1
codecentric_spring-boot-starter-batch-web.de.codecentric.batch.metrics.BatchMetricsImpl,0,0,0,0,0,0,0,5,5
codecentric_spring-boot-starter-batch-web.de.codecentric.batch.listener.ProtocolListener,1,0,0,0,0,0,0,0,1
teamed_requs.org.requs.Compiler,0,0,0,0,0,0,0,0,0
teamed_requs.org.requs.facet.Transform,0,0,0,0,0,0,0,0,0
teamed_requs.org.requs.facet.sa.Violation,0,0,0,0,0,0,0,0,0
teamed_requs.org.requs.facet.sa.RegexRule,0,0,0,0,0,0,0,0,0
teamed_requs.org.requs.facet.sa.IndentationRule,0,0,0,0,0,0,0,0,0
teamed_requs.org.requs.facet.sa.CascadingRule,0,0,0,0,0,0,0,0,0
teamed_requs.org.requs.facet.syntax.ontology.Informal,0,0,0,0,0,0,0,0,0
teamed_requs.org.requs.facet.syntax.ontology.Flow,0,0,0,0,0,0,0,0,0
teamed_requs.org.requs.facet.syntax.ontology.Signature,0,0,0,0,0,0,0,0,0
teamed_requs.org.requs.facet.syntax.ontology.Method,0,0,0,0,0,0,0,0,0
teamed_requs.org.requs.facet.syntax.ontology.XeOntology,0,0,0,0,0,0,0,0,0
teamed_requs.org.requs.facet.uml.Plant,0,0,0,0,0,0,0,0,0
tarql_tarql.org.deri.tarql.CSVParser,2,0,0,0,0,0,0,0,2
tarql_tarql.org.deri.tarql.TarqlParser,4,0,0,4,0,0,0,18,26
tarql_tarql.org.deri.tarql.CSVOptions,14,0,0,6,0,0,1,1,22
tarql_tarql.org.deri.tarql.TarqlQueryExecution,0,0,0,0,0,0,5,0,5
tarql_tarql.org.deri.tarql.CSVTable,3,0,0,3,0,0,0,0,6
TomasMikula_ReactFX.org.reactfx.Counter,1,0,0,1,0,0,0,0,2
payara_Payara.org.glassfish.contextpropagation.View,0,0,0,0,0,0,0,1,1
payara_Payara.org.jvnet.hk2.config.types.HK2DomConfigTypesUtilities,1,0,0,0,0,0,0,0,1
payara_Payara.org.jvnet.hk2.config.HK2DomConfigUtilities,1,0,0,0,0,0,0,0,1
payara_Payara.org.glassfish.flashlight.xml.ProbeProviderStaxParser,0,0,0,0,0,0,0,1,1
payara_Payara.com.sun.enterprise.util.cluster.Paths,3,0,0,0,0,0,0,0,3
payara_Payara.org.glassfish.grizzly.config.dom.Ssl,0,0,0,0,0,0,0,0,0
payara_Payara.org.glassfish.grizzly.config.GrizzlyConfig,10,0,0,10,0,2,0,0,22
payara_Payara.org.glassfish.grizzly.config.dom.NetworkAddressValidator,1,0,0,0,0,0,0,0,1
payara_Payara.org.glassfish.admin.amx.impl.util.SingletonEnforcer,1,0,0,0,0,0,0,1,2
payara_Payara.org.glassfish.admin.amx.core.Util,0,0,0,0,0,0,0,1,1
payara_Payara.org.glassfish.admin.amx.impl.util.ObjectNameBuilder,0,0,0,0,0,0,0,1,1
payara_Payara.com.sun.enterprise.loader.DirWatcher,0,0,0,0,0,0,0,4,4
payara_Payara.com.sun.enterprise.util.PropertyPlaceholderHelper,2,0,0,0,0,0,0,0,2
payara_Payara.com.sun.enterprise.util.Utility,1,0,0,1,0,0,0,0,2
payara_Payara.com.sun.enterprise.util.StringUtils,1,0,0,0,0,0,0,0,1
payara_Payara.com.sun.enterprise.util.JavaVersion,3,0,0,3,0,0,0,0,6
payara_Payara.com.sun.enterprise.util.JDK,1,0,0,0,0,0,0,0,1
payara_Payara.com.sun.enterprise.util.BeanUtils,4,0,0,0,0,0,0,0,4
payara_Payara.com.sun.enterprise.util.RegexUtil,1,0,0,0,0,0,1,0,2
payara_Payara.com.sun.enterprise.util.io.ServerDirs,2,0,0,2,0,0,0,0,4
payara_Payara.com.sun.enterprise.util.io.FileUtils,5,0,0,1,0,0,0,0,6
payara_Payara.com.sun.enterprise.util.io.FileDeletionThread,1,0,0,1,0,0,0,0,2
payara_Payara.com.sun.enterprise.util.net.NetUtils,2,1,0,0,0,0,0,0,3
payara_Payara.com.sun.enterprise.util.reflect.ReflectUtils,1,0,0,0,0,0,0,0,1
payara_Payara.com.sun.enterprise.universal.PropertiesDecoder,1,0,0,0,0,0,0,0,1
payara_Payara.com.sun.enterprise.universal.io.SmartFile,1,1,0,1,0,0,0,0,3
payara_Payara.com.sun.enterprise.util.OS,4,0,0,0,0,2,0,0,6
payara_Payara.com.sun.enterprise.universal.glassfish.TokenResolver,1,0,0,0,0,0,0,0,1
payara_Payara.com.sun.enterprise.universal.glassfish.GFSystem,0,0,0,0,0,0,1,0,1
payara_Payara.com.sun.enterprise.universal.xml.SysPropsHandler,1,0,0,1,0,0,0,0,2
payara_Payara.com.sun.enterprise.universal.xml.MiniXmlParser,7,0,0,6,0,0,0,2,15
payara_Payara.com.sun.enterprise.universal.process.ProcessManager,0,0,0,0,0,0,0,1,1
payara_Payara.com.sun.enterprise.universal.process.Jps,0,0,0,0,0,0,0,1,1
payara_Payara.com.sun.enterprise.universal.collections.ManifestUtils,2,0,0,0,0,0,0,0,2
payara_Payara.org.glassfish.common.util.InstanceCounter,3,0,0,1,0,0,0,0,4
payara_Payara.org.glassfish.common.util.admin.MapInjectionResolver,5,0,0,0,0,0,0,0,5
payara_Payara.org.glassfish.admin.payload.PayloadFilesManager,1,0,0,1,0,0,0,0,2
payara_Payara.org.glassfish.common.util.admin.ManagedFile,0,0,0,0,0,6,0,4,10
payara_Payara.org.glassfish.api.admin.CommandSupport,1,0,0,0,0,0,0,0,1
payara_Payara.org.glassfish.api.admin.progress.ProgressStatusBase,6,0,0,6,0,0,0,0,12
payara_Payara.org.glassfish.api.admin.progress.ProgressStatusMirroringImpl,2,0,0,2,0,0,0,0,4
payara_Payara.org.glassfish.api.invocation.InvocationManager,9,0,0,7,0,0,0,4,20
payara_Payara.org.glassfish.api.invocation.ComponentInvocation,1,0,0,1,0,0,0,0,2
payara_Payara.org.glassfish.api.event.EventTypes,1,0,0,0,0,0,1,0,2
payara_Payara.fish.payara.internal.notification.NotifierUtils,5,0,0,0,0,0,0,0,5
payara_Payara.org.glassfish.internal.deployment.DeploymentTracing,0,0,0,0,0,0,0,1,1
payara_Payara.org.glassfish.flashlight.datatree.TreeNode,0,0,0,0,0,0,0,0,0
payara_Payara.org.glassfish.flashlight.statistics.factory.TimeStatsFactory,1,0,0,1,0,0,0,0,2
payara_Payara.org.glassfish.security.services.common.SubjectUtil,0,0,0,0,0,0,0,0,0
payara_Payara.org.glassfish.security.services.impl.authorization.AuthorizationServiceImpl,8,0,0,6,0,0,0,0,14
payara_Payara.org.glassfish.security.services.impl.authorization.AzActionImpl,1,0,0,0,0,0,0,0,1
payara_Payara.org.glassfish.security.services.impl.authorization.RoleMappingServiceImpl,5,0,0,4,0,2,0,0,11
payara_Payara.org.glassfish.security.services.api.authorization.AuthorizationService,1,0,0,1,0,1,0,0,3
payara_Payara.org.glassfish.security.services.impl.authorization.AzResourceImpl,3,1,0,2,0,0,0,0,6
payara_Payara.org.glassfish.security.services.api.common.Attribute,2,0,0,2,0,0,0,0,4
payara_Payara.org.glassfish.security.services.api.common.Attributes,2,0,0,2,0,0,0,0,4
payara_Payara.org.glassfish.security.services.spi.authorization.RoleMappingProvider,3,0,0,3,0,0,0,0,6
payara_Payara.org.glassfish.security.services.api.context.SecurityContextService,1,0,0,1,0,0,0,0,2
payara_Payara.com.sun.enterprise.security.ssl.GlassfishSSLImpl,0,0,0,0,0,0,0,0,0
payara_Payara.com.sun.enterprise.deployment.deploy.shared.JarArchive,4,0,0,0,0,4,0,0,8
payara_Payara.org.glassfish.api.deployment.archive.Archive,2,0,0,0,0,2,0,0,4
payara_Payara.org.glassfish.api.deployment.archive.ReadableArchive,2,0,0,0,0,2,0,0,4
payara_Payara.com.sun.enterprise.deploy.shared.FileArchive,1,1,0,0,0,0,1,3,6
payara_Payara.org.glassfish.deployment.versioning.VersioningUtils,7,0,0,0,0,1,0,0,8
payara_Payara.com.sun.enterprise.config.serverbeans.Engine,1,0,0,0,0,0,0,0,1
payara_Payara.fish.payara.admin.rest.streams.StreamWriter,0,0,0,0,0,0,0,0,0
payara_Payara.org.glassfish.admin.rest.utils.JsonUtil,1,0,0,1,0,0,0,0,2
payara_Payara.org.glassfish.api.ActionReport,0,0,0,0,0,0,0,5,5
payara_Payara.org.glassfish.admin.rest.provider.ProgressStatusEventJsonProvider,0,0,0,0,0,0,0,0,0
payara_Payara.org.glassfish.admin.rest.provider.ActionReportResultJsonProvider,1,0,0,1,0,0,0,0,2
payara_Payara.org.glassfish.admin.rest.provider.ActionReportResultXmlProvider,1,0,0,1,0,0,0,0,2
payara_Payara.org.glassfish.admin.rest.provider.ActionReportResultHtmlProvider,0,0,0,0,0,0,0,1,1
payara_Payara.org.glassfish.admin.rest.composite.CompositeUtil,5,0,0,1,0,0,0,0,6
payara_Payara.org.glassfish.admin.rest.composite.metadata.RestResourceMetadata,1,0,0,1,0,0,0,0,2
payara_Payara.org.glassfish.admin.rest.composite.RestCollection,9,0,0,9,0,0,0,0,18
payara_Payara.org.glassfish.admin.rest.utils.ResourceUtil,0,0,0,0,0,0,0,0,0
payara_Payara.com.sun.enterprise.admin.progress.CommandProgressImpl,1,0,0,1,0,0,0,0,2
payara_Payara.com.sun.enterprise.admin.util.CachedCommandModel,1,0,0,1,0,0,0,0,2
payara_Payara.com.sun.enterprise.admin.util.cache.AdminCacheUtils,3,0,0,2,0,0,0,0,5
payara_Payara.com.sun.enterprise.admin.util.cache.AdminCache,2,0,0,2,0,0,0,0,4
payara_Payara.com.sun.enterprise.security.store.AsadminSecurityUtil,1,0,0,0,0,0,0,0,1
payara_Payara.fish.payara.boot.runtime.BootCommands,1,0,0,1,0,0,0,0,2
payara_Payara.org.glassfish.config.support.TranslatedConfigView,1,0,0,0,0,0,0,0,1
payara_Payara.org.glassfish.config.support.DomainXmlPreParser,5,0,0,5,0,0,0,0,10
payara_Payara.com.sun.enterprise.config.modularity.ConfigModularityUtils,6,0,0,4,0,0,0,0,10
payara_Payara.com.sun.enterprise.config.serverbeans.Config,6,0,0,3,0,0,0,0,9
payara_Payara.com.sun.enterprise.config.serverbeans.Domain,7,0,0,5,0,2,0,0,14
payara_Payara.org.glassfish.grizzly.config.dom.NetworkListeners,4,1,0,4,0,1,0,0,10
payara_Payara.org.jvnet.hk2.config.DomDocument,0,0,0,0,0,1,0,0,1
payara_Payara.org.glassfish.grizzly.config.dom.NetworkListener,3,1,0,3,0,0,0,0,7
payara_Payara.org.jvnet.hk2.config.ConfigSupport,1,0,0,0,0,1,0,1,3
payara_Payara.org.glassfish.grizzly.config.dom.Protocols,0,0,0,0,0,0,0,1,1
payara_Payara.com.sun.enterprise.config.serverbeans.Applications,1,0,0,1,0,0,0,0,2
payara_Payara.org.jvnet.hk2.config.ConfigModel,1,0,0,1,0,0,0,0,2
payara_Payara.org.glassfish.grizzly.config.dom.Http,0,0,0,0,0,1,0,1,2
payara_Payara.com.sun.enterprise.config.serverbeans.JvmOptionBag,0,0,0,0,0,0,0,1,1
payara_Payara.org.jvnet.hk2.config.Dom,6,0,0,3,0,6,0,1,16
payara_Payara.org.jvnet.hk2.config.Transactions,4,1,0,4,0,0,0,0,9
payara_Payara.org.glassfish.grizzly.config.dom.Transport,0,0,0,0,0,0,0,0,0
payara_Payara.com.sun.enterprise.config.serverbeans.HttpService,2,0,0,2,0,0,0,0,4
payara_Payara.org.glassfish.api.admin.config.ApplicationName,0,0,0,0,0,0,0,0,0
payara_Payara.org.glassfish.tests.utils.Utils,2,0,0,2,0,0,0,0,4
payara_Payara.com.sun.enterprise.config.serverbeans.Server,0,0,0,0,0,0,0,1,1
payara_Payara.com.sun.enterprise.config.serverbeans.JavaConfig,1,1,0,0,0,0,0,0,2
payara_Payara.org.glassfish.grizzly.config.dom.NetworkConfig,1,0,0,1,0,0,0,0,2
payara_Payara.com.sun.enterprise.config.serverbeans.Application,0,0,0,0,0,0,0,0,0
payara_Payara.com.sun.enterprise.config.serverbeans.SecurityService,1,0,0,1,0,0,0,0,2
payara_Payara.com.sun.enterprise.config.serverbeans.AccessLog,1,0,0,1,0,0,0,0,2
payara_Payara.com.sun.enterprise.config.serverbeans.Cluster,2,0,0,1,0,2,0,0,5
payara_Payara.com.sun.enterprise.config.serverbeans.AdminService,1,1,0,0,0,1,0,0,3
payara_Payara.com.sun.enterprise.admin.servermgmt.KeystoreManager,6,0,0,6,0,0,0,0,12
payara_Payara.com.sun.enterprise.admin.servermgmt.stringsubs.StringSubstitutionFactory,1,1,0,0,0,1,0,0,3
payara_Payara.com.sun.enterprise.admin.servermgmt.xml.stringsubs.FileEntry,5,1,0,4,0,0,0,0,10
payara_Payara.com.sun.enterprise.admin.servermgmt.stringsubs.impl.ModeProcessor,0,0,0,0,0,0,0,0,0
payara_Payara.com.sun.enterprise.admin.servermgmt.stringsubs.impl.SubstitutionFileUtil,3,0,0,2,0,3,0,0,8
payara_Payara.com.sun.enterprise.admin.servermgmt.stringsubs.impl.StringSubstitutionParser,1,0,0,1,0,1,0,0,3
payara_Payara.com.sun.enterprise.admin.servermgmt.stringsubs.impl.StringSubstitutionEngine,2,0,0,1,0,6,0,0,9
payara_Payara.com.sun.enterprise.admin.servermgmt.stringsubs.impl.algorithm.RadixTree,1,0,0,1,0,0,0,0,2
payara_Payara.com.sun.enterprise.admin.servermgmt.stringsubs.SubstitutionAlgorithm,2,0,0,2,0,2,0,0,6
payara_Payara.com.sun.enterprise.admin.servermgmt.stringsubs.impl.algorithm.RadixTreeNode,4,0,0,4,0,0,0,0,8
payara_Payara.com.sun.enterprise.admin.cli.ProgramOptions,2,0,0,2,0,0,0,0,4
payara_Payara.com.sun.enterprise.admin.cli.CLIUtil,1,0,0,0,0,0,0,0,1
payara_Payara.com.sun.enterprise.admin.cli.Parser,1,0,0,1,0,0,0,0,2
payara_Payara.com.sun.enterprise.admin.launcher.JavaConfig,1,1,0,1,0,0,0,0,3
payara_Payara.com.sun.enterprise.admin.launcher.GFLauncher,1,0,0,1,0,0,0,0,2
payara_Payara.com.sun.enterprise.server.logging.LogEvent,0,0,0,0,0,0,0,0,0
payara_Payara.com.sun.enterprise.server.logging.LogFormatHelper,3,0,0,3,0,0,0,0,6
payara_Payara.com.sun.enterprise.server.logging.GFFileHandler,2,0,0,0,0,0,0,0,2
payara_Payara.com.sun.common.util.logging.LoggingConfigImpl,0,0,0,0,0,0,0,0,0
payara_Payara.com.sun.enterprise.server.logging.parser.LogParser,0,0,0,0,0,0,0,0,0
payara_Payara.com.sun.enterprise.v3.server.APIClassLoaderServiceImpl,1,0,0,1,0,0,0,0,2
payara_Payara.com.sun.enterprise.v3.server.AppServerStartup,1,0,0,1,0,0,1,0,3
payara_Payara.org.glassfish.server.ServerEnvironmentImpl,3,0,0,0,0,0,3,0,6
payara_Payara.com.sun.enterprise.v3.admin.CommandRunnerImpl,6,4,0,5,0,1,0,0,16
payara_Payara.com.sun.enterprise.v3.admin.AdminAdapter,0,0,0,0,0,0,0,0,0
payara_Payara.org.glassfish.api.admin.AdminCommandContext,0,0,0,0,0,0,0,0,0
payara_Payara.com.sun.enterprise.admin.report.ActionReporter,1,0,0,1,0,0,0,0,2
payara_Payara.org.glassfish.api.event.Events,0,0,0,0,0,0,0,1,1
payara_Payara.org.glassfish.internal.deployment.Deployment,0,0,0,0,0,0,0,0,0
payara_Payara.org.glassfish.api.admin.CommandRunner,41,21,0,41,0,0,4,0,107
payara_Payara.com.sun.enterprise.glassfish.bootstrap.MainHelper,1,0,0,0,0,0,0,0,1
payara_Payara.org.glassfish.contextpropagation.internal.Entry,0,0,0,0,0,0,0,1,1
payara_Payara.org.glassfish.contextpropagation.wireadapters.Catalog,2,0,0,1,0,0,0,0,3
payara_Payara.fish.payara.nucleus.hazelcast.DnsDiscoveryService,3,0,0,0,0,0,2,0,5
payara_Payara.fish.payara.notification.requesttracing.RequestTrace,7,0,0,6,0,0,0,1,14
payara_Payara.fish.payara.nucleus.requesttracing.RequestTracingService,0,0,0,0,0,0,0,1,1
payara_Payara.fish.payara.nucleus.requesttracing.RequestTraceSpanStore,4,0,0,4,0,0,0,0,8
payara_Payara.fish.payara.nucleus.requesttracing.sampling.SampleFilter,0,0,0,0,0,0,0,0,0
payara_Payara.fish.payara.nucleus.requesttracing.store.RequestTraceStoreInterface,5,0,0,5,0,0,0,0,10
payara_Payara.fish.payara.nucleus.requesttracing.store.strategy.TraceStorageStrategy,3,0,0,0,0,0,0,0,3
payara_Payara.org.glassfish.admin.rest.client.utils.MarshallingUtils,6,0,0,0,0,0,0,0,6
payara_Payara.com.sun.enterprise.deployment.DataSourceDefinitionDescriptor,2,0,0,1,0,0,0,0,3
payara_Payara.com.sun.logging.LogDomains,6,0,0,5,0,1,2,1,15
payara_Payara.com.sun.enterprise.util.ExceptionUtil,1,0,0,0,0,1,0,0,2
payara_Payara.com.sun.enterprise.config.serverbeans.Node,0,0,0,0,0,0,0,0,0
payara_Payara.org.glassfish.embeddable.GlassFish,2,0,0,0,0,0,0,2,4
payara_Payara.com.sun.enterprise.web.deploy.FilterDefDecorator,0,0,0,0,0,0,0,0,0
payara_Payara.org.glassfish.web.loader.WebappClassLoader,0,0,0,0,0,0,0,0,0
payara_Payara.org.apache.catalina.core.StandardContextValve,1,0,0,0,0,0,0,1,2
payara_Payara.org.glassfish.internal.api.JavaEEContextUtil,1,0,0,1,0,0,0,0,2
payara_Payara.org.glassfish.api.deployment.ApplicationContext,1,0,0,1,0,0,0,0,2
payara_Payara.org.apache.catalina.core.StandardContext,0,0,0,0,0,0,0,0,0
payara_Payara.com.sun.enterprise.deployment.EjbDescriptor,0,0,0,0,0,0,0,0,0
payara_Payara.org.glassfish.api.naming.GlassfishNamingManager,0,0,0,0,0,0,0,1,1
payara_Payara.com.sun.enterprise.naming.impl.GlassfishNamingManagerImpl,0,0,0,0,0,0,0,3,3
payara_Payara.org.glassfish.apf.impl.AnnotationUtils,1,0,0,0,0,0,0,0,1
payara_Payara.com.sun.enterprise.security.permissionsxml.VoidPermission,3,0,0,0,0,0,0,0,3
payara_Payara.com.sun.enterprise.security.permissionsxml.GlobalPolicyUtil,0,0,0,0,0,0,0,0,0
payara_Payara.com.sun.enterprise.util.HostAndPort,0,0,0,0,0,1,1,0,2
payara_Payara.org.glassfish.grizzly.config.dom.ThreadPool,0,0,0,0,0,0,0,0,0
payara_Payara.org.glassfish.connectors.config.BackendPrincipal,0,0,0,0,0,0,0,0,0
payara_Payara.fish.payara.nucleus.healthcheck.preliminary.BaseHealthCheck,20,2,0,20,0,0,0,0,42
payara_Payara.org.glassfish.embeddable.CommandResult,16,0,0,2,0,0,0,0,18
payara_Payara.fish.payara.nucleus.healthcheck.HealthCheckService,5,0,0,3,0,0,0,0,8
payara_Payara.fish.payara.nucleus.healthcheck.configuration.HealthCheckServiceConfiguration,4,0,0,2,0,0,0,0,6
payara_Payara.fish.payara.nucleus.hazelcast.HazelcastRuntimeConfiguration,1,0,0,0,0,0,0,0,1
payara_Payara.org.glassfish.admin.amx.base.DomainRoot,0,0,0,0,0,0,0,1,1
payara_Payara.org.glassfish.admin.amx.base.RuntimeRoot,0,0,0,0,0,0,0,2,2
OpenHFT_Chronicle-Map.net.openhft.chronicle.set.ChronicleSetBuilder,2,0,0,2,0,0,2,1,7
OpenHFT_Chronicle-Map.net.openhft.chronicle.hash.impl.util.BuildVersion,0,0,0,0,0,0,0,0,0
OpenHFT_Chronicle-Map.net.openhft.chronicle.map.ChronicleMapBuilder,34,3,0,34,0,9,7,25,112
OpenHFT_Chronicle-Map.net.openhft.chronicle.hash.ChecksumEntry,2,0,0,1,0,0,0,0,3
OpenHFT_Chronicle-Map.net.openhft.chronicle.hash.impl.util.CanonicalRandomAccessFiles,1,4,0,1,0,0,0,3,9
OpenHFT_Chronicle-Map.net.openhft.chronicle.map.locks.ChronicleStampedLock,8,4,0,8,0,0,0,0,20
OpenHFT_Chronicle-Map.net.openhft.chronicle.hash.impl.util.CleanerUtils,0,0,0,0,0,0,0,0,0
OpenHFT_Chronicle-Map.net.openhft.chronicle.hash.serialization.impl.ByteBufferDataAccess,1,0,0,0,0,0,0,0,1
edgedalmacio_phisix.javax.xml.bind.DateAdapter,4,2,0,0,0,0,0,0,6
edgedalmacio_phisix.javax.xml.bind.CurrencyAdapter,2,0,0,0,0,0,0,0,2
edgedalmacio_phisix.com.googlecode.phisix.api.client.PseClient,1,0,0,1,0,0,0,1,3
edgedalmacio_phisix.com.googlecode.phisix.api.repository.StocksRepository,2,0,0,2,0,0,0,0,4
edgedalmacio_phisix.com.googlecode.phisix.api.model.Stocks,1,0,0,1,0,0,0,1,3
edgedalmacio_phisix.com.googlecode.phisix.api.resource.StocksResource,2,0,0,2,0,0,0,1,5
edgedalmacio_phisix.com.googlecode.phisix.api.model.Stock,1,0,0,1,0,0,0,0,2
edgedalmacio_phisix.com.googlecode.phisix.api.model.Price,0,0,0,0,0,0,0,0,0
edgedalmacio_phisix.com.googlecode.phisix.api.client.GaClient,0,0,0,0,0,0,0,0,0
edgedalmacio_phisix.com.googlecode.phisix.api.ext.RobotsProvider,0,0,0,0,0,0,0,0,0
edgedalmacio_phisix.com.googlecode.phisix.api.ext.RobotsFilter,1,0,0,0,0,0,0,0,1
edgedalmacio_phisix.com.googlecode.phisix.api.ext.CorsProvider,0,0,0,0,0,0,0,0,0
xerial_sqlite-jdbc.org.sqlite.BusyHandler,2,0,0,1,0,2,0,0,5
xerial_sqlite-jdbc.org.sqlite.core.DB,1,0,0,0,0,0,0,0,1
xerial_sqlite-jdbc.org.sqlite.JDBC,0,0,0,0,0,0,0,0,0
xerial_sqlite-jdbc.org.sqlite.Function,13,0,0,11,0,1,0,0,25
xerial_sqlite-jdbc.org.sqlite.SQLiteConnection,4,0,0,3,0,3,0,0,10
xerial_sqlite-jdbc.org.sqlite.date.FastDateFormat,2,0,0,1,0,0,0,0,3
xerial_sqlite-jdbc.org.sqlite.SQLiteDataSource,2,0,0,1,0,0,0,0,3
xerial_sqlite-jdbc.org.sqlite.SQLiteException,1,0,0,0,0,1,0,0,2
xerial_sqlite-jdbc.org.sqlite.SQLiteConfig,2,1,0,1,0,0,0,0,4
xerial_sqlite-jdbc.org.sqlite.ProgressHandler,1,0,0,1,0,0,0,0,2
xerial_sqlite-jdbc.org.sqlite.Collation,4,0,0,1,0,0,0,0,5
xerial_sqlite-jdbc.org.sqlite.SQLiteJDBCLoader,0,0,0,0,0,0,0,1,1
xerial_sqlite-jdbc.org.sqlite.util.OSInfo,3,0,0,1,0,0,0,1,5
windy1_google-places-api-java.se.walkercrou.places.Param,1,1,0,0,0,0,0,1,3
apache_incubator-tamaya.org.apache.tamaya.core.OSGIActivator,1,0,0,1,0,0,0,0,2
apache_incubator-tamaya.org.apache.tamaya.Configuration,96,0,0,11,0,0,0,1,108
apache_incubator-tamaya.org.apache.tamaya.spi.ConfigurationBuilder,24,0,0,24,0,0,0,0,48
apache_incubator-tamaya.org.apache.tamaya.spi.PropertySource,2,0,0,1,0,0,0,0,3
apache_incubator-tamaya.org.apache.tamaya.core.propertysource.BasePropertySource,3,0,0,3,0,0,0,0,6
apache_incubator-tamaya.org.apache.tamaya.core.internal.converters.URIConverter,1,0,0,0,0,0,0,0,1
apache_incubator-tamaya.org.apache.tamaya.core.internal.converters.URLConverter,1,0,0,0,0,0,0,0,1
apache_incubator-tamaya.org.apache.tamaya.core.internal.converters.OptionalConverter,3,0,0,1,0,0,0,0,4
apache_incubator-tamaya.org.apache.tamaya.core.internal.converters.InstantConverter,2,0,0,0,0,0,0,0,2
apache_incubator-tamaya.org.apache.tamaya.core.internal.converters.BooleanConverter,0,0,0,0,0,0,0,0,0
apache_incubator-tamaya.org.apache.tamaya.core.internal.converters.ConvertQuery,1,0,0,1,0,0,0,0,2
apache_incubator-tamaya.org.apache.tamaya.core.internal.converters.LongConverter,0,0,0,0,0,0,0,0,0
apache_incubator-tamaya.org.apache.tamaya.core.internal.converters.FloatConverter,0,0,0,0,0,0,0,0,0
apache_incubator-tamaya.org.apache.tamaya.core.internal.converters.BigDecimalConverter,0,0,0,0,0,0,0,0,0
apache_incubator-tamaya.org.apache.tamaya.core.internal.converters.CharConverter,0,0,0,0,0,0,0,0,0
apache_incubator-tamaya.org.apache.tamaya.core.internal.converters.ShortConverter,0,0,0,0,0,0,0,0,0
apache_incubator-tamaya.org.apache.tamaya.core.internal.converters.LocalTimeConverter,2,0,0,0,0,0,0,0,2
apache_incubator-tamaya.org.apache.tamaya.core.internal.converters.LocalDateConverter,2,0,0,0,0,0,0,0,2
apache_incubator-tamaya.org.apache.tamaya.core.internal.converters.LocalDateTimeConverter,2,0,0,0,0,0,0,0,2
apache_incubator-tamaya.org.apache.tamaya.core.internal.converters.CurrencyConverter,0,0,0,0,0,0,0,0,0
apache_incubator-tamaya.org.apache.tamaya.core.internal.converters.ByteConverter,0,0,0,0,0,0,0,0,0
apache_incubator-tamaya.org.apache.tamaya.core.internal.converters.IntegerConverter,0,0,0,0,0,0,0,0,0
apache_incubator-tamaya.org.apache.tamaya.core.internal.converters.BigIntegerConverter,1,0,0,1,0,0,0,0,2
apache_incubator-tamaya.org.apache.tamaya.core.internal.converters.SupplierConverter,1,0,0,0,0,0,0,0,1
apache_incubator-tamaya.org.apache.tamaya.core.internal.converters.FileConverter,1,0,0,1,0,0,0,0,2
apache_incubator-tamaya.org.apache.tamaya.core.internal.converters.NumberConverter,0,0,0,0,0,0,0,0,0
apache_incubator-tamaya.org.apache.tamaya.core.internal.converters.OffsetTimeConverter,2,0,0,0,0,0,0,0,2
apache_incubator-tamaya.org.apache.tamaya.core.internal.converters.PathConverter,3,0,0,0,0,0,0,0,3
apache_incubator-tamaya.org.apache.tamaya.core.internal.converters.DoubleConverter,0,0,0,0,0,0,0,0,0
apache_incubator-tamaya.org.apache.tamaya.core.internal.converters.OffsetDateTimeConverter,2,0,0,0,0,0,0,0,2
apache_incubator-tamaya.org.apache.tamaya.core.internal.converters.ClassConverter,1,0,0,0,0,0,0,0,1
apache_incubator-tamaya.org.apache.tamaya.core.internal.converters.DurationConverter,2,0,0,0,0,0,0,0,2
apache_incubator-tamaya.org.apache.tamaya.core.internal.CoreConfigurationBuilder,7,0,0,7,0,0,0,0,14
apache_incubator-tamaya.org.apache.tamaya.TypeLiteral,8,0,0,7,0,0,0,0,15
apache_incubator-tamaya.org.apache.tamaya.core.internal.BannerManager,0,0,0,0,0,0,0,3,3
apache_incubator-tamaya.org.apache.tamaya.core.internal.OSGIServiceComparator,1,0,0,0,0,0,0,0,1
apache_incubator-tamaya.org.apache.tamaya.spisupport.DefaultConfigurationBuilder,11,0,0,11,0,0,0,0,22
apache_incubator-tamaya.org.apache.tamaya.core.internal.OSGIServiceLoader,1,0,0,1,0,0,0,0,2
apache_incubator-tamaya.org.apache.tamaya.core.internal.CoreConfigurationProvider,1,0,0,1,0,0,0,0,2
apache_incubator-tamaya.org.apache.tamaya.core.internal.OSGIServiceContext,2,0,0,0,0,0,0,0,2
apache_incubator-tamaya.org.apache.tamaya.ConfigurationSnapshot,0,0,0,0,0,0,0,0,0
apache_incubator-tamaya.org.apache.tamaya.ConfigurationProvider,1,0,0,1,0,0,0,0,2
apache_incubator-tamaya.org.apache.tamaya.spi.ServiceContext,0,0,0,0,0,0,0,0,0
apache_incubator-tamaya.org.apache.tamaya.spi.ServiceContextManager,4,0,0,3,0,0,0,0,7
apache_incubator-tamaya.org.apache.tamaya.spi.PropertyValue,24,0,0,23,0,0,0,0,47
apache_incubator-tamaya.org.apache.tamaya.spi.ListValue,16,0,0,16,0,0,0,0,32
apache_incubator-tamaya.org.apache.tamaya.spi.ObjectValue,19,0,0,19,0,0,0,0,38
apache_incubator-tamaya.org.apache.tamaya.spi.PropertySourceProvider,1,0,0,0,0,0,0,0,1
apache_incubator-tamaya.org.apache.tamaya.spi.FilterContext,4,0,0,1,0,0,0,0,5
apache_incubator-tamaya.org.apache.tamaya.spi.ConversionContext,6,0,0,6,0,0,0,0,12
apache_incubator-tamaya.org.apache.tamaya.spi.ConfigurationContext,1,0,0,1,0,0,0,0,2
apache_incubator-tamaya.org.apache.tamaya.spisupport.PriorityServiceComparator,1,0,0,1,0,0,0,0,2
apache_incubator-tamaya.org.apache.tamaya.spisupport.PropertySourceChangeSupport,5,0,0,5,0,0,0,3,13
apache_incubator-tamaya.org.apache.tamaya.spisupport.propertysource.BuildablePropertySource,9,0,0,6,0,0,0,0,15
apache_incubator-tamaya.org.apache.tamaya.spisupport.propertysource.BuildablePropertySourceProvider,4,0,0,4,0,0,0,0,8
apache_incubator-tamaya.org.apache.tamaya.spisupport.DefaultPropertySourceSnapshot,5,1,0,5,0,0,0,0,11
apache_incubator-tamaya.org.apache.tamaya.spisupport.PropertyConverterManager,9,0,0,9,0,0,0,0,18
apache_incubator-tamaya.org.apache.tamaya.spisupport.DefaultMetaDataProvider,5,0,0,5,0,0,0,0,10
apache_incubator-tamaya.org.apache.tamaya.spisupport.ConfigValueEvaluator,2,0,0,0,0,0,0,0,2
apache_incubator-tamaya.org.apache.tamaya.spisupport.EnumConverter,1,0,0,0,0,0,0,0,1
apache_incubator-tamaya.org.apache.tamaya.spisupport.DefaultConfiguration,5,0,0,2,0,0,0,0,7
apache_incubator-tamaya.org.apache.tamaya.spisupport.DefaultConfigValueEvaluator,2,0,0,2,0,0,0,0,4
apache_incubator-tamaya.org.apache.tamaya.spisupport.PropertyFilterComparator,0,0,0,0,0,0,0,0,0
apache_incubator-tamaya.org.apache.tamaya.spisupport.ReflectionUtil,1,0,0,0,0,0,0,0,1
apache_incubator-tamaya.org.apache.tamaya.spisupport.DefaultConfigurationContext,1,0,0,1,0,0,0,0,2
apache_incubator-tamaya.org.apache.tamaya.spisupport.DefaultConfigurationSnapshot,7,0,0,7,0,0,0,0,14
apache_incubator-tamaya.org.apache.tamaya.spisupport.propertysource.WrappedPropertySource,4,0,0,4,0,0,0,0,8
apache_incubator-tamaya.org.apache.tamaya.spisupport.propertysource.EnvironmentPropertySource,3,2,0,3,0,0,0,0,8
apache_incubator-tamaya.org.apache.tamaya.spisupport.propertysource.BasePropertySource,6,0,0,4,0,0,0,0,10
apache_incubator-tamaya.org.apache.tamaya.spisupport.propertysource.SystemPropertySource,2,0,0,2,0,0,0,1,5
apache_incubator-tamaya.org.apache.tamaya.spisupport.propertysource.MapPropertySource,3,0,0,3,0,0,0,0,6
apache_incubator-tamaya.org.apache.tamaya.spisupport.propertysource.SimplePropertySource,10,0,0,8,0,0,0,0,18
apache_incubator-tamaya.org.apache.tamaya.spisupport.propertysource.PropertiesResourcePropertySource,2,0,0,0,0,0,0,0,2
apache_incubator-tamaya.org.apache.tamaya.spisupport.propertysource.JavaConfigurationPropertySource,2,0,0,2,0,0,0,0,4
apache_incubator-tamaya.org.apache.tamaya.spisupport.propertysource.CLIPropertySource,1,0,0,1,0,0,0,0,2
SonarSource_sonar-findbugs.org.sonar.plugins.findbugs.FindbugsSensor,0,0,0,0,0,0,0,12,12
SonarSource_sonar-findbugs.org.sonar.plugins.findbugs.xml.FindBugsFilter,1,0,0,1,0,0,0,0,2
SonarSource_sonar-findbugs.org.sonar.plugins.findbugs.FindbugsProfileExporter,2,0,0,2,0,0,0,0,4
SonarSource_sonar-findbugs.org.sonar.plugins.findbugs.FindbugsConfiguration,9,0,0,2,0,0,0,0,11
SonarSource_sonar-findbugs.org.sonar.plugins.findbugs.FindbugsCategory,1,0,0,0,0,0,0,0,1
SonarSource_sonar-findbugs.org.sonar.plugins.findbugs.FindbugsExecutor,2,0,0,2,0,0,0,0,4
SonarSource_sonar-findbugs.org.sonar.plugins.findbugs.resource.ByteCodeResourceLocator,0,0,0,0,0,0,0,4,4
SonarSource_sonar-findbugs.org.sonar.plugins.findbugs.resource.DebugExtensionExtractor,4,0,0,4,0,0,0,0,8
PhantomYdn_wicket-orientdb.ru.ydn.wicket.wicketorientdb.model.AbstractJavaSortableDataProvider,3,0,0,3,0,0,0,0,6
PhantomYdn_wicket-orientdb.ru.ydn.wicket.wicketorientdb.model.AbstractNamingModel,1,0,0,0,0,0,0,3,4
PhantomYdn_wicket-orientdb.ru.ydn.wicket.wicketorientdb.model.ODocumentModel,1,0,0,0,0,0,0,0,1
PhantomYdn_wicket-orientdb.ru.ydn.wicket.wicketorientdb.model.ForwardingDataProvider,1,0,0,1,0,0,0,0,2
PhantomYdn_wicket-orientdb.ru.ydn.wicket.wicketorientdb.IOrientDbSettings,0,0,0,0,0,0,0,1,1
PhantomYdn_wicket-orientdb.ru.ydn.wicket.wicketorientdb.utils.FlexyMetaDataKey,1,0,0,1,0,0,0,0,2
PhantomYdn_wicket-orientdb.ru.ydn.wicket.wicketorientdb.converter.ODocumentConverter,1,0,0,1,0,0,0,0,2
PhantomYdn_wicket-orientdb.ru.ydn.wicket.wicketorientdb.converter.HexConverter,1,0,0,1,0,0,0,0,2
PhantomYdn_wicket-orientdb.ru.ydn.wicket.wicketorientdb.proto.OClassPrototyper,1,0,0,1,0,0,0,0,2
PhantomYdn_wicket-orientdb.ru.ydn.wicket.wicketorientdb.proto.OPropertyPrototyper,1,0,0,1,0,0,0,0,2
PhantomYdn_wicket-orientdb.ru.ydn.wicket.wicketorientdb.proto.OIndexPrototyper,1,0,0,1,0,0,0,0,2
PhantomYdn_wicket-orientdb.ru.ydn.wicket.wicketorientdb.utils.query.filter.IFilterCriteriaManager,12,0,0,5,0,0,3,0,20
PhantomYdn_wicket-orientdb.ru.ydn.wicket.wicketorientdb.utils.OSchemaHelper,1,0,0,1,0,0,1,0,3
OryxProject_oryx.com.cloudera.oryx.app.serving.IDEntity,17,0,0,17,0,0,0,0,34
OryxProject_oryx.com.cloudera.oryx.common.collection.Pair,3,0,0,0,0,0,0,0,3
OryxProject_oryx.com.cloudera.oryx.common.settings.ConfigUtils,24,5,0,22,0,0,0,2,53
OryxProject_oryx.com.cloudera.oryx.app.serving.IDCount,4,0,0,0,0,0,0,0,4
OryxProject_oryx.com.cloudera.oryx.common.lang.ExecUtils,0,0,0,0,0,0,0,1,1
OryxProject_oryx.com.cloudera.oryx.app.serving.als.model.ALSServingModelManager,1,0,0,0,0,0,0,0,1
OryxProject_oryx.com.cloudera.oryx.app.serving.als.model.LocalitySensitiveHash,3,0,0,3,0,0,0,0,6
OryxProject_oryx.com.cloudera.oryx.app.serving.als.model.ALSServingModel,7,0,0,6,0,0,0,0,13
OryxProject_oryx.com.cloudera.oryx.app.serving.als.model.TopNConsumer,1,0,0,1,0,0,0,0,2
OryxProject_oryx.com.cloudera.oryx.app.schema.InputSchema,4,0,0,4,0,0,0,0,8
OryxProject_oryx.com.cloudera.oryx.app.schema.CategoricalValueEncodings,3,0,0,1,0,0,0,0,4
OryxProject_oryx.com.cloudera.oryx.app.pmml.AppPMMLUtils,6,0,0,4,0,0,0,0,10
OryxProject_oryx.com.cloudera.oryx.app.rdf.RDFPMMLUtils,1,0,0,1,0,0,0,2,4
OryxProject_oryx.com.cloudera.oryx.app.rdf.tree.TreePath,2,0,0,1,0,0,0,0,3
OryxProject_oryx.com.cloudera.oryx.app.rdf.tree.DecisionTree,1,0,0,0,0,0,0,0,1
OryxProject_oryx.com.cloudera.oryx.app.rdf.tree.DecisionForest,1,0,0,0,0,0,0,0,1
OryxProject_oryx.com.cloudera.oryx.app.rdf.tree.TerminalNode,2,0,0,1,0,0,0,0,3
OryxProject_oryx.com.cloudera.oryx.app.rdf.tree.DecisionNode,2,0,0,1,0,0,0,0,3
OryxProject_oryx.com.cloudera.oryx.app.rdf.decision.NumericDecision,2,0,0,1,0,0,0,0,3
OryxProject_oryx.com.cloudera.oryx.app.rdf.decision.Decision,2,0,0,2,0,0,0,0,4
OryxProject_oryx.com.cloudera.oryx.app.rdf.decision.CategoricalDecision,2,0,0,1,0,0,0,0,3
OryxProject_oryx.com.cloudera.oryx.app.als.FeatureVectorsPartition,7,0,0,7,0,0,0,0,14
OryxProject_oryx.com.cloudera.oryx.app.als.FeatureVectors,0,0,0,0,0,0,0,0,0
OryxProject_oryx.com.cloudera.oryx.app.als.ALSUtils,2,0,0,1,0,0,0,0,3
OryxProject_oryx.com.cloudera.oryx.app.als.PartitionedFeatureVectors,6,0,0,6,0,0,0,0,12
OryxProject_oryx.com.cloudera.oryx.app.als.SolverCache,0,0,0,0,0,0,0,1,1
OryxProject_oryx.com.cloudera.oryx.app.als.RescorerProvider,6,0,0,2,0,0,0,0,8
OryxProject_oryx.com.cloudera.oryx.app.als.MultiRescorer,1,0,0,0,0,0,0,0,1
OryxProject_oryx.com.cloudera.oryx.app.kmeans.ClusterInfo,1,0,0,1,0,0,0,0,2
OryxProject_oryx.com.cloudera.oryx.app.kmeans.KMeansPMMLUtils,1,0,0,1,0,0,0,1,3
OryxProject_oryx.com.cloudera.oryx.app.kmeans.EuclideanDistanceFn,1,0,0,0,0,0,0,0,1
OryxProject_oryx.com.cloudera.oryx.app.kmeans.KMeansUtils,1,0,0,1,0,0,0,1,3
OryxProject_oryx.com.cloudera.oryx.app.classreg.example.ExampleUtils,1,0,0,1,0,0,0,0,2
OryxProject_oryx.com.cloudera.oryx.app.classreg.example.CategoricalFeature,1,0,0,1,0,0,0,0,2
OryxProject_oryx.com.cloudera.oryx.app.classreg.example.NumericFeature,2,0,0,1,0,0,0,0,3
OryxProject_oryx.com.cloudera.oryx.app.classreg.predict.CategoricalPrediction,6,0,0,6,0,0,0,0,12
OryxProject_oryx.com.cloudera.oryx.app.classreg.predict.NumericPrediction,5,0,0,4,0,0,0,0,9
OryxProject_oryx.com.cloudera.oryx.app.speed.als.ALSSpeedModel,3,0,0,2,0,0,0,0,5
OryxProject_oryx.com.cloudera.oryx.app.speed.kmeans.KMeansSpeedModel,1,0,0,1,0,0,0,0,2
OryxProject_oryx.com.cloudera.oryx.app.batch.mllib.als.ALSUpdate,1,0,0,0,0,0,0,0,1
OryxProject_oryx.com.cloudera.oryx.app.batch.mllib.kmeans.SilhouetteCoefficient,1,0,0,0,0,0,0,0,1
OryxProject_oryx.com.cloudera.oryx.app.batch.mllib.kmeans.DunnIndex,0,0,0,0,0,0,0,0,0
OryxProject_oryx.com.cloudera.oryx.app.batch.mllib.kmeans.DaviesBouldinIndex,0,0,0,0,0,0,0,0,0
OryxProject_oryx.com.cloudera.oryx.app.batch.mllib.kmeans.SumSquaredError,0,0,0,0,0,0,0,0,0
OryxProject_oryx.com.cloudera.oryx.common.io.IOUtils,9,1,0,2,0,1,0,1,14
OryxProject_oryx.com.cloudera.oryx.common.pmml.PMMLUtils,3,0,0,2,0,0,0,0,5
OryxProject_oryx.com.cloudera.oryx.common.math.LinearSystemSolver,2,0,0,1,0,0,0,0,3
OryxProject_oryx.com.cloudera.oryx.common.math.Solver,2,0,0,0,0,0,0,0,2
OryxProject_oryx.com.cloudera.oryx.common.math.SingularMatrixSolverException,1,0,0,0,0,1,0,0,2
OryxProject_oryx.com.cloudera.oryx.common.math.DoubleWeightedMean,6,0,0,6,0,0,0,0,12
OryxProject_oryx.com.cloudera.oryx.common.math.VectorMath,4,0,0,2,0,0,0,0,6
OryxProject_oryx.com.cloudera.oryx.common.random.RandomManager,3,0,0,1,0,0,1,0,5
OryxProject_oryx.com.cloudera.oryx.common.text.TextUtils,6,0,0,0,0,0,0,0,6
OryxProject_oryx.com.cloudera.oryx.common.lang.AutoReadWriteLock,3,0,0,1,0,0,0,0,4
OryxProject_oryx.com.cloudera.oryx.common.lang.LoggingCallable,0,0,0,0,0,0,0,0,0
OryxProject_oryx.com.cloudera.oryx.common.lang.ClassUtils,1,0,0,0,0,0,0,0,1
OryxProject_oryx.com.cloudera.oryx.common.lang.JVMUtils,0,0,0,0,0,0,0,1,1
OryxProject_oryx.com.cloudera.oryx.common.lang.OryxShutdownHook,0,0,0,0,0,0,0,0,0
OryxProject_oryx.com.cloudera.oryx.common.lang.RateLimitCheck,1,0,0,0,0,0,0,0,1
OryxProject_oryx.com.cloudera.oryx.common.lang.AutoLock,3,0,0,2,0,0,0,0,5
OryxProject_oryx.com.cloudera.oryx.common.settings.ConfigToProperties,1,0,0,0,0,0,0,0,1
OryxProject_oryx.com.cloudera.oryx.common.collection.Pairs,1,0,0,1,0,0,0,0,2
OryxProject_oryx.com.cloudera.oryx.ml.param.RandomSearch,2,0,0,1,0,0,0,0,3
OryxProject_oryx.com.cloudera.oryx.ml.param.HyperParams,0,0,0,0,0,0,0,4,4
OryxProject_oryx.com.cloudera.oryx.ml.param.GridSearch,3,0,0,2,0,0,0,0,5
OryxProject_oryx.com.cloudera.oryx.lambda.HadoopUtils,0,0,0,0,0,0,0,1,1
OryxProject_oryx.com.cloudera.oryx.lambda.TopicProducerImpl,1,0,0,1,0,0,0,0,2
OryxProject_oryx.com.cloudera.oryx.lambda.batch.ValueWritableConverter,2,0,0,0,0,0,0,0,2
OryxProject_oryx.com.cloudera.oryx.lambda.batch.WritableToValueFunction,1,0,0,0,0,0,0,0,1
OryxProject_oryx.com.cloudera.oryx.lambda.serving.InMemoryRealm,1,0,0,1,0,0,0,0,2
OryxProject_oryx.com.cloudera.oryx.lambda.serving.TopicProducerImpl,1,0,0,1,0,0,0,0,2
OryxProject_oryx.com.cloudera.oryx.lambda.serving.CSVMessageBodyWriter,2,0,0,0,0,0,0,0,2
OryxProject_oryx.com.cloudera.oryx.lambda.serving.ErrorResource,0,0,0,0,0,0,0,1,1
OryxProject_oryx.com.cloudera.oryx.lambda.serving.OryxExceptionMapper,1,0,0,0,0,0,0,0,1
datanucleus_datanucleus-core.org.datanucleus.properties.FrequentlyAccessedProperties,2,0,0,2,0,0,0,0,4
awslabs_aws-dynamodb-encryption-java.com.amazonaws.examples.AwsKmsEncryptedItem,0,0,0,0,0,0,0,1,1
awslabs_aws-dynamodb-encryption-java.com.amazonaws.examples.SymmetricEncryptedItem,0,0,0,0,0,0,0,1,1
awslabs_aws-dynamodb-encryption-java.com.amazonaws.examples.AwsKmsEncryptedObject,0,0,0,0,0,0,0,1,1
awslabs_aws-dynamodb-encryption-java.com.amazonaws.examples.AsymmetricEncryptedItem,0,0,0,0,0,0,0,1,1
awslabs_aws-dynamodb-encryption-java.com.amazonaws.examples.AwsKmsMultiRegionKey,0,0,0,0,0,0,0,1,1
awslabs_aws-dynamodb-encryption-java.com.amazonaws.services.dynamodbv2.datamodeling.encryption.providers.store.MetaStore,9,0,0,9,0,0,0,1,19
awslabs_aws-dynamodb-encryption-java.com.amazonaws.examples.EncryptionContextOverridesWithDynamoDBMapper,0,0,0,0,0,0,0,1,1
awslabs_aws-dynamodb-encryption-java.com.amazonaws.services.dynamodbv2.datamodeling.internal.LRUCache,4,0,0,4,0,0,0,0,8
awslabs_aws-dynamodb-encryption-java.com.amazonaws.services.dynamodbv2.datamodeling.internal.Hkdf,1,0,0,1,0,0,0,1,3
awslabs_aws-dynamodb-encryption-java.com.amazonaws.services.dynamodbv2.datamodeling.internal.AttributeValueMarshaller,2,0,0,0,0,2,0,16,20
awslabs_aws-dynamodb-encryption-java.com.amazonaws.services.dynamodbv2.datamodeling.internal.Base64,2,0,0,1,0,0,0,0,3
awslabs_aws-dynamodb-encryption-java.com.amazonaws.services.dynamodbv2.datamodeling.internal.TTLCache,12,0,0,12,0,0,0,0,24
awslabs_aws-dynamodb-encryption-java.com.amazonaws.services.dynamodbv2.datamodeling.internal.ByteBufferInputStream,3,0,0,2,0,0,0,0,5
awslabs_aws-dynamodb-encryption-java.com.amazonaws.services.dynamodbv2.datamodeling.internal.Utils,3,0,0,2,0,0,0,0,5
awslabs_aws-dynamodb-encryption-java.com.amazonaws.services.dynamodbv2.datamodeling.encryption.DynamoDBEncryptor,13,0,0,9,0,0,0,1,23
awslabs_aws-dynamodb-encryption-java.com.amazonaws.services.dynamodbv2.datamodeling.encryption.DynamoDBSigner,0,0,0,0,0,0,0,13,13
awslabs_aws-dynamodb-encryption-java.com.amazonaws.services.dynamodbv2.datamodeling.encryption.utils.EncryptionContextOperators,3,0,0,3,0,0,0,0,6
awslabs_aws-dynamodb-encryption-java.com.amazonaws.services.dynamodbv2.datamodeling.encryption.providers.SymmetricStaticProvider,6,0,0,6,0,0,0,1,13
awslabs_aws-dynamodb-encryption-java.com.amazonaws.services.dynamodbv2.datamodeling.encryption.providers.WrappedMaterialsProvider,18,0,0,18,0,0,0,2,38
awslabs_aws-dynamodb-encryption-java.com.amazonaws.services.dynamodbv2.datamodeling.encryption.providers.DirectKmsMaterialProvider,10,0,0,9,0,0,0,1,20
awslabs_aws-dynamodb-encryption-java.com.amazonaws.services.dynamodbv2.datamodeling.encryption.providers.CachingMostRecentProvider,9,0,0,9,0,0,0,0,18
awslabs_aws-dynamodb-encryption-java.com.amazonaws.services.dynamodbv2.datamodeling.encryption.providers.KeyStoreMaterialsProvider,10,0,0,10,0,1,0,1,22
awslabs_aws-dynamodb-encryption-java.com.amazonaws.services.dynamodbv2.datamodeling.encryption.materials.AbstractRawMaterials,4,0,0,4,0,0,0,0,8
awslabs_aws-dynamodb-encryption-java.com.amazonaws.services.dynamodbv2.datamodeling.encryption.materials.SymmetricRawMaterials,4,0,0,4,0,0,0,0,8
geftimov_MapReduce.com.eftimoff.mapreduce.utils.MRDPUtils,0,0,0,0,0,0,0,0,0
my2iu_Jinq.org.jinq.orm.stream.JinqStream,34,0,0,34,0,0,0,0,68
my2iu_Jinq.org.jinq.tuples.Pair,18,0,0,10,0,0,0,0,28
my2iu_Jinq.org.jinq.tuples.Tuple3,3,0,0,3,0,0,0,0,6
my2iu_Jinq.org.jinq.tuples.Tuple8,2,0,0,2,0,0,0,0,4
my2iu_Jinq.org.jinq.jpa.JPQL,2,0,0,2,0,0,0,0,4
my2iu_Jinq.org.jinq.orm.stream.NonQueryJinqStream,1,0,0,0,0,0,0,0,1
my2iu_Jinq.org.jinq.jpa.test.entities.Supplier,13,0,0,12,0,0,0,0,25
my2iu_Jinq.org.jinq.jpa.test.entities.Customer,21,0,0,5,0,0,0,0,26
my2iu_Jinq.org.jinq.jpa.test.entities.Item,8,0,0,7,0,0,0,0,15
my2iu_Jinq.org.jinq.jpa.test.entities.CreditCard,1,0,0,1,0,0,0,0,2
galenframework_galen.com.galenframework.rainbow4j.Rainbow4J,23,0,0,23,0,0,0,2,48
galenframework_galen.com.galenframework.rainbow4j.ImageHandler,0,0,0,0,0,0,0,3,3
galenframework_galen.com.galenframework.rainbow4j.filters.BlurFilter,5,0,0,2,0,0,0,0,7
galenframework_galen.com.galenframework.rainbow4j.filters.ReplaceColorsFilter,1,0,0,1,0,0,0,0,2
galenframework_galen.com.galenframework.rainbow4j.filters.EdgesFilter,1,0,0,0,0,0,0,0,1
.org.dataalgorithms.chap05.mapreduce.PairOfWords,0,0,0,0,0,0,0,0,0
WhisperSystems_WebSocket-Resources.org.whispersystems.websocket.messages.WebSocketResponseMessage,2,0,0,2,0,0,0,0,4
WhisperSystems_WebSocket-Resources.org.whispersystems.websocket.messages.WebSocketRequestMessage,0,0,0,0,0,0,0,1,1
WhisperSystems_WebSocket-Resources.org.whispersystems.websocket.WebSocketResourceProvider,1,0,0,1,0,0,0,1,3
WhisperSystems_WebSocket-Resources.org.whispersystems.websocket.WebSocketResourceProviderFactory,1,0,0,1,0,0,0,0,2
fiji_Stitching.mpicbg.stitching.fusion.Interval,2,0,0,1,0,0,0,2,5
fiji_Stitching.mpicbg.stitching.fusion.ClassifiedRegion,3,0,0,2,0,1,0,0,6
dgageot_simplelenium.net.codestory.simplelenium.reflection.ReflectionUtil,3,0,0,0,0,0,0,0,3
dgageot_simplelenium.net.codestory.simplelenium.FluentTest,0,0,0,0,0,0,0,1,1
dgageot_simplelenium.net.codestory.simplelenium.Should,0,0,0,0,0,0,0,2,2
dgageot_simplelenium.net.codestory.simplelenium.selectors.ByCssSelectorOrByNameOrById,1,0,0,0,0,0,0,0,1
dgageot_simplelenium.net.codestory.simplelenium.text.Text,3,0,0,0,0,0,0,0,3
dgageot_simplelenium.net.codestory.simplelenium.filters.StringPredicates,8,0,0,0,0,0,0,0,8
dropwizard_dropwizard-protobuf.io.dropwizard.jersey.protobuf.ProtocolBufferMessageBodyProvider,0,0,0,0,0,0,0,0,0
dropwizard_dropwizard-protobuf.io.dropwizard.jersey.protobuf.InvalidProtocolBufferExceptionMapper,0,0,0,0,0,0,0,0,0
vibe-project_vibe-java-server.org.atmosphere.vibe.DefaultServer,0,0,0,0,0,0,0,1,1
wildflyext_wildfly-camel.org.wildfly.camel.catalog.CatalogCreator,1,0,0,1,0,0,0,1,3
wildflyext_wildfly-camel.org.wildfly.extras.config.ConfigSupport,4,0,0,4,0,0,0,1,9
wildflyext_wildfly-camel.org.wildfly.camel.test.common.utils.TestUtils,7,0,0,1,0,1,0,1,10
wildflyext_wildfly-camel.org.wildfly.camel.test.common.aws.AWSUtils,1,0,0,0,0,0,0,0,1
wildflyext_wildfly-camel.org.wildfly.camel.test.common.utils.AvailablePortFinder,5,1,0,0,0,0,0,0,6
wildflyext_wildfly-camel.org.wildfly.camel.test.common.http.HttpRequest,8,0,0,0,0,0,0,1,9
wildflyext_wildfly-camel.org.wildfly.camel.test.common.utils.EnvironmentUtils,0,0,0,0,0,0,0,0,0
wildflyext_wildfly-camel.org.wildfly.extension.camel.CamelContextRegistry,63,0,0,16,0,7,0,0,86
wildflyext_wildfly-camel.org.wildfly.camel.test.common.utils.LogUtils,0,0,0,0,0,0,0,0,0
wildflyext_wildfly-camel.org.wildfly.extension.camel.SpringCamelContextFactory,1,0,0,0,0,0,0,0,1
wildflyext_wildfly-camel.org.wildfly.extension.camel.SpringCamelContextBootstrap,0,0,0,0,0,0,0,0,0
wildflyext_wildfly-camel.org.wildfly.extension.camel.security.LoginContextBuilder,1,0,0,0,0,0,0,2,3
wildflyext_wildfly-camel.org.wildfly.extension.camel.CamelContextFactory,0,0,0,0,0,0,0,3,3
wildflyext_wildfly-camel.org.wildfly.camel.test.common.aws.KinesisUtils,1,0,0,1,0,0,0,0,2
wildflyext_wildfly-camel.org.wildfly.extension.camel.WildFlyCamelContext,2,1,0,0,0,0,0,0,3
wildflyext_wildfly-camel.org.wildfly.camel.test.common.aws.S3Utils,1,0,0,1,0,0,0,0,2
wildflyext_wildfly-camel.org.wildfly.camel.test.common.aws.DynamoDBUtils,2,0,0,2,0,0,0,0,4
wildflyext_wildfly-camel.org.wildfly.camel.test.common.aws.SDBUtils,1,0,0,1,0,0,0,0,2
wildflyext_wildfly-camel.org.wildfly.camel.test.common.types.Customer,7,0,0,7,0,0,0,0,14
wildflyext_wildfly-camel.org.wildfly.extension.camel.ContextCreateHandlerRegistry,1,0,0,0,0,0,0,0,1
wildflyext_wildfly-camel.org.wildfly.camel.utils.ObjectNameFactory,1,0,0,1,0,0,0,0,2
wildflyext_wildfly-camel.org.wildfly.camel.test.common.utils.XMLUtils,0,0,0,0,0,0,0,0,0
wildflyext_wildfly-camel.org.wildfly.camel.test.common.utils.FileUtils,1,0,0,0,0,0,0,0,1
wildflyext_wildfly-camel.org.wildfly.camel.utils.ServiceLocator,1,0,0,1,0,0,0,0,2
wildflyext_wildfly-camel.org.wildfly.extension.camel.EndpointRegistryClient,0,0,0,0,0,0,0,0,0
wildflyext_wildfly-camel.org.wildfly.camel.test.common.types.Endpoint,0,0,0,0,0,0,0,0,0
takari_takari-local-repository.io.takari.aether.localrepo.TakariLocalRepositoryManager,10,0,0,2,0,0,0,0,12
takari_takari-local-repository.io.takari.aether.localrepo.TrackingFileManager,5,0,0,1,0,0,0,0,6
takari_takari-local-repository.io.takari.filemanager.internal.DefaultFileManager,6,0,0,5,0,1,0,4,16
spotify_crtauth-java.com.spotify.crtauth.signer.Signer,0,0,0,0,0,0,0,1,1
spotify_crtauth-java.com.spotify.crtauth.CrtAuthServer,0,0,0,0,0,0,0,2,2
spotify_crtauth-java.com.spotify.crtauth.utils.TraditionalKeyParser,1,0,0,0,0,0,0,0,1
spotify_crtauth-java.com.spotify.crtauth.CrtAuthClient,0,0,0,0,0,0,0,1,1
spotify_crtauth-java.com.spotify.crtauth.utils.ASCIICodec,0,0,0,0,0,0,0,0,0
spotify_crtauth-java.com.spotify.crtauth.protocol.CrtAuthCodec,1,0,0,1,0,0,0,0,2
spotify_crtauth-java.com.spotify.crtauth.utils.SettableTimeSupplier,0,0,0,0,0,0,0,0,0
neo4j_neo4j-ogm.org.neo4j.ogm.response.Response,12,0,0,6,0,0,0,0,18
neo4j_neo4j-ogm.org.neo4j.ogm.drivers.embedded.driver.EmbeddedDriver,4,0,0,2,0,1,0,2,9
neo4j_neo4j-ogm.org.neo4j.ogm.drivers.embedded.types.adapter.PointToEmbeddedValueAdapter,1,0,0,0,0,0,0,0,1
neo4j_neo4j-ogm.org.neo4j.ogm.types.adapter.TemporalAmountAdapter,2,0,0,0,0,0,0,0,2
neo4j_neo4j-ogm.org.neo4j.ogm.drivers.embedded.types.adapter.EmbeddedValueToPointAdapter,1,0,0,1,0,0,0,0,2
neo4j_neo4j-ogm.org.neo4j.ogm.config.Configuration,18,0,0,16,0,0,0,0,34
neo4j_neo4j-ogm.org.neo4j.ogm.drivers.bolt.driver.BoltDriver,1,0,0,1,0,0,0,0,2
neo4j_neo4j-ogm.org.neo4j.ogm.session.Session,231,5,0,61,0,1,0,11,309
neo4j_neo4j-ogm.org.neo4j.ogm.drivers.bolt.types.adapter.PointToBoltValueAdapter,1,0,0,0,0,0,0,0,1
neo4j_neo4j-ogm.org.neo4j.ogm.drivers.bolt.transaction.BoltTransaction,2,0,0,0,0,2,0,4,8
neo4j_neo4j-ogm.org.neo4j.ogm.context.MappingContext,15,0,0,15,0,0,0,0,30
neo4j_neo4j-ogm.org.neo4j.ogm.session.SessionFactory,70,0,0,46,0,9,1,4,130
neo4j_neo4j-ogm.org.neo4j.ogm.context.IdentityMap,1,0,0,1,0,0,0,0,2
neo4j_neo4j-ogm.org.neo4j.ogm.cypher.compiler.Compiler,18,1,0,18,0,0,0,0,37
neo4j_neo4j-ogm.org.neo4j.ogm.cypher.Filter,9,0,0,9,0,0,1,0,19
neo4j_neo4j-ogm.org.neo4j.ogm.context.EntityMapper,4,1,0,4,0,0,0,0,9
neo4j_neo4j-ogm.org.neo4j.ogm.utils.RelationshipUtils,0,0,0,0,0,0,0,12,12
neo4j_neo4j-ogm.org.neo4j.ogm.utils.EntityUtils,1,0,0,0,0,0,0,0,1
neo4j_neo4j-ogm.org.neo4j.ogm.driver.Driver,0,0,0,0,0,0,0,0,0
neo4j_neo4j-ogm.org.neo4j.ogm.drivers.http.driver.HttpDriver,1,0,0,0,0,1,1,0,3
neo4j_neo4j-ogm.org.neo4j.ogm.config.UsernamePasswordCredentials,1,0,0,1,0,0,0,0,2
neo4j_neo4j-ogm.org.neo4j.ogm.config.ConfigurationUtils,0,0,0,0,0,0,0,0,0
neo4j_neo4j-ogm.org.neo4j.ogm.model.Query,7,0,0,6,0,0,0,0,13
neo4j_neo4j-ogm.org.neo4j.ogm.cypher.Filters,7,0,0,2,0,0,0,3,12
neo4j_neo4j-ogm.org.neo4j.ogm.session.Neo4jSession,8,0,0,6,0,0,0,1,15
neo4j_neo4j-ogm.org.neo4j.ogm.metadata.ClassInfo,48,2,0,43,0,0,0,1,94
neo4j_neo4j-ogm.org.neo4j.ogm.transaction.Transaction,3,0,0,3,0,0,0,3,9
neo4j_neo4j-ogm.org.neo4j.ogm.session.event.PreSaveEvent,3,0,0,3,0,0,0,0,6
neo4j_neo4j-ogm.org.neo4j.ogm.model.Result,3,0,0,3,0,0,0,0,6
neo4j_neo4j-ogm.org.neo4j.ogm.context.EntityGraphMapper,1,0,0,1,0,0,0,0,2
neo4j_neo4j-ogm.org.neo4j.ogm.exception.CypherException,1,0,0,0,0,1,0,0,2
neo4j_neo4j-ogm.org.neo4j.ogm.model.QueryStatistics,4,0,0,0,0,4,0,0,8
neo4j_neo4j-ogm.org.neo4j.ogm.session.Utils,2,0,0,0,0,0,0,0,2
neo4j_neo4j-ogm.org.neo4j.ogm.cypher.query.PagingAndSortingQuery,10,0,0,10,0,0,0,6,26
neo4j_neo4j-ogm.org.neo4j.ogm.session.request.strategy.impl.SchemaRelationshipLoadClauseBuilder,0,0,0,0,0,0,0,0,0
neo4j_neo4j-ogm.org.neo4j.ogm.cypher.query.CypherQuery,4,0,0,4,0,0,0,0,8
neo4j_neo4j-ogm.org.neo4j.ogm.session.request.strategy.AggregateStatements,2,0,0,2,0,0,0,0,4
neo4j_neo4j-ogm.org.neo4j.ogm.session.request.strategy.impl.SchemaNodeLoadClauseBuilder,1,0,0,1,0,0,0,0,2
neo4j_neo4j-ogm.org.neo4j.ogm.session.request.strategy.impl.NodeQueryStatements,6,0,0,6,0,0,0,0,12
neo4j_neo4j-ogm.org.neo4j.ogm.session.request.strategy.impl.RelationshipQueryStatements,2,0,0,2,0,0,0,0,4
neo4j_neo4j-ogm.org.neo4j.ogm.session.request.strategy.impl.NodeDeleteStatements,2,0,0,2,0,0,0,0,4
neo4j_neo4j-ogm.org.neo4j.ogm.session.request.strategy.impl.RelationshipDeleteStatements,1,0,0,1,0,0,0,0,2
neo4j_neo4j-ogm.org.neo4j.ogm.cypher.query.Pagination,0,0,0,0,0,0,0,0,0
neo4j_neo4j-ogm.org.neo4j.ogm.session.request.strategy.DeleteStatements,0,0,0,0,0,0,0,0,0
neo4j_neo4j-ogm.org.neo4j.ogm.session.request.strategy.QueryStatements,1,0,0,1,0,0,0,2,4
neo4j_neo4j-ogm.org.neo4j.ogm.session.delegates.SessionDelegate,1,0,0,1,0,0,0,0,2
neo4j_neo4j-ogm.org.neo4j.ogm.session.delegates.ExecuteQueriesDelegate,1,1,0,0,0,0,0,0,2
neo4j_neo4j-ogm.org.neo4j.ogm.support.ClassUtils,3,0,0,0,0,0,0,0,3
neo4j_neo4j-ogm.org.neo4j.ogm.metadata.MetaData,10,1,0,7,0,1,0,1,20
neo4j_neo4j-ogm.org.neo4j.ogm.metadata.DomainInfo,70,1,0,70,0,0,0,0,141
neo4j_neo4j-ogm.org.neo4j.ogm.metadata.FieldInfo,11,0,0,11,0,0,0,0,22
neo4j_neo4j-ogm.org.neo4j.ogm.metadata.DescriptorMappings,2,0,0,1,0,0,0,0,3
neo4j_neo4j-ogm.org.neo4j.ogm.metadata.AnnotationsInfo,0,0,0,0,0,0,0,0,0
neo4j_neo4j-ogm.org.neo4j.ogm.metadata.schema.Schema,6,0,0,6,0,0,0,0,12
neo4j_neo4j-ogm.org.neo4j.ogm.metadata.schema.DomainInfoSchemaBuilder,3,0,0,3,0,0,0,0,6
neo4j_neo4j-ogm.org.neo4j.ogm.metadata.schema.Relationship,1,0,0,0,0,0,0,0,1
neo4j_neo4j-ogm.org.neo4j.ogm.metadata.reflect.EntityFactory,0,0,0,0,0,0,0,1,1
neo4j_neo4j-ogm.org.neo4j.ogm.metadata.reflect.EntityAccessManager,5,0,0,5,0,0,0,0,10
neo4j_neo4j-ogm.org.neo4j.ogm.types.spatial.GeographicPoint3d,1,0,0,1,0,0,0,0,2
neo4j_neo4j-ogm.org.neo4j.ogm.types.spatial.GeographicPoint2d,1,0,0,1,0,0,0,0,2
kaazing_k3po.org.kaazing.k3po.junit.rules.K3poRule,0,0,0,0,0,0,14,773,787
kaazing_k3po.org.kaazing.k3po.driver.internal.Robot,39,0,0,39,0,0,1,3,82
kaazing_k3po.org.kaazing.k3po.driver.internal.netty.channel.ChannelAddressFactory,2,0,0,2,0,0,0,1,5
kaazing_k3po.org.kaazing.k3po.driver.internal.netty.channel.ChannelAddressFactorySpi,0,0,0,0,0,0,0,0,0
kaazing_k3po.org.kaazing.k3po.driver.internal.behavior.ScriptProgress,1,0,0,1,0,0,0,0,2
kaazing_k3po.org.kaazing.k3po.lang.internal.RegionInfo,0,0,0,0,0,0,0,2,2
kaazing_k3po.org.kaazing.k3po.driver.internal.behavior.handler.ExecutionHandler,71,0,0,7,0,0,0,0,78
kaazing_k3po.org.kaazing.k3po.driver.internal.netty.channel.Channels,0,0,0,0,0,0,0,0,0
kaazing_k3po.org.kaazing.k3po.driver.internal.behavior.handler.codec.Masker,4,0,0,3,0,0,0,0,7
kaazing_k3po.org.kaazing.k3po.driver.internal.behavior.handler.codec.MessageDecoder,32,0,0,0,0,0,0,0,32
kaazing_k3po.org.kaazing.k3po.lang.internal.regex.NamedGroupPattern,15,0,0,15,0,0,0,6,36
kaazing_k3po.org.kaazing.k3po.driver.internal.behavior.handler.codec.http.HttpMethodDecoder,0,0,0,0,0,0,0,0,0
kaazing_k3po.org.kaazing.k3po.driver.internal.behavior.handler.barrier.AwaitBarrierDownstreamHandler,2,0,0,2,0,0,0,0,4
kaazing_k3po.org.kaazing.k3po.driver.internal.behavior.handler.barrier.AwaitBarrierUpstreamHandler,2,0,0,2,0,0,0,0,4
kaazing_k3po.org.kaazing.k3po.lang.internal.ast.builder.AstScriptNodeBuilder,0,0,0,0,0,0,0,6,6
kaazing_k3po.org.kaazing.k3po.driver.internal.control.PreparedMessage,0,0,0,0,0,0,0,0,0
kaazing_k3po.org.kaazing.k3po.driver.internal.control.ErrorMessage,0,0,0,0,0,0,0,0,0
kaazing_k3po.org.kaazing.k3po.driver.internal.control.FinishedMessage,0,0,0,0,0,0,0,0,0
kaazing_k3po.org.kaazing.k3po.driver.internal.control.PrepareMessage,0,0,0,0,0,0,0,0,0
kaazing_k3po.org.kaazing.k3po.lang.internal.ast.builder.AstWriteConfigNodeBuilder,10,0,0,10,0,0,0,0,20
kaazing_k3po.org.kaazing.k3po.lang.internal.ast.builder.AstReadConfigNodeBuilder,7,0,0,7,0,0,0,0,14
kaazing_k3po.org.kaazing.k3po.lang.internal.ast.builder.AstReadClosedNodeBuilder,1,0,0,1,0,0,0,0,2
kaazing_k3po.org.kaazing.k3po.lang.internal.ast.builder.AstWriteFlushNodeBuilder,1,0,0,1,0,0,0,0,2
kaazing_k3po.org.kaazing.k3po.lang.internal.ast.builder.AstWriteCloseNodeBuilder,1,0,0,1,0,0,0,0,2
kaazing_k3po.org.kaazing.k3po.lang.internal.ast.builder.AstWriteOptionNodeBuilder,1,0,0,1,0,0,0,0,2
kaazing_k3po.org.kaazing.k3po.lang.internal.ast.builder.AstReadOptionNodeBuilder,1,0,0,1,0,0,0,0,2
kaazing_k3po.org.kaazing.k3po.pcap.converter.internal.author.emitter.EmitterFactoryImpl,0,0,0,0,0,0,0,0,0
kaazing_k3po.org.kaazing.k3po.pcap.converter.internal.author.composer.TcpServerComposer,2,0,0,3,0,0,0,0,5
kaazing_k3po.org.kaazing.k3po.pcap.converter.internal.PcapConverter,9,0,0,0,0,5,0,0,14
kaazing_k3po.org.kaazing.k3po.pcap.converter.internal.author.composer.TcpClientComposer,2,0,0,3,0,0,0,0,5
kaazing_k3po.org.kaazing.k3po.pcap.converter.internal.filter.IpFilter,0,0,0,0,0,0,0,0,0
kaazing_k3po.org.kaazing.k3po.pcap.converter.internal.author.RptScriptCreator,0,0,0,0,0,0,0,0,0
kaazing_k3po.org.kaazing.k3po.pcap.converter.internal.author.emitter.EmitterFactory,0,0,0,0,0,0,0,0,0
kaazing_k3po.org.kaazing.k3po.pcap.converter.internal.packet.Packet,1,0,0,1,0,0,0,0,2
kaazing_k3po.org.kaazing.k3po.pcap.converter.internal.author.coordinator.TcpCoordinator,0,0,0,4,0,0,0,0,4
kaazing_k3po.org.kaazing.k3po.pcap.converter.internal.filter.Filter,0,0,0,0,0,0,0,0,0
kaazing_k3po.org.kaazing.k3po.pcap.converter.internal.parser.Parser,1,1,0,1,0,0,0,0,3
kaazing_k3po.org.kaazing.k3po.pcap.converter.internal.author.script.ByteArrayWriter,0,0,0,0,0,0,0,6,6
kaazing_k3po.org.kaazing.specification.ws.internal.Functions,0,0,0,0,0,0,0,0,0
kaazing_k3po.org.kaazing.specification.wse.internal.Functions,2,0,0,1,0,0,0,0,3
kaazing_k3po.org.kaazing.k3po.lang.internal.parser.ScriptParserImpl,13,0,0,13,0,0,1,0,27
kaazing_k3po.org.kaazing.k3po.lang.internal.ast.AstReadValueNode,4,0,0,4,0,0,0,0,8
kaazing_k3po.org.kaazing.k3po.lang.internal.ast.AstWriteValueNode,2,0,0,2,0,0,0,0,4
kaazing_k3po.org.kaazing.k3po.lang.internal.ast.builder.AstAcceptNodeBuilder,0,0,0,0,0,0,0,0,0
kaazing_k3po.org.kaazing.k3po.lang.internal.ast.builder.AstRejectedNodeBuilder,0,0,0,0,0,0,0,0,0
kaazing_k3po.org.kaazing.k3po.lang.internal.ast.builder.AstConnectAbortNodeBuilder,0,0,0,0,0,0,0,0,0
kaazing_k3po.org.kaazing.k3po.lang.internal.ast.builder.AstConnectAbortedNodeBuilder,0,0,0,0,0,0,0,0,0
kaazing_k3po.org.kaazing.k3po.lang.internal.ast.builder.AstCloseNodeBuilder,0,0,0,0,0,0,0,0,0
kaazing_k3po.org.kaazing.k3po.lang.internal.ast.builder.AstWriteAbortNodeBuilder,0,0,0,0,0,0,0,0,0
kaazing_k3po.org.kaazing.k3po.lang.internal.ast.builder.AstReadAbortNodeBuilder,0,0,0,0,0,0,0,0,0
kaazing_k3po.org.kaazing.k3po.lang.internal.ast.builder.AstReadAbortedNodeBuilder,0,0,0,0,0,0,0,0,0
kaazing_k3po.org.kaazing.k3po.lang.internal.ast.builder.AstWriteAbortedNodeBuilder,0,0,0,0,0,0,0,0,0
kaazing_k3po.org.kaazing.k3po.lang.internal.ast.builder.AstClosedNodeBuilder,0,0,0,0,0,0,0,0,0
kaazing_k3po.org.kaazing.k3po.lang.internal.ast.builder.AstConnectedNodeBuilder,0,0,0,0,0,0,0,0,0
kaazing_k3po.org.kaazing.k3po.lang.internal.ast.builder.AstReadNodeBuilder,14,0,0,14,0,0,0,0,28
kaazing_k3po.org.kaazing.k3po.lang.internal.ast.builder.AstWriteNodeBuilder,12,0,0,12,0,0,0,0,24
kaazing_k3po.org.kaazing.k3po.lang.internal.ast.builder.AstReadAwaitNodeBuilder,1,0,0,1,0,0,0,0,2
kaazing_k3po.org.kaazing.k3po.lang.internal.ast.builder.AstReadNotifyNodeBuilder,1,0,0,1,0,0,0,0,2
kaazing_k3po.org.kaazing.k3po.lang.internal.ast.builder.AstWriteAwaitNodeBuilder,1,0,0,1,0,0,0,0,2
kaazing_k3po.org.kaazing.k3po.lang.internal.ast.builder.AstWriteNotifyNodeBuilder,1,0,0,1,0,0,0,0,2
kaazing_k3po.org.kaazing.k3po.lang.internal.ast.builder.AstReadAdviseNodeBuilder,0,0,0,0,0,0,0,0,0
kaazing_k3po.org.kaazing.k3po.lang.internal.ast.builder.AstWriteAdviseNodeBuilder,0,0,0,0,0,0,0,0,0
kaazing_k3po.org.kaazing.k3po.lang.internal.ast.builder.AstReadAdvisedNodeBuilder,0,0,0,0,0,0,0,0,0
kaazing_k3po.org.kaazing.k3po.lang.internal.ast.builder.AstWriteAdvisedNodeBuilder,0,0,0,0,0,0,0,0,0
kaazing_k3po.org.kaazing.k3po.lang.internal.ast.builder.AstPropertyNodeBuilder,0,0,0,0,0,0,0,0,0
kaazing_k3po.org.kaazing.k3po.lang.el.spi.FunctionMapperSpi,2,0,0,0,0,0,0,0,2
kaazing_k3po.org.kaazing.k3po.control.internal.Control,0,0,0,0,0,0,0,6,6
devnied_EMV-NFC-Paycard-Enrollment.com.github.devnied.emvnfccard.utils.CPLCUtils,2,0,0,2,0,0,0,0,4
devnied_EMV-NFC-Paycard-Enrollment.com.github.devnied.emvnfccard.utils.TrackUtils,7,0,0,7,0,0,0,0,14
devnied_EMV-NFC-Paycard-Enrollment.com.github.devnied.emvnfccard.utils.ResponseUtils,2,0,0,0,0,0,0,0,2
devnied_EMV-NFC-Paycard-Enrollment.com.github.devnied.emvnfccard.utils.AtrUtils,3,0,0,1,0,0,0,0,4
devnied_EMV-NFC-Paycard-Enrollment.com.github.devnied.emvnfccard.utils.CommandApdu,1,0,0,0,0,0,0,0,1
devnied_EMV-NFC-Paycard-Enrollment.com.github.devnied.emvnfccard.utils.TlvUtil,2,0,0,0,0,0,0,0,2
devnied_EMV-NFC-Paycard-Enrollment.com.github.devnied.emvnfccard.iso7816emv.ITag,2,0,0,2,0,0,0,0,4
devnied_EMV-NFC-Paycard-Enrollment.com.github.devnied.emvnfccard.model.Application,3,0,0,2,0,0,0,0,5
devnied_EMV-NFC-Paycard-Enrollment.com.github.devnied.emvnfccard.model.EmvTransactionRecord,3,0,0,3,0,0,0,0,6
devnied_EMV-NFC-Paycard-Enrollment.com.github.devnied.emvnfccard.parser.impl.ProviderWrapper,0,0,0,0,0,0,0,2,2
devnied_EMV-NFC-Paycard-Enrollment.com.github.devnied.emvnfccard.parser.apdu.annotation.AnnotationData,1,0,0,0,0,0,0,0,1
devnied_EMV-NFC-Paycard-Enrollment.com.github.devnied.emvnfccard.parser.apdu.impl.DataFactory,2,0,0,0,0,0,0,0,2
devnied_EMV-NFC-Paycard-Enrollment.com.github.devnied.emvnfccard.model.EmvCard,3,0,0,3,0,0,0,0,6
devnied_EMV-NFC-Paycard-Enrollment.com.github.devnied.emvnfccard.iso7816emv.ITerminal,5,0,0,0,0,0,0,0,5
devnied_EMV-NFC-Paycard-Enrollment.com.github.devnied.emvnfccard.iso7816emv.TLV,1,0,0,1,0,1,0,0,3
devnied_EMV-NFC-Paycard-Enrollment.com.github.devnied.emvnfccard.iso7816emv.TagAndLength,1,0,0,1,0,0,0,0,2
devnied_EMV-NFC-Paycard-Enrollment.com.github.devnied.emvnfccard.iso7816emv.impl.TagImpl,1,0,0,1,0,0,0,0,2
devnied_EMV-NFC-Paycard-Enrollment.com.github.devnied.emvnfccard.iso7816emv.TerminalTransactionQualifiers,1,0,0,1,0,0,0,0,2
devnied_EMV-NFC-Paycard-Enrollment.com.github.devnied.emvnfccard.iso7816emv.ByteArrayWrapper,1,0,0,1,0,0,0,0,2
devnied_EMV-NFC-Paycard-Enrollment.com.github.devnied.emvnfccard.parser.EmvTemplate,25,0,0,25,0,1,0,2,53
devnied_EMV-NFC-Paycard-Enrollment.com.github.devnied.emvnfccard.model.Afl,1,0,0,1,0,0,0,0,2
Kixeye_chassis.com.kixeye.chassis.transport.serde.MessageSerDe,10,0,0,7,0,0,0,0,17
Kixeye_chassis.com.kixeye.chassis.transport.serde.converter.JsonJacksonMessageSerDe,0,0,0,0,0,0,0,0,0
Kixeye_chassis.com.kixeye.chassis.transport.serde.converter.XmlMessageSerDe,0,0,0,0,0,0,1,0,1
Kixeye_chassis.com.kixeye.chassis.transport.serde.converter.YamlJacksonMessageSerDe,0,0,0,0,0,0,0,0,0
Kixeye_chassis.com.kixeye.chassis.transport.serde.converter.ProtobufMessageSerDe,0,0,0,0,0,0,0,0,0
Kixeye_chassis.com.kixeye.chassis.transport.serde.converter.BsonJacksonMessageSerDe,0,0,0,0,0,0,0,0,0
sualeh_magnetictrackparser.us.fatehi.magnetictrack.BaseTrackData,1,0,0,0,0,0,0,0,1
sualeh_magnetictrackparser.us.fatehi.magnetictrack.Track1FormatB,1,0,0,1,0,0,0,3,5
sualeh_magnetictrackparser.us.fatehi.magnetictrack.Track3,0,0,0,0,0,0,0,2,2
sualeh_magnetictrackparser.us.fatehi.magnetictrack.BankCardMagneticTrack,12,0,0,12,0,0,0,0,24
sualeh_magnetictrackparser.us.fatehi.magnetictrack.Track2,0,0,0,0,0,0,0,2,2
poetix_protonpack.com.codepoetics.protonpack.Seq,0,0,0,0,0,0,0,0,0
poetix_protonpack.com.codepoetics.protonpack.maps.MapStream,5,0,0,2,0,0,0,0,7
poetix_protonpack.com.codepoetics.protonpack.collectors.CollectorUtils,0,0,0,0,0,0,0,1,1
poetix_protonpack.com.codepoetics.protonpack.selectors.Selectors,0,0,0,0,0,0,0,0,0
poetix_protonpack.com.codepoetics.protonpack.Streamable,1,0,0,0,0,0,0,0,1
poetix_protonpack.com.codepoetics.protonpack.collectors.CompletableFutures,0,0,0,0,0,2,0,0,2
gridkit_nanocloud.org.gridkit.vicluster.ViConfigurable,0,0,0,0,0,0,0,0,0
gridkit_nanocloud.org.gridkit.nanocloud.CloudFactory,0,0,0,0,0,1,0,7,8
gridkit_nanocloud.org.gridkit.nanocloud.Cloud,5,0,0,4,0,3,0,6,18
gridkit_nanocloud.org.gridkit.vicluster.ViExecutor,2,0,0,0,0,1,0,4,7
gridkit_nanocloud.org.gridkit.vicluster.isolate.IsolateProps,0,0,0,0,0,0,0,3,3
gridkit_nanocloud.org.gridkit.nanocloud.SimpleCloudFactory,1,0,0,1,0,0,0,9,11
gridkit_nanocloud.org.gridkit.vicluster.telecontrol.ssh.SimpleSshSessionProvider,0,0,0,0,0,0,0,1,1
gridkit_nanocloud.org.gridkit.vicluster.telecontrol.ssh.ConfigurableSshSessionProvider,1,0,0,1,0,0,0,0,2
gridkit_nanocloud.org.gridkit.vicluster.telecontrol.ssh.TunnellerJvmReplicator,0,0,0,0,0,0,0,1,1
gridkit_nanocloud.org.gridkit.vicluster.telecontrol.ssh.ConfigurableSshReplicator,1,0,0,0,0,0,0,0,1
gridkit_nanocloud.org.gridkit.vicluster.telecontrol.ssh.SftFileCache,0,0,0,0,0,0,0,1,1
gridkit_nanocloud.org.gridkit.vicluster.telecontrol.Classpath,1,0,0,1,0,0,0,1,3
gridkit_nanocloud.org.gridkit.nanocloud.telecontrol.HostControlConsole,11,0,0,4,0,0,2,1,18
gridkit_nanocloud.org.gridkit.vicluster.telecontrol.ssh.StreamHelper,0,0,0,0,0,0,0,0,0
gridkit_nanocloud.org.gridkit.lab.util.shell.Tailer,0,0,0,0,0,0,0,1,1
gridkit_nanocloud.org.gridkit.lab.util.shell.Shell,0,0,0,0,0,0,0,1,1
gridkit_nanocloud.org.gridkit.vicluster.ViGroup,1,0,0,1,0,0,0,0,2
gridkit_nanocloud.org.gridkit.vicluster.ViManager,3,0,0,3,0,1,0,1,8
gridkit_nanocloud.org.gridkit.vicluster.WildProps,2,0,0,2,0,0,0,0,4
gridkit_nanocloud.org.gridkit.vicluster.ViNodeSet,0,0,0,0,0,0,0,0,0
gridkit_nanocloud.org.gridkit.vicluster.GlobHelper,0,0,0,0,0,0,0,0,0
gridkit_nanocloud.org.gridkit.zerormi.SmartAnonMarshaler,0,0,0,0,0,0,0,0,0
gridkit_nanocloud.org.gridkit.zerormi.RmiGateway,3,0,0,0,0,3,0,0,6
gridkit_nanocloud.org.gridkit.zerormi.EnvelopOutputStream,5,0,0,5,0,0,0,0,10
gridkit_nanocloud.org.gridkit.zerormi.zlog.LogStream,0,0,0,0,0,0,0,1,1
gridkit_nanocloud.org.gridkit.zerormi.zlog.AbstractLogStream,0,0,0,0,0,0,0,1,1
gridkit_nanocloud.org.gridkit.nanocloud.telecontrol.StreamHelper,0,0,0,0,0,0,0,0,0
gridkit_nanocloud.org.gridkit.nanocloud.jmx.MBeanForwarder,0,0,0,0,0,0,0,2,2
gridkit_nanocloud.org.gridkit.nanocloud.viengine.PragmaMap,6,0,0,6,0,0,0,0,12
gridkit_nanocloud.org.gridkit.vicluster.telecontrol.ClasspathUtils,3,0,0,0,0,0,0,0,3
gridkit_nanocloud.org.gridkit.util.concurrent.FutureBox,1,3,0,0,0,0,0,0,4
gridkit_nanocloud.org.gridkit.vicluster.telecontrol.bootstraper.TunnellerConnection,0,0,0,0,0,0,1,0,1
gridkit_nanocloud.org.gridkit.vicluster.telecontrol.LocalJvmProcessFactory,0,0,0,0,0,0,0,0,0
gridkit_nanocloud.org.gridkit.vicluster.isolate.Isolate,0,0,0,0,0,1,0,0,1
gridkit_nanocloud.org.gridkit.vicluster.telecontrol.jvm.JvmProps,1,0,0,1,0,0,0,0,2
gridkit_nanocloud.org.gridkit.vicluster.isolate.IsolateViNode,0,0,0,0,0,0,0,1,1
gridkit_nanocloud.org.gridkit.nanocloud.interceptor.Intercept,1,0,0,0,0,1,0,3,5
gridkit_nanocloud.org.gridkit.util.concurrent.SensibleTaskService,0,0,0,0,0,0,0,1,1
gridkit_nanocloud.org.gridkit.lab.interceptor.BinaryCutPoints,1,0,0,0,0,0,0,0,1
gridkit_nanocloud.org.gridkit.lab.interceptor.ReflectionMethodCallSiteHookContext,0,0,0,0,0,0,0,0,0
gridkit_nanocloud.org.gridkit.nanocloud.test.maven.MavenClasspathManager,2,0,0,2,0,0,0,0,4
jackpf_ApkDownloader.com.actionbarsherlock.internal.ActionBarSherlockCompat,1,0,0,0,0,0,0,0,1
xhanin_jarup.io.github.xhanin.jarup.Jarup,1,0,0,0,0,0,0,0,1
xhanin_jarup.io.github.xhanin.jarup.WorkingCopy,7,0,0,7,0,0,0,0,14
xhanin_jarup.io.github.xhanin.jarup.commands.CatCommand,0,0,0,0,0,0,0,0,0
xhanin_jarup.io.github.xhanin.jarup.commands.SetPropertyCommand,0,0,0,0,0,0,0,0,0
xhanin_jarup.io.github.xhanin.jarup.commands.AddCommand,0,0,0,0,0,0,0,0,0
xhanin_jarup.io.github.xhanin.jarup.commands.SearchReplaceCommand,0,0,0,0,0,0,0,0,0
jvirtanen_parity.com.paritytrading.parity.match.OrderBook,0,0,0,0,0,0,0,0,0
jvirtanen_parity.com.paritytrading.parity.file.taq.TAQWriter,0,0,0,0,0,0,0,0,0
jvirtanen_parity.com.paritytrading.parity.util.TableHeader,0,0,0,0,0,0,0,0,0
jvirtanen_parity.com.paritytrading.parity.util.Instruments,0,0,0,0,0,0,0,0,0
jvirtanen_parity.com.paritytrading.parity.util.Timestamps,0,0,0,0,0,0,0,0,0
jvirtanen_parity.com.paritytrading.parity.book.Market,10,0,0,8,0,0,0,0,18
pusher_pusher-http-java.com.pusher.rest.crypto.nacl.SecretBox,1,0,0,1,0,0,0,0,2
pusher_pusher-http-java.com.pusher.rest.crypto.CryptoUtil,2,0,0,2,0,0,0,0,4
pusher_pusher-http-java.com.pusher.rest.PusherAbstract,0,0,0,0,0,0,0,11,11
pusher_pusher-http-java.com.pusher.rest.PusherException,5,0,0,0,0,0,0,0,5
pusher_pusher-http-java.com.pusher.rest.PusherAsync,8,0,0,8,0,0,0,0,16
pusher_pusher-http-java.com.pusher.rest.SignatureUtil,2,0,0,0,0,0,0,0,2
pusher_pusher-http-java.com.pusher.rest.Pusher,8,0,0,8,0,0,0,0,16
ysc_word.org.apdplat.word.analysis.TextSimilarity,0,0,0,0,0,0,0,0,0
ysc_word.org.apdplat.word.segmentation.Segmentation,0,0,0,0,0,0,0,0,0
ysc_word.org.apdplat.word.util.WordConfTools,1,0,0,0,0,1,0,0,2
ysc_word.org.apdplat.word.util.Utils,1,0,0,0,0,1,0,0,2
ysc_word.org.apdplat.word.recognition.RecognitionTool,4,0,0,0,0,0,0,0,4
ysc_word.org.apdplat.word.recognition.Punctuation,2,0,0,0,0,0,0,0,2
ysc_word.org.apdplat.word.util.GenericTrie,2,0,0,1,0,2,0,0,5
ysc_word.org.apdplat.word.util.DoubleArrayGenericTrie,2,0,0,1,0,2,0,0,5
ysc_word.org.apdplat.word.dictionary.Dictionary,4,0,0,4,0,6,0,0,14
ysc_word.org.apdplat.word.dictionary.impl.DictionaryTrie,2,0,0,0,0,0,0,0,2
larsga_Duke.no.priv.garshol.duke.RDBMSLinkDatabase,4,0,0,4,0,0,0,0,8
larsga_Duke.no.priv.garshol.duke.LinkDatabase,5,0,0,4,0,0,0,0,9
larsga_Duke.no.priv.garshol.duke.utils.NTriplesWriter,8,0,0,8,0,0,0,0,16
larsga_Duke.no.priv.garshol.duke.utils.SparqlResult,6,0,0,6,0,0,0,0,12
larsga_Duke.no.priv.garshol.duke.utils.CommandLineParser,5,0,0,5,0,0,0,0,10
larsga_Duke.no.priv.garshol.duke.utils.ObjectUtils,1,0,0,0,0,0,0,0,1
larsga_Duke.no.priv.garshol.duke.Configuration,0,0,0,0,0,0,0,0,0
larsga_Duke.no.priv.garshol.duke.ConfigurationImpl,8,0,0,7,0,0,0,2,17
larsga_Duke.no.priv.garshol.duke.genetic.GeneticConfiguration,1,0,0,1,0,0,0,0,2
larsga_Duke.no.priv.garshol.duke.Record,25,0,0,1,0,0,0,0,26
larsga_Duke.no.priv.garshol.duke.Database,14,0,0,14,0,0,0,1,29
larsga_Duke.no.priv.garshol.duke.ConfigLoader,6,0,0,6,0,0,0,0,12
larsga_Duke.no.priv.garshol.duke.Processor,3,0,0,0,0,0,0,0,3
larsga_Duke.no.priv.garshol.duke.datasources.SparqlDataSource,12,0,0,11,0,0,0,0,23
larsga_Duke.no.priv.garshol.duke.datasources.Column,4,0,0,4,0,0,0,0,8
larsga_Duke.no.priv.garshol.duke.cleaners.PhoneNumberCleaner,0,0,0,0,0,0,0,0,0
larsga_Duke.no.priv.garshol.duke.Cleaner,0,0,0,0,0,0,0,0,0
larsga_Duke.no.priv.garshol.duke.comparators.QGramComparator,0,0,0,0,0,0,0,0,0
larsga_Duke.no.priv.garshol.duke.utils.LinkDatabaseUtils,0,0,0,0,0,0,0,0,0
larsga_Duke.no.priv.garshol.duke.ConfigWriter,5,0,0,5,0,0,0,0,10
larsga_Duke.no.priv.garshol.duke.Property,4,0,0,4,0,0,0,0,8
larsga_Duke.no.priv.garshol.duke.InMemoryLinkDatabase,5,0,0,5,0,0,0,1,11
larsga_Duke.no.priv.garshol.duke.EquivalenceClassDatabase,0,0,0,0,0,0,0,0,0
indexiatech_antiquity.co.indexia.antiquity.graph.VersionedGraphBase,1,0,0,0,0,0,0,0,1
indexiatech_antiquity.co.indexia.antiquity.graph.ActiveVersionedGraph,14,1,0,14,0,0,0,0,29
indexiatech_antiquity.co.indexia.antiquity.graph.HistoricVersionedElement,1,0,0,0,0,0,0,0,1
indexiatech_antiquity.co.indexia.antiquity.graph.VersionContextGraph,4,0,0,2,0,0,0,0,6
marcosvidolin_doco.com.vidolima.doco.Doco,4,0,0,0,0,0,0,0,4
marcosvidolin_doco.com.vidolima.doco.ObjectParser,1,0,0,0,0,0,0,0,1
fiji_TrackMate.fiji.plugin.trackmate.Model,5,0,0,5,0,0,0,0,10
fiji_TrackMate.fiji.plugin.trackmate.TrackModel,19,5,0,18,0,0,0,0,42
fiji_TrackMate.fiji.plugin.trackmate.SpotCollection,15,3,0,14,0,0,0,0,32
fiji_TrackMate.fiji.plugin.trackmate.tracking.sparselap.linker.SparseCostMatrix,3,0,0,1,0,0,0,0,4
fiji_TrackMate.fiji.plugin.trackmate.features.track.AbstractTrackAnalyzer,4,0,0,4,0,0,0,0,8
fiji_TrackMate.fiji.plugin.trackmate.features.track.TrackIndexAnalyzer,0,0,0,0,0,0,0,0,0
fiji_TrackMate.fiji.plugin.trackmate.Spot,1,0,0,0,0,0,0,0,1
fiji_TrackMate.fiji.plugin.trackmate.SpotRoi,0,0,0,0,0,0,0,0,0
fiji_TrackMate.fiji.plugin.trackmate.action.CloseGapsByLinearInterpolationAction,0,0,0,0,0,0,0,3,3
fiji_TrackMate.fiji.plugin.trackmate.features.edges.AbstractEdgeAnalyzer,3,0,0,3,0,0,0,0,6
fiji_TrackMate.fiji.plugin.trackmate.FeatureModel,1,0,0,1,0,0,0,0,2
apache_metamodel.org.apache.metamodel.factory.DataContextPropertiesImpl,2,0,0,2,0,0,0,1,5
apache_metamodel.org.apache.metamodel.query.InvokableQuery,22,0,0,22,0,0,0,0,44
apache_metamodel.org.apache.metamodel.jdbc.JdbcDataContext,6,0,0,6,0,1,0,0,13
apache_metamodel.org.apache.metamodel.jdbc.dialects.PostgresqlQueryRewriter,0,0,0,0,0,0,0,1,1
apache_metamodel.org.apache.metamodel.query.SelectItem,1,0,0,1,0,0,0,0,2
apache_metamodel.org.apache.metamodel.jdbc.dialects.IQueryRewriter,0,0,0,0,0,0,0,0,0
apache_metamodel.org.apache.metamodel.query.Query,3,0,0,3,0,0,0,0,6
apache_metamodel.org.apache.metamodel.AbstractDataContext,34,0,0,33,0,3,0,2,72
apache_metamodel.org.apache.metamodel.data.DataSet,15,0,0,15,0,0,0,1,31
apache_metamodel.org.apache.metamodel.DataContext,14,0,0,14,0,0,0,0,28
apache_metamodel.org.apache.metamodel.schema.Schema,46,2,0,46,0,0,0,2,96
apache_metamodel.org.apache.metamodel.query.builder.SatisfiedQueryBuilder,1,0,0,1,0,0,0,0,2
apache_metamodel.org.apache.metamodel.util.AbstractResource,4,0,0,3,0,1,0,0,8
apache_metamodel.org.apache.metamodel.util.NumberComparator,10,0,0,0,0,0,0,0,10
apache_metamodel.org.apache.metamodel.util.FileResource,2,0,0,2,0,1,0,0,5
apache_metamodel.org.apache.metamodel.data.AbstractDataSet,1,0,0,1,0,0,0,0,2
apache_metamodel.org.apache.metamodel.neo4j.Neo4jRequestWrapper,9,1,0,7,0,0,0,0,17
apache_metamodel.org.apache.metamodel.neo4j.Neo4jDataContext,2,0,0,2,0,0,0,0,4
apache_metamodel.org.apache.metamodel.neo4j.ColumnTypeResolver,1,0,0,0,0,0,0,0,1
apache_metamodel.org.apache.metamodel.couchdb.CouchDbDataContext,4,0,0,4,0,0,0,0,8
apache_metamodel.org.apache.metamodel.create.AbstractTableCreationBuilder,4,0,0,4,0,0,0,0,8
apache_metamodel.org.apache.metamodel.schema.Table,3,0,0,3,0,0,0,0,6
apache_metamodel.org.apache.metamodel.query.builder.FilterBuilder,0,0,0,0,0,0,0,1,1
apache_metamodel.org.apache.metamodel.hbase.HBaseRowDeletionBuilder,0,0,0,0,0,0,0,1,1
apache_metamodel.org.apache.metamodel.insert.RowInsertionBuilder,1,0,0,0,0,0,0,4,5
apache_metamodel.org.apache.metamodel.schema.MutableTable,0,0,0,0,0,0,0,1,1
apache_metamodel.org.apache.metamodel.hbase.HBaseDataContext,0,0,0,0,0,0,0,1,1
apache_metamodel.org.apache.metamodel.hbase.HBaseClient,0,0,0,0,0,0,0,10,10
apache_metamodel.org.apache.metamodel.MetaModelHelper,8,0,0,8,0,0,0,0,16
apache_metamodel.org.apache.metamodel.factory.DataContextFactoryRegistry,1,1,0,1,0,0,0,0,3
apache_metamodel.org.apache.metamodel.factory.ResourceFactoryRegistry,4,0,0,4,0,0,0,0,8
apache_metamodel.org.apache.metamodel.query.builder.InitFromBuilder,2,0,0,2,0,0,0,0,4
apache_metamodel.org.apache.metamodel.mongodb.mongo3.MongoDbDataContext,2,0,0,2,0,0,0,0,4
apache_metamodel.org.apache.metamodel.insert.AbstractRowInsertionBuilder,0,0,0,0,0,1,0,0,1
apache_metamodel.org.apache.metamodel.schema.MutableSchema,3,0,0,3,0,0,0,0,6
apache_metamodel.org.apache.metamodel.schema.ImmutableSchema,1,0,0,1,0,0,0,0,2
apache_metamodel.org.apache.metamodel.schema.naming.ColumnNamingStrategy,2,0,0,2,0,0,0,0,4
apache_metamodel.org.apache.metamodel.data.UnionDataSet,1,0,0,1,0,0,0,0,2
apache_metamodel.org.apache.metamodel.query.ScalarFunction,0,0,0,0,0,0,0,0,0
apache_metamodel.org.apache.metamodel.query.DefaultCompiledQuery,1,0,0,1,0,0,0,0,2
apache_metamodel.org.apache.metamodel.query.FunctionType,3,0,0,0,0,0,0,0,3
apache_metamodel.org.apache.metamodel.query.AggregateFunction,3,0,0,0,0,0,0,0,3
apache_metamodel.org.apache.metamodel.query.RandomAggregateBuilder,0,1,0,0,0,0,0,0,1
apache_metamodel.org.apache.metamodel.csv.CsvDataContext,2,0,0,2,0,0,0,0,4
apache_metamodel.org.apache.metamodel.excel.ExcelDataContext,5,0,0,5,0,0,0,2,12
apache_metamodel.org.apache.metamodel.data.AbstractRow,1,0,0,1,0,0,0,0,2
apache_metamodel.org.apache.metamodel.schema.MutableColumn,0,0,0,0,0,0,0,0,0
apache_metamodel.org.apache.metamodel.csv.CsvWriter,0,0,0,0,0,0,0,0,0
apache_metamodel.org.apache.metamodel.fixedwidth.FixedWidthConfigurationReader,2,0,0,2,0,0,0,0,4
apache_metamodel.org.apache.metamodel.fixedwidth.FixedWidthLineParser,1,0,0,0,0,0,0,1,2
apache_metamodel.org.apache.metamodel.fixedwidth.FixedWidthReader,4,0,0,0,0,0,0,0,4
apache_metamodel.org.apache.metamodel.UpdateableDataContext,4,0,0,2,0,2,0,0,8
kuujo_copycat.io.atomix.rest.impl.EventLog,1,0,0,1,0,0,0,0,2
kuujo_copycat.io.atomix.utils.net.Address,4,0,0,4,0,0,1,0,9
kuujo_copycat.io.atomix.cluster.Member,0,0,0,1,0,0,0,1,2
kuujo_copycat.io.atomix.primitive.operation.OperationId,1,0,0,1,0,0,0,0,2
kuujo_copycat.io.atomix.primitive.service.ServiceExecutor,1,0,0,1,0,0,0,0,2
kuujo_copycat.io.atomix.primitive.partition.PrimaryTerm,5,0,0,5,0,0,0,0,10
kuujo_copycat.io.atomix.primitive.partition.impl.PrimaryElectorService,1,0,0,1,0,0,0,0,2
kuujo_copycat.io.atomix.utils.AbstractIdentifier,2,0,0,2,0,0,0,0,4
kuujo_copycat.io.atomix.primitive.session.SessionMetadata,1,0,0,1,0,0,0,0,2
kuujo_copycat.io.atomix.primitive.session.SessionId,0,0,0,0,0,0,0,0,0
kuujo_copycat.io.atomix.agent.AtomixAgent,2,0,0,2,0,0,1,0,5
kuujo_copycat.io.atomix.cluster.AtomixCluster,2,0,0,2,0,0,0,0,4
kuujo_copycat.io.atomix.primitive.log.LogConsumer,0,0,0,0,0,0,0,1,1
kuujo_copycat.io.atomix.primitive.log.LogProducer,0,0,0,0,0,0,0,1,1
kuujo_copycat.io.atomix.storage.journal.SegmentedJournal,0,0,0,0,0,0,0,2,2
kuujo_copycat.io.atomix.protocols.raft.RaftMetadataClient,1,0,0,1,0,0,0,0,2
kuujo_copycat.io.atomix.protocols.raft.RaftServer,1,0,0,1,0,0,1,6,9
kuujo_copycat.io.atomix.primitive.session.SessionClient,0,0,0,0,0,0,0,1,1
kuujo_copycat.io.atomix.protocols.raft.cluster.RaftCluster,0,0,0,0,0,0,0,1,1
kuujo_copycat.io.atomix.primitive.AsyncPrimitive,0,0,0,0,0,0,0,1,1
kuujo_copycat.io.atomix.protocols.raft.MultiRaftProtocolConfig,1,0,0,1,0,0,0,0,2
kuujo_copycat.io.atomix.protocols.raft.storage.RaftStorage,4,0,0,4,0,0,0,0,8
kuujo_copycat.io.atomix.protocols.raft.storage.snapshot.SnapshotFile,3,0,0,1,0,0,0,0,4
kuujo_copycat.io.atomix.protocols.raft.storage.snapshot.SnapshotStore,4,0,0,4,0,0,0,1,9
kuujo_copycat.io.atomix.protocols.raft.storage.snapshot.SnapshotDescriptor,2,0,0,2,0,0,0,0,4
kuujo_copycat.io.atomix.protocols.raft.impl.RaftServiceManager,2,0,0,2,0,0,0,0,4
kuujo_copycat.io.atomix.protocols.raft.session.RaftSessionRegistry,1,0,0,1,0,0,0,0,2
kuujo_copycat.io.atomix.protocols.raft.session.impl.RaftSessionState,2,0,0,2,0,0,0,0,4
kuujo_copycat.io.atomix.protocols.raft.session.impl.RaftSessionSequencer,6,0,0,6,0,0,0,0,12
kuujo_copycat.io.atomix.protocols.raft.session.impl.MemberSelectorManager,1,0,0,1,0,0,0,0,2
kuujo_copycat.io.atomix.protocols.raft.session.impl.MemberSelector,3,0,0,3,0,0,0,0,6
kuujo_copycat.io.atomix.protocols.raft.session.impl.RaftSessionInvoker,8,0,0,8,0,0,0,0,16
kuujo_copycat.io.atomix.utils.misc.Match,6,0,0,4,0,0,0,0,10
kuujo_copycat.io.atomix.utils.Generics,1,0,0,0,0,0,0,0,1
kuujo_copycat.io.atomix.utils.Version,2,0,0,2,0,0,0,1,5
kuujo_copycat.io.atomix.utils.misc.ArraySizeHashPrinter,0,0,0,0,0,0,0,0,0
kuujo_copycat.io.atomix.utils.misc.TimestampPrinter,0,0,0,0,0,0,1,0,1
kuujo_copycat.io.atomix.utils.logging.LoggerContext,0,0,0,0,0,0,0,0,0
kuujo_copycat.io.atomix.utils.misc.StringUtils,1,0,0,0,0,0,0,0,1
kuujo_copycat.io.atomix.utils.time.MultiValuedTimestamp,1,0,0,1,0,0,0,0,2
kuujo_copycat.io.atomix.utils.time.Version,1,0,0,1,0,0,0,0,2
kuujo_copycat.io.atomix.utils.time.WallClockTimestamp,1,0,0,1,0,0,0,0,2
kuujo_copycat.io.atomix.utils.time.LogicalTimestamp,1,0,0,1,0,0,0,0,2
kuujo_copycat.io.atomix.utils.time.Epoch,1,0,0,1,0,0,0,0,2
kuujo_copycat.io.atomix.utils.time.Versioned,19,0,0,3,0,0,0,0,22
kuujo_copycat.io.atomix.utils.time.WallClock,1,0,0,1,0,0,0,0,2
kuujo_copycat.io.atomix.utils.time.LogicalClock,1,0,0,1,0,0,0,0,2
kuujo_copycat.io.atomix.utils.serializer.BufferAwareByteArrayOutputStream,1,0,0,0,0,0,0,0,1
kuujo_copycat.io.atomix.utils.serializer.ByteArrayOutput,1,0,0,0,0,0,0,0,1
kuujo_copycat.io.atomix.cluster.Node,2,0,0,2,0,0,0,0,4
kuujo_copycat.io.atomix.cluster.messaging.impl.AbstractMessageEncoder,2,0,0,2,0,0,0,0,4
kuujo_copycat.io.atomix.cluster.messaging.impl.AbstractMessageDecoder,1,0,0,0,0,0,0,0,1
kuujo_copycat.io.atomix.cluster.messaging.BroadcastService,0,0,0,0,0,0,0,1,1
kuujo_copycat.io.atomix.cluster.messaging.MessagingService,4,0,0,3,0,2,0,0,9
kuujo_copycat.io.atomix.cluster.messaging.UnicastService,1,0,0,1,0,0,0,0,2
kuujo_copycat.io.atomix.storage.journal.JournalSegmentDescriptor,2,0,0,2,0,0,0,0,4
kuujo_copycat.io.atomix.storage.journal.JournalSegmentFile,0,0,0,0,0,0,0,0,0
kuujo_copycat.io.atomix.storage.journal.index.JournalIndex,1,0,0,1,0,0,0,0,2
kuujo_copycat.io.atomix.storage.buffer.HeapBuffer,0,0,0,0,0,0,0,0,0
kuujo_copycat.io.atomix.storage.buffer.Buffer,26,0,0,26,0,0,0,0,52
kuujo_copycat.io.atomix.storage.buffer.MappedBuffer,1,0,0,1,0,0,0,0,2
kuujo_copycat.io.atomix.storage.buffer.FileBuffer,3,0,0,3,0,0,0,0,6
kuujo_copycat.io.atomix.storage.buffer.DirectBuffer,1,0,0,1,0,0,0,0,2
kuujo_copycat.io.atomix.storage.buffer.BytesOutput,1,0,0,1,0,0,0,0,2
kuujo_copycat.io.atomix.core.idgenerator.AtomicIdGenerator,1,0,0,1,0,0,0,0,2
kuujo_copycat.io.atomix.core.idgenerator.impl.DelegatingAtomicIdGenerator,1,0,0,0,0,0,0,0,1
kuujo_copycat.io.atomix.core.AtomixConfig,23,0,0,23,0,0,0,0,46
kuujo_copycat.io.atomix.core.profile.ConsensusProfileBuilder,1,0,0,1,0,0,0,2,4
kuujo_copycat.io.atomix.core.profile.Profile,0,0,0,0,0,0,0,3,3
kuujo_copycat.io.atomix.core.Atomix,5,0,0,5,0,2,0,1,13
kuujo_copycat.io.atomix.core.AtomixBuilder,2,0,0,2,0,0,0,0,4
kuujo_copycat.io.atomix.core.lock.DistributedLock,1,0,0,0,0,0,0,2,3
kuujo_copycat.io.atomix.core.lock.AtomicLock,1,0,0,1,0,0,0,2,4
kuujo_copycat.io.atomix.primitive.service.ServiceContext,5,0,0,5,0,0,0,0,10
kuujo_copycat.io.atomix.utils.event.AbstractEvent,8,0,0,8,0,0,0,0,16
kuujo_copycat.io.atomix.core.queue.impl.DefaultDistributedQueueService,0,0,0,0,0,0,0,0,0
kuujo_copycat.io.atomix.core.value.AtomicValue,1,0,0,0,0,0,0,0,1
kuujo_copycat.io.atomix.core.value.AtomicValueEvent,1,0,0,0,0,0,0,0,1
kuujo_copycat.io.atomix.core.tree.DocumentPath,2,0,0,2,0,0,0,0,4
kuujo_copycat.io.atomix.core.tree.AtomicDocumentTree,1,0,0,1,0,0,0,0,2
kuujo_copycat.io.atomix.core.tree.impl.DefaultDocumentTreeService,1,0,0,1,0,0,0,0,2
kuujo_copycat.io.atomix.core.set.impl.DefaultDistributedNavigableSetService,0,0,0,0,0,0,0,0,0
kuujo_copycat.io.atomix.core.set.impl.DefaultDistributedSetService,0,0,0,0,0,0,0,0,0
kuujo_copycat.io.atomix.core.map.DistributedMap,4,0,0,3,0,0,0,0,7
kuujo_copycat.io.atomix.core.map.AtomicMap,2,0,0,2,0,0,0,0,4
kuujo_copycat.io.atomix.core.transaction.Transaction,3,0,0,3,0,0,0,0,6
kuujo_copycat.io.atomix.core.map.AtomicCounterMap,1,0,0,1,0,0,0,0,2
kuujo_copycat.io.atomix.core.map.AtomicCounterMapConfig,1,0,0,1,0,0,0,0,2
kuujo_copycat.io.atomix.core.map.AtomicNavigableMap,3,0,0,3,0,0,0,0,6
kuujo_copycat.io.atomix.core.map.impl.DefaultAtomicCounterMapService,0,0,0,0,0,0,0,0,0
kuujo_copycat.io.atomix.core.election.Leader,4,0,0,4,0,0,0,0,8
kuujo_copycat.io.atomix.core.election.LeaderElector,3,0,0,3,0,0,0,0,6
kuujo_copycat.io.atomix.core.election.Leadership,2,0,0,2,0,0,0,0,4
kuujo_copycat.io.atomix.primitive.SyncPrimitive,5,0,0,5,0,0,1,0,11
kuujo_copycat.io.atomix.core.election.LeaderElection,2,0,0,2,0,0,0,0,4
kuujo_copycat.io.atomix.core.election.impl.DefaultLeaderElectionService,1,0,0,1,0,0,0,0,2
kuujo_copycat.io.atomix.core.registry.SimpleRegistry,1,0,0,1,0,0,0,0,2
kuujo_copycat.io.atomix.core.multimap.DistributedMultimap,1,0,0,1,0,0,0,0,2
kuujo_copycat.io.atomix.core.multimap.AtomicMultimap,6,0,0,5,0,0,0,0,11
kuujo_copycat.io.atomix.core.workqueue.WorkQueue,6,0,0,6,0,0,0,0,12
kuujo_copycat.io.atomix.core.workqueue.impl.DefaultWorkQueueService,1,0,0,1,0,0,0,0,2
kuujo_copycat.io.atomix.core.semaphore.impl.AtomicSemaphoreServiceConfig,1,0,0,1,0,0,0,0,2
kuujo_copycat.io.atomix.core.list.impl.DefaultDistributedListService,0,0,0,0,0,0,0,0,0
kuujo_copycat.io.atomix.core.barrier.DistributedCyclicBarrierConfig,1,0,0,1,0,0,0,0,2
kuujo_copycat.io.atomix.core.barrier.AsyncDistributedCyclicBarrier,2,0,0,2,0,1,1,0,6
kuujo_copycat.io.atomix.core.counter.AtomicCounter,1,0,0,1,0,0,0,0,2
kuujo_copycat.io.atomix.core.counter.impl.DefaultAtomicCounterService,0,0,0,0,0,0,0,0,0
kuujo_copycat.io.atomix.core.multiset.DistributedMultiset,1,0,0,1,0,0,0,0,2
kuujo_copycat.io.atomix.core.multiset.impl.DefaultDistributedMultisetService,0,0,0,0,0,0,0,0,0
kuujo_copycat.io.atomix.core.AtomixRegistry,1,0,0,1,0,0,0,0,2
jmrozanec_cron-utils.com.cronutils.utils.CronFrequencyComparator,0,0,0,0,0,0,0,0,0
jmrozanec_cron-utils.com.cronutils.utils.StringUtils,1,0,0,0,0,0,0,0,1
jmrozanec_cron-utils.com.cronutils.utils.DateUtils,0,0,0,0,0,0,0,0,0
jmrozanec_cron-utils.com.cronutils.parser.CronParser,10,7,0,6,0,0,0,31,54
jmrozanec_cron-utils.com.cronutils.model.time.ExecutionTime,52,40,0,27,0,0,1,1,121
jmrozanec_cron-utils.com.cronutils.builder.CronBuilder,6,0,0,0,0,0,0,2,8
jmrozanec_cron-utils.com.cronutils.model.definition.CronDefinitionBuilder,45,21,0,26,0,4,3,18,117
jmrozanec_cron-utils.com.cronutils.parser.CronParserField,3,0,0,3,0,0,0,0,6
jmrozanec_cron-utils.com.cronutils.model.Cron,3,0,0,1,0,0,0,2,6
jmrozanec_cron-utils.com.cronutils.model.field.definition.FieldDefinition,3,0,0,0,0,0,0,0,3
jmrozanec_cron-utils.com.cronutils.model.definition.CronDefinition,2,1,0,0,0,0,0,0,3
jmrozanec_cron-utils.com.cronutils.model.field.definition.FieldDefinitionBuilder,0,0,0,0,0,0,0,1,1
jmrozanec_cron-utils.com.cronutils.model.field.CronField,1,0,0,1,0,0,0,0,2
jmrozanec_cron-utils.com.cronutils.parser.FieldParser,5,0,0,5,0,0,0,0,10
jmrozanec_cron-utils.com.cronutils.model.field.expression.On,1,0,0,0,0,0,0,0,1
jmrozanec_cron-utils.com.cronutils.model.field.expression.FieldExpression,3,0,0,3,0,0,0,1,7
jmrozanec_cron-utils.com.cronutils.model.field.expression.Between,2,0,0,1,0,0,0,0,3
jmrozanec_cron-utils.com.cronutils.model.field.expression.And,3,0,0,2,0,0,0,0,5
jmrozanec_cron-utils.com.cronutils.model.field.expression.Every,1,0,0,1,0,0,0,0,2
jmrozanec_cron-utils.com.cronutils.model.field.expression.visitor.ValidationFieldExpressionVisitor,3,1,0,0,0,0,0,1,5
jmrozanec_cron-utils.com.cronutils.model.time.TimeNode,2,0,0,0,0,0,0,2,4
jmrozanec_cron-utils.com.cronutils.model.time.NearestValue,0,0,0,0,0,0,0,0,0
jmrozanec_cron-utils.com.cronutils.descriptor.CronDescriptor,20,0,0,7,0,0,33,2,62
jmrozanec_cron-utils.com.cronutils.model.time.generator.OnDayOfMonthValueGenerator,2,0,0,0,0,0,0,0,2
jmrozanec_cron-utils.com.cronutils.model.time.generator.OnDayOfCalendarValueGenerator,7,0,0,0,0,0,0,0,7
jmrozanec_cron-utils.com.cronutils.model.time.generator.OnDayOfWeekValueGenerator,7,0,0,0,0,0,0,0,7
jmrozanec_cron-utils.com.cronutils.model.time.generator.FieldValueGenerator,1,0,0,1,0,0,0,0,2
jmrozanec_cron-utils.com.cronutils.model.time.generator.BetweenFieldValueGenerator,3,0,0,0,0,0,0,0,3
jmrozanec_cron-utils.com.cronutils.model.time.generator.AndFieldValueGenerator,3,0,0,0,0,0,0,0,3
jmrozanec_cron-utils.com.cronutils.model.time.generator.NullFieldValueGenerator,0,0,0,0,0,0,0,0,0
jmrozanec_cron-utils.com.cronutils.model.time.generator.AlwaysFieldValueGenerator,2,0,0,0,0,0,0,0,2
jmrozanec_cron-utils.com.cronutils.model.field.constraint.FieldConstraintsBuilder,0,0,0,0,0,0,0,0,0
jmrozanec_cron-utils.com.cronutils.model.time.generator.FieldValueGeneratorFactory,0,1,0,0,0,0,0,0,1
jmrozanec_cron-utils.com.cronutils.model.time.generator.EveryFieldValueGenerator,7,0,0,0,0,0,0,0,7
jmrozanec_cron-utils.com.cronutils.model.time.generator.OnFieldValueGenerator,3,0,0,0,0,0,0,0,3
jmrozanec_cron-utils.com.cronutils.converter.CronConverter,0,0,0,0,0,0,0,0,0
jmrozanec_cron-utils.com.cronutils.mapper.ConstantsMapper,4,0,0,0,0,0,0,0,4
jmrozanec_cron-utils.com.cronutils.mapper.CronMapper,2,0,0,2,0,0,0,0,4
jmrozanec_cron-utils.com.cronutils.mapper.WeekDay,0,0,0,0,0,0,0,0,0
jmrozanec_cron-utils.com.cronutils.descriptor.refactor.TimeDescriptor,0,0,0,0,0,0,0,0,0
GoogleCloudPlatform_bigdata-interop.com.google.cloud.hadoop.util.RetryDeterminer,1,0,0,0,0,0,0,0,1
GoogleCloudPlatform_bigdata-interop.com.google.cloud.hadoop.util.testing.MockHttpTransportHelper,21,0,0,12,0,0,0,0,33
GoogleCloudPlatform_bigdata-interop.com.google.cloud.hadoop.util.PropertyUtil,0,0,0,0,0,0,0,0,0
GoogleCloudPlatform_bigdata-interop.com.google.cloud.hadoop.util.ApiErrorExtractor,13,0,0,0,0,2,0,0,15
GoogleCloudPlatform_bigdata-interop.com.google.cloud.hadoop.util.IoExceptionHelper,3,0,0,0,0,0,0,0,3
GoogleCloudPlatform_bigdata-interop.com.google.cloud.hadoop.util.LazyExecutorService,2,0,0,1,0,0,0,0,3
GoogleCloudPlatform_bigdata-interop.com.google.cloud.hadoop.util.HttpTransportFactory,0,0,0,0,0,0,0,0,0
GoogleCloudPlatform_bigdata-interop.com.google.cloud.hadoop.util.HadoopConfigurationProperty,23,2,0,13,0,0,0,2,40
GoogleCloudPlatform_bigdata-interop.com.google.cloud.hadoop.util.testing.HadoopConfigurationUtils,0,0,0,0,0,0,0,0,0
GoogleCloudPlatform_bigdata-interop.com.google.cloud.hadoop.fs.gcs.GoogleHadoopFileSystem,40,0,0,30,0,0,1,8,79
GoogleCloudPlatform_bigdata-interop.com.google.cloud.hadoop.gcsio.StorageResourceId,5,0,0,4,0,0,0,0,9
GoogleCloudPlatform_bigdata-interop.com.google.cloud.hadoop.fs.gcs.GoogleHadoopFileSystemConfiguration,6,0,0,6,0,0,0,0,12
GoogleCloudPlatform_bigdata-interop.com.google.cloud.hadoop.fs.gcs.GoogleHadoopFSInputStream,1,0,0,0,0,0,0,0,1
GoogleCloudPlatform_bigdata-interop.com.google.cloud.hadoop.fs.gcs.InMemoryGlobberFileSystem,1,0,0,1,0,0,0,0,2
GoogleCloudPlatform_bigdata-interop.com.google.cloud.hadoop.fs.gcs.GoogleHadoopOutputStream,3,0,0,3,0,1,0,0,7
GoogleCloudPlatform_bigdata-interop.com.google.cloud.hadoop.gcsio.GoogleCloudStorageFileSystemOptions,5,0,0,5,0,0,0,0,10
GoogleCloudPlatform_bigdata-interop.com.google.cloud.hadoop.fs.gcs.GoogleHadoopFS,7,0,0,2,0,0,0,0,9
GoogleCloudPlatform_bigdata-interop.com.google.cloud.hadoop.io.bigquery.ShardedInputSplit,5,0,0,3,0,0,0,0,8
GoogleCloudPlatform_bigdata-interop.com.google.cloud.hadoop.io.bigquery.DirectBigQueryInputFormat,0,0,0,0,0,0,0,0,0
GoogleCloudPlatform_bigdata-interop.com.google.cloud.hadoop.io.bigquery.BigQueryConfiguration,6,0,0,4,0,0,0,1,11
GoogleCloudPlatform_bigdata-interop.com.google.cloud.hadoop.io.bigquery.BigQueryUtils,2,0,0,0,0,0,0,2,4
GoogleCloudPlatform_bigdata-interop.com.google.cloud.hadoop.io.bigquery.AbstractBigQueryInputFormat,3,0,0,3,0,0,0,0,6
GoogleCloudPlatform_bigdata-interop.com.google.cloud.hadoop.io.bigquery.BigQueryHelper,4,0,0,2,0,0,0,0,6
GoogleCloudPlatform_bigdata-interop.com.google.cloud.hadoop.io.bigquery.GsonRecordReader,4,0,0,4,0,0,0,0,8
GoogleCloudPlatform_bigdata-interop.com.google.cloud.hadoop.io.bigquery.BigQueryFactory,2,0,0,2,0,0,0,0,4
GoogleCloudPlatform_bigdata-interop.com.google.cloud.hadoop.io.bigquery.UnshardedExportToCloudStorage,2,0,0,0,0,2,0,0,4
GoogleCloudPlatform_bigdata-interop.com.google.cloud.hadoop.io.bigquery.output.BigQueryTableFieldSchema,1,0,0,1,0,0,0,0,2
GoogleCloudPlatform_bigdata-interop.com.google.cloud.hadoop.io.bigquery.BigQueryStrings,3,0,0,0,0,0,0,0,3
GoogleCloudPlatform_bigdata-interop.com.google.cloud.hadoop.io.bigquery.AvroRecordReader,0,0,0,0,0,0,0,0,0
GoogleCloudPlatform_bigdata-interop.com.google.cloud.hadoop.io.bigquery.NoopFederatedExportToCloudStorage,0,0,0,0,0,0,0,0,0
GoogleCloudPlatform_bigdata-interop.com.google.cloud.hadoop.io.bigquery.DirectBigQueryRecordReader,2,0,0,2,0,0,0,0,4
GoogleCloudPlatform_bigdata-interop.com.google.cloud.hadoop.io.bigquery.output.BigQueryOutputConfiguration,3,0,0,2,0,0,0,2,7
GoogleCloudPlatform_bigdata-interop.com.google.cloud.hadoop.io.bigquery.output.ForwardingBigQueryFileOutputCommitter,1,0,0,0,0,0,0,5,6
GoogleCloudPlatform_bigdata-interop.com.google.cloud.hadoop.io.bigquery.output.FederatedBigQueryOutputCommitter,0,0,0,0,0,0,0,0,0
GoogleCloudPlatform_bigdata-interop.com.google.cloud.hadoop.io.bigquery.output.IndirectBigQueryOutputCommitter,0,0,0,0,0,0,0,0,0
GoogleCloudPlatform_bigdata-interop.com.google.cloud.hadoop.io.bigquery.output.BigQueryTableSchema,1,0,0,1,0,0,0,0,2
GoogleCloudPlatform_bigdata-interop.com.google.cloud.hadoop.io.bigquery.output.BigQueryTimePartitioning,1,0,0,1,0,0,0,0,2
GoogleCloudPlatform_bigdata-interop.com.google.cloud.hadoop.gcsio.GoogleCloudStorage,127,0,0,109,0,2,2,37,277
GoogleCloudPlatform_bigdata-interop.com.google.cloud.hadoop.gcsio.PerformanceCachingGoogleCloudStorage,14,0,0,14,0,0,0,0,28
GoogleCloudPlatform_bigdata-interop.com.google.cloud.hadoop.gcsio.Watchdog,3,0,0,0,0,0,0,0,3
GoogleCloudPlatform_bigdata-interop.com.google.cloud.hadoop.gcsio.GoogleCloudStorageExceptions,2,0,0,0,0,0,0,0,2
GoogleCloudPlatform_bigdata-interop.com.google.cloud.hadoop.gcsio.ForwardingGoogleCloudStorage,0,0,0,0,0,0,0,21,21
GoogleCloudPlatform_bigdata-interop.com.google.cloud.hadoop.util.AsyncWriteChannelOptions,4,0,0,4,0,0,0,7,15
GoogleCloudPlatform_bigdata-interop.com.google.cloud.hadoop.util.AbstractGoogleAsyncWriteChannel,0,0,0,0,0,0,0,3,3
GoogleCloudPlatform_bigdata-interop.com.google.cloud.hadoop.gcsio.GoogleCloudStorageGrpcWriteChannel,0,0,0,0,0,0,0,0,0
GoogleCloudPlatform_bigdata-interop.com.google.cloud.hadoop.gcsio.GoogleCloudStorageGrpcReadChannel,11,0,0,10,0,0,0,5,26
GoogleCloudPlatform_bigdata-interop.com.google.cloud.hadoop.gcsio.GoogleCloudStorageReadOptions,9,0,0,4,0,0,0,0,13
GoogleCloudPlatform_bigdata-interop.com.google.cloud.hadoop.gcsio.GoogleCloudStorageItemInfo,6,0,0,5,0,0,0,1,12
GoogleCloudPlatform_bigdata-interop.com.google.cloud.hadoop.gcsio.GoogleCloudStorageOptions,15,0,0,12,0,0,0,0,27
GoogleCloudPlatform_bigdata-interop.com.google.cloud.hadoop.gcsio.GrpcChannelUtils,1,0,0,0,0,0,0,0,1
GoogleCloudPlatform_bigdata-interop.com.google.cloud.hadoop.gcsio.GoogleCloudStorageFileSystem,36,0,0,29,0,0,0,0,65
GoogleCloudPlatform_bigdata-interop.com.google.cloud.hadoop.gcsio.PrefixMappedItemCache,6,0,0,6,0,0,0,0,12
GoogleCloudPlatform_bigdata-interop.com.google.cloud.hadoop.gcsio.GoogleCloudStorageReadChannel,10,0,0,10,0,2,0,2,24
GoogleCloudPlatform_bigdata-interop.com.google.cloud.hadoop.util.AccessBoundary,0,0,0,0,0,0,0,0,0
GoogleCloudPlatform_bigdata-interop.com.google.cloud.hadoop.gcsio.StorageRequestFactory,0,0,0,0,0,0,0,0,0
GoogleCloudPlatform_bigdata-interop.com.google.cloud.hadoop.gcsio.CreateObjectOptions,3,0,0,3,0,0,0,0,6
GoogleCloudPlatform_bigdata-interop.com.google.cloud.hadoop.gcsio.CreateFileOptions,2,0,0,1,0,0,0,1,4
GoogleCloudPlatform_bigdata-interop.com.google.cloud.hadoop.gcsio.UriPaths,9,0,0,6,0,0,0,0,15
GoogleCloudPlatform_bigdata-interop.com.google.cloud.hadoop.gcsio.GoogleCloudStorageFileSystemImpl,0,0,0,0,0,0,0,0,0
GoogleCloudPlatform_bigdata-interop.com.google.cloud.hadoop.gcsio.StringPaths,0,0,0,0,0,0,0,0,0
GoogleCloudPlatform_bigdata-interop.com.google.cloud.hadoop.gcsio.FileInfo,1,0,0,1,0,0,0,1,3
GoogleCloudPlatform_bigdata-interop.com.google.cloud.hadoop.gcsio.EventLoggingHttpRequestInitializer,3,0,0,2,0,0,0,0,5
GoogleCloudPlatform_bigdata-interop.com.google.cloud.hadoop.gcsio.GoogleCloudStorageWriteChannel,0,0,0,0,0,0,0,0,0
GoogleCloudPlatform_bigdata-interop.com.google.cloud.hadoop.gcsio.BatchHelper,3,0,0,3,0,0,0,0,6
GoogleCloudPlatform_bigdata-interop.com.google.cloud.hadoop.gcsio.GoogleCloudStorageImpl,1,0,0,1,0,0,0,0,2
pulsarIO_realtime-analytics.com.ebay.pulsar.sessionizer.config.SessionizerConfig,2,0,0,2,0,0,0,0,4
pulsarIO_realtime-analytics.com.ebay.pulsar.sessionizer.model.AbstractSession,1,0,0,1,0,0,0,2,4
pulsarIO_realtime-analytics.com.ebay.pulsar.sessionizer.util.BinaryFormatSerializer,1,0,0,1,0,0,0,0,2
pulsarIO_realtime-analytics.com.ebay.pulsar.sessionizer.esper.impl.SessionVariable,1,0,0,1,0,0,0,0,2
codefollower_Tomcat-Research.javax.el.ELManager,132,0,0,132,0,0,0,0,264
codefollower_Tomcat-Research.javax.el.ExpressionFactory,18,0,0,18,0,0,0,0,36
codefollower_Tomcat-Research.javax.el.CompositeELResolver,0,0,0,0,0,0,0,0,0
codefollower_Tomcat-Research.org.apache.catalina.startup.Tomcat,218,32,0,202,0,8,0,90,550
codefollower_Tomcat-Research.javax.el.ImportHandler,0,0,0,0,0,0,0,0,0
codefollower_Tomcat-Research.javax.el.ELProcessor,6,0,0,6,0,0,0,0,12
codefollower_Tomcat-Research.javax.el.ELContext,16,0,0,16,0,0,0,0,32
codefollower_Tomcat-Research.javax.el.BeanELResolver,0,0,0,0,0,0,0,0,0
codefollower_Tomcat-Research.org.apache.catalina.loader.WebappLoader,2,0,0,2,0,0,0,0,4
codefollower_Tomcat-Research.org.apache.catalina.Lifecycle,4,0,0,4,0,0,0,0,8
codefollower_Tomcat-Research.org.apache.catalina.loader.WebappClassLoader,18,0,0,8,0,0,0,0,26
codefollower_Tomcat-Research.org.apache.catalina.connector.Response,0,0,0,0,0,0,0,0,0
codefollower_Tomcat-Research.org.apache.tomcat.util.modeler.Registry,2,2,0,2,0,0,0,0,6
codefollower_Tomcat-Research.org.apache.catalina.security.SecurityClassLoad,0,0,0,0,0,0,0,2,2
codefollower_Tomcat-Research.org.apache.catalina.ha.session.SerializablePrincipal,2,0,0,2,0,2,0,0,6
codefollower_Tomcat-Research.org.apache.tomcat.util.descriptor.web.SecurityConstraint,18,2,0,18,0,0,0,0,38
codefollower_Tomcat-Research.org.apache.catalina.util.ContextName,10,0,0,0,0,0,0,0,10
codefollower_Tomcat-Research.org.apache.catalina.util.Conversions,2,0,0,0,0,0,0,0,2
codefollower_Tomcat-Research.org.apache.catalina.filters.RemoteIpFilter,4,0,0,0,0,0,0,0,4
codefollower_Tomcat-Research.org.apache.tomcat.util.descriptor.web.FilterDef,22,0,0,22,0,0,0,0,44
codefollower_Tomcat-Research.javax.servlet.http.HttpServletResponse,0,0,0,0,0,0,0,2,2
codefollower_Tomcat-Research.org.apache.catalina.filters.CorsFilter,38,0,0,38,0,0,0,0,76
codefollower_Tomcat-Research.javax.servlet.ServletResponse,0,0,0,0,0,0,0,18,18
codefollower_Tomcat-Research.org.apache.catalina.filters.ExpiresFilter,4,0,0,0,0,0,0,0,4
codefollower_Tomcat-Research.org.apache.catalina.core.DefaultInstanceManager,0,0,0,0,0,0,0,0,0
codefollower_Tomcat-Research.org.apache.catalina.connector.Connector,2,2,0,2,0,0,0,12,18
codefollower_Tomcat-Research.org.apache.catalina.Host,2,2,0,2,0,0,0,0,6
codefollower_Tomcat-Research.org.apache.catalina.core.ApplicationSessionCookieConfig,0,0,0,0,0,0,0,0,0
codefollower_Tomcat-Research.org.apache.juli.logging.Log,12,0,0,0,0,0,0,0,12
codefollower_Tomcat-Research.org.apache.catalina.authenticator.AuthenticatorBase,0,0,0,0,0,0,0,0,0
codefollower_Tomcat-Research.org.apache.catalina.valves.RemoteIpValve,24,0,0,24,0,0,0,4,52
codefollower_Tomcat-Research.org.apache.catalina.WebResource,0,0,0,0,0,0,0,0,0
codefollower_Tomcat-Research.org.apache.catalina.WebResourceRoot,40,16,0,22,0,2,0,0,80
codefollower_Tomcat-Research.org.apache.catalina.Container,2,0,0,0,0,0,0,0,2
codefollower_Tomcat-Research.org.apache.tomcat.util.buf.MessageBytes,2,0,0,2,0,0,0,0,4
codefollower_Tomcat-Research.org.apache.catalina.core.StandardHost,0,0,0,0,0,0,0,10,10
codefollower_Tomcat-Research.org.apache.catalina.startup.ContextConfig,10,0,0,10,0,0,0,0,20
codefollower_Tomcat-Research.org.apache.tomcat.util.descriptor.web.ServletDef,4,0,0,4,0,0,0,0,8
codefollower_Tomcat-Research.org.apache.catalina.core.StandardContext,2,0,0,2,0,0,0,0,4
codefollower_Tomcat-Research.org.apache.catalina.Server,0,0,0,0,0,0,0,0,0
codefollower_Tomcat-Research.javax.servlet.ServletContext,0,0,0,0,0,0,0,0,0
codefollower_Tomcat-Research.org.apache.catalina.startup.WebappServiceLoader,0,0,0,0,0,0,0,0,0
codefollower_Tomcat-Research.org.apache.catalina.ssi.ExpressionParseTree,0,0,0,0,0,0,0,0,0
codefollower_Tomcat-Research.org.apache.catalina.ssi.SSIExternalResolver,0,0,0,0,0,0,0,0,0
codefollower_Tomcat-Research.org.apache.catalina.tribes.io.XByteBuffer,2,0,0,2,0,0,0,0,4
codefollower_Tomcat-Research.org.apache.catalina.tribes.group.GroupChannel,4,0,0,4,0,0,0,4,12
codefollower_Tomcat-Research.org.apache.catalina.tribes.ManagedChannel,0,0,0,0,0,0,0,4,4
codefollower_Tomcat-Research.org.apache.catalina.tribes.Channel,4,0,0,4,0,6,0,0,14
codefollower_Tomcat-Research.org.apache.catalina.tribes.group.ChannelInterceptorBase,4,2,0,2,0,0,0,0,8
codefollower_Tomcat-Research.org.apache.catalina.tribes.group.interceptors.NonBlockingCoordinator,0,2,0,0,0,0,0,0,2
codefollower_Tomcat-Research.org.apache.catalina.tribes.membership.MemberImpl,4,0,0,2,0,0,0,0,6
codefollower_Tomcat-Research.org.apache.catalina.tribes.Member,2,0,0,2,0,0,0,0,4
codefollower_Tomcat-Research.javax.el.VariableMapper,2,0,0,2,0,0,0,0,4
codefollower_Tomcat-Research.org.apache.el.util.ReflectionUtil,0,0,0,0,0,0,0,4,4
codefollower_Tomcat-Research.org.apache.el.lang.ELArithmetic,0,0,0,0,0,0,0,0,0
codefollower_Tomcat-Research.org.apache.el.lang.ELSupport,0,0,0,0,0,0,0,0,0
codefollower_Tomcat-Research.org.apache.tomcat.websocket.WsFrameBase,4,0,0,0,0,0,0,0,4
codefollower_Tomcat-Research.org.apache.tomcat.websocket.Util,0,0,0,0,0,0,0,0,0
codefollower_Tomcat-Research.org.apache.tomcat.websocket.server.WsServerContainer,4,0,0,4,0,0,0,0,8
codefollower_Tomcat-Research.org.apache.tomcat.websocket.server.UriTemplate,8,0,0,0,0,0,0,0,8
codefollower_Tomcat-Research.org.apache.tomcat.util.descriptor.LocalResolver,10,0,0,0,0,0,0,0,10
codefollower_Tomcat-Research.org.apache.tomcat.util.descriptor.web.WebXml,36,0,0,32,0,0,0,2,70
codefollower_Tomcat-Research.org.apache.tomcat.util.descriptor.web.JspPropertyGroup,2,0,0,2,0,0,0,0,4
codefollower_Tomcat-Research.javax.servlet.descriptor.JspConfigDescriptor,0,0,0,0,0,0,0,0,0
codefollower_Tomcat-Research.org.apache.tomcat.util.descriptor.tld.TaglibXml,12,0,0,12,0,0,0,0,24
codefollower_Tomcat-Research.org.apache.tomcat.util.threads.LimitLatch,8,0,0,8,0,0,0,0,16
codefollower_Tomcat-Research.org.apache.tomcat.util.buf.B2CConverter,0,0,0,0,0,0,0,2,2
codefollower_Tomcat-Research.org.apache.tomcat.util.http.Parameters,6,0,0,6,0,0,0,0,12
codefollower_Tomcat-Research.org.apache.tomcat.util.http.RequestUtil,2,0,0,0,0,0,0,0,2
codefollower_Tomcat-Research.org.apache.tomcat.util.http.parser.HttpParser,20,0,0,12,0,0,0,0,32
codefollower_Tomcat-Research.org.apache.tomcat.util.res.StringManager,0,0,0,0,0,0,0,2,2
codefollower_Tomcat-Research.org.apache.tomcat.util.buf.ByteChunk,18,0,0,4,0,0,0,0,22
codefollower_Tomcat-Research.org.apache.tomcat.util.buf.CharChunk,2,0,0,2,0,0,0,0,4
codefollower_Tomcat-Research.org.apache.tomcat.util.buf.UEncoder,2,0,0,2,0,0,0,0,4
codefollower_Tomcat-Research.org.apache.tomcat.util.buf.HexUtils,2,0,0,0,0,0,0,0,2
codefollower_Tomcat-Research.org.apache.tomcat.util.buf.UDecoder,2,0,0,0,0,0,0,0,2
codefollower_Tomcat-Research.org.apache.tomcat.util.collections.SynchronizedQueue,6,0,0,0,0,0,0,0,6
codefollower_Tomcat-Research.org.apache.tomcat.util.collections.SynchronizedStack,8,0,0,0,0,0,0,0,8
codefollower_Tomcat-Research.org.apache.jasper.util.FastRemovalDequeue,16,0,0,0,0,0,0,0,16
codefollower_Tomcat-Research.org.apache.jasper.servlet.JspCServletContext,16,0,0,16,0,0,0,0,32
codefollower_Tomcat-Research.org.apache.coyote.Response,0,0,0,0,0,0,0,0,0
codefollower_Tomcat-Research.org.apache.juli.ClassLoaderLogManager,2,0,0,0,0,0,0,0,2
codefollower_Tomcat-Research.org.apache.juli.DateFormatCache,2,0,0,0,0,0,0,0,2
codefollower_Tomcat-Research.org.apache.tomcat.util.descriptor.DigesterFactory,14,0,0,14,0,0,0,0,28
codefollower_Tomcat-Research.org.apache.catalina.tribes.transport.ReplicationTransmitter,0,0,0,0,0,0,0,0,0
h2oai_h2o.water.fvec.NFSFileVec,11,3,0,11,0,2,1,11,39
h2oai_h2o.water.util.MRUtils,0,0,0,0,0,0,0,1,1
h2oai_h2o.water.fvec.ParseDataset2,6,0,0,6,0,0,0,1,13
h2oai_h2o.jsr166y.ForkJoinTask,6,0,0,6,0,1,0,0,13
h2oai_h2o.water.Job,3,0,0,3,0,0,0,1,7
h2oai_h2o.water.api.RequestServer,1,0,0,1,0,0,0,1,3
h2oai_h2o.hex.Summary2,2,0,0,2,0,0,0,0,4
h2oai_h2o.water.util.Utils,6,0,0,2,0,0,0,2,10
h2oai_h2o.hex.FrameSplitter,2,0,0,1,0,0,0,0,3
h2oai_h2o.water.fvec.Frame,9,1,0,9,0,1,2,12,34
h2oai_h2o.water.fvec.Vec,4,0,0,4,0,0,0,0,8
h2oai_h2o.water.Key,6,0,0,6,0,0,0,5,17
h2oai_h2o.hex.NFoldFrameExtractor,1,0,0,0,0,0,0,0,1
h2oai_h2o.water.UKV,1,0,0,1,0,1,0,4,7
h2oai_h2o.water.Scope,1,0,0,1,0,0,0,0,2
h2oai_h2o.hex.gbm.GBM,1,0,0,1,0,0,0,0,2
h2oai_h2o.hex.deeplearning.Neurons,0,0,0,0,0,0,1,1,2
h2oai_h2o.hex.deeplearning.Dropout,1,0,0,1,0,0,0,0,2
h2oai_h2o.water.fvec.NewChunk,20,17,0,20,0,0,0,0,57
h2oai_h2o.water.api.ImportFiles2,0,0,0,0,0,0,0,1,1
h2oai_h2o.water.Lockable,4,0,0,0,0,0,1,4,9
h2oai_h2o.water.Value,3,0,0,1,0,3,0,0,7
h2oai_h2o.water.util.JsonUtil,0,0,0,0,0,0,0,0,0
h2oai_h2o.water.Iced,2,2,0,2,0,0,0,0,6
h2oai_h2o.water.H2O,0,0,0,0,0,0,0,2,2
h2oai_h2o.water.Request2,1,0,0,0,0,0,0,0,1
h2oai_h2o.water.DRemoteTask,0,0,0,0,0,0,0,1,1
h2oai_h2o.water.DKV,4,0,0,4,0,0,1,0,9
h2oai_h2o.water.NetworkTest,1,0,0,1,0,0,0,0,2
h2oai_h2o.water.api.JStack,0,0,0,0,0,0,0,0,0
h2oai_h2o.water.util.LinuxProcFileReader,1,0,0,0,0,0,0,0,1
h2oai_h2o.water.util.SB,2,0,0,0,0,0,0,0,2
h2oai_h2o.water.api.HitRatio,1,0,0,0,0,0,0,0,1
h2oai_h2o.water.score.ScorecardModel,1,0,0,1,0,0,0,0,2
h2oai_h2o.water.util.UserSpecifiedNetwork,0,0,0,0,0,0,0,3,3
pavel4n_wowdoge.org.com.google.dogecoin.crypto.KeyCrypterScrypt,5,0,0,5,0,1,0,0,11
pavel4n_wowdoge.org.com.google.dogecoin.crypto.HDUtils,0,0,0,0,0,0,0,0,0
pavel4n_wowdoge.org.com.google.dogecoin.crypto.MnemonicCode,1,0,0,1,0,0,0,0,2
pavel4n_wowdoge.org.com.google.dogecoin.crypto.HDKeyDerivation,1,0,0,1,0,0,0,0,2
pavel4n_wowdoge.org.com.google.dogecoin.crypto.X509Utils,2,0,0,0,0,0,0,0,2
pavel4n_wowdoge.org.com.google.dogecoin.protocols.channels.PaymentChannelClientState,0,0,0,0,0,0,0,0,0
pavel4n_wowdoge.org.com.google.dogecoin.core.Utils,13,2,0,12,0,4,0,0,31
pavel4n_wowdoge.org.com.google.dogecoin.core.Wallet,53,2,0,51,0,3,0,0,109
pavel4n_wowdoge.org.com.google.dogecoin.protocols.channels.PaymentChannelServerListener,1,1,0,1,0,0,0,0,3
pavel4n_wowdoge.org.com.google.dogecoin.protocols.channels.PaymentChannelServer,1,0,0,1,0,0,0,0,2
pavel4n_wowdoge.org.com.google.dogecoin.protocols.channels.PaymentChannelClient,4,0,0,3,0,0,0,0,7
pavel4n_wowdoge.org.com.google.dogecoin.protocols.payments.PaymentSession,3,0,0,3,0,1,0,0,7
pavel4n_wowdoge.org.com.google.dogecoin.uri.BitcoinURI,6,0,0,6,0,1,0,0,13
pavel4n_wowdoge.org.com.google.dogecoin.params.MainNetParams,9,0,0,1,0,8,0,6,24
pavel4n_wowdoge.org.com.google.dogecoin.store.SPVBlockStore,1,0,0,1,0,0,0,0,2
pavel4n_wowdoge.org.com.google.dogecoin.store.WalletProtobufSerializer,3,0,0,3,0,1,0,0,7
pavel4n_wowdoge.org.com.google.dogecoin.utils.TestUtils,5,0,0,5,0,0,0,0,10
pavel4n_wowdoge.org.com.google.dogecoin.core.ECKey,12,2,0,12,0,0,0,2,28
pavel4n_wowdoge.org.com.google.dogecoin.core.Block,13,0,0,13,0,1,0,0,27
pavel4n_wowdoge.org.com.google.dogecoin.script.Script,5,3,0,5,0,2,0,1,16
pavel4n_wowdoge.org.com.google.dogecoin.core.VersionedChecksummedBytes,0,0,0,0,0,0,0,0,0
pavel4n_wowdoge.org.com.google.dogecoin.core.Address,0,0,0,0,0,0,0,0,0
pavel4n_wowdoge.org.com.google.dogecoin.params.UnitTestParams,3,0,0,2,0,0,0,0,5
pavel4n_wowdoge.org.com.google.dogecoin.core.AbstractBlockChain,3,2,0,3,0,3,0,0,11
pavel4n_wowdoge.org.com.google.dogecoin.core.NetworkParameters,1,0,0,1,0,0,0,1,3
pavel4n_wowdoge.org.com.google.dogecoin.crypto.TransactionSignature,0,0,0,0,0,0,0,0,0
pavel4n_wowdoge.org.com.google.dogecoin.core.FullPrunedBlockChain,0,0,0,0,0,1,0,0,1
pavel4n_wowdoge.org.com.google.dogecoin.core.TransactionBroadcast,1,0,0,1,0,0,0,0,2
pavel4n_wowdoge.org.com.google.dogecoin.core.Peer,10,0,0,10,0,1,0,0,21
pavel4n_wowdoge.org.com.google.dogecoin.core.Transaction,2,0,0,2,0,1,0,0,5
pavel4n_wowdoge.org.com.google.dogecoin.params.TestNet3Params,1,0,0,1,0,1,0,0,3
pavel4n_wowdoge.org.com.google.dogecoin.core.Base58,2,0,0,1,0,0,0,0,3
pavel4n_wowdoge.org.com.google.dogecoin.core.BloomFilter,3,0,0,3,0,0,0,0,6
pavel4n_wowdoge.org.com.google.dogecoin.core.MemoryPool,2,0,0,2,0,0,0,0,4
pavel4n_wowdoge.org.com.google.dogecoin.utils.Threading,1,0,0,0,0,0,0,0,1
pavel4n_wowdoge.org.com.google.dogecoin.core.InventoryMessage,1,0,0,0,0,0,0,0,1
pavel4n_wowdoge.org.com.google.dogecoin.core.GetBlocksMessage,1,0,0,1,0,0,0,0,2
pavel4n_wowdoge.org.com.google.dogecoin.core.Ping,1,0,0,0,0,0,0,0,1
pavel4n_wowdoge.org.com.google.dogecoin.core.BitcoinSerializer,2,0,0,2,0,0,0,0,4
pavel4n_wowdoge.org.com.google.dogecoin.net.MessageWriteTarget,2,0,0,1,0,0,0,0,3
pavel4n_wowdoge.org.com.google.dogecoin.net.AbstractTimeoutHandler,0,0,0,0,0,0,0,0,0
pavel4n_wowdoge.org.com.google.dogecoin.net.discovery.SeedPeers,1,0,0,1,0,0,0,0,2
pavel4n_wowdoge.org.com.google.dogecoin.wallet.DefaultCoinSelector,3,0,0,3,0,0,0,0,6
pavel4n_wowdoge.org.com.google.dogecoin.wallet.DefaultRiskAnalysis,3,0,0,3,0,0,0,0,6
pavel4n_wowdoge.org.com.google.dogecoin.utils.ExponentialBackoff,3,0,0,2,0,0,0,0,5
SharedKnowledge_SharkFW.net.sharkfw.peer.ASIPPort,0,0,0,0,0,0,0,0,0
SharedKnowledge_SharkFW.net.sharkfw.knowledgeBase.inmemory.InMemoSharkKB,0,0,0,0,0,0,0,2,2
SharedKnowledge_SharkFW.net.sharkfw.peer.SharkEngine,1,0,0,0,0,0,1,0,2
SharedKnowledge_SharkFW.net.sharkfw.asip.ASIPKnowledge,0,0,0,0,0,0,0,0,0
SharedKnowledge_SharkFW.net.sharkfw.asip.engine.ASIPOutMessage,0,0,0,0,0,0,0,0,0
SharedKnowledge_SharkFW.net.sharkfw.asip.engine.ASIPInMessage,0,0,0,0,0,0,0,0,0
SharedKnowledge_SharkFW.net.sharkfw.system.TestUtils,0,0,0,0,0,0,0,2,2
SharedKnowledge_SharkFW.net.sharkfw.knowledgeBase.SharkKB,0,0,0,0,0,0,0,0,0
SharedKnowledge_SharkFW.net.sharkfw.security.SharkPkiStorage,1,0,0,1,0,0,0,0,2
SharedKnowledge_SharkFW.net.sharkfw.knowledgeBase.SharkVocabulary,0,0,0,0,0,1,0,3,4
SharedKnowledge_SharkFW.net.sharkfw.system.L,4,4,0,4,0,0,1,1,14
SharedKnowledge_SharkFW.net.sharkfw.knowledgeBase.persistent.dump.DumpSharkKB,0,0,0,0,0,0,0,0,0
SharedKnowledge_SharkFW.net.sharkfw.knowledgeBase.persistent.sql.SqlAsipInformation,4,3,0,4,0,0,0,0,11
SharedKnowledge_SharkFW.net.sharkfw.knowledgeBase.persistent.sql.SqlSemanticTag,2,0,0,2,0,0,0,0,4
SharedKnowledge_SharkFW.net.sharkfw.knowledgeBase.persistent.sql.SqlSharkPropertyHolder,1,0,0,1,0,0,0,0,2
SharedKnowledge_SharkFW.net.sharkfw.knowledgeBase.sync.SyncKB,1,0,0,1,0,0,0,1,3
SharedKnowledge_SharkFW.net.sharkfw.knowledgeBase.sync.manager.SyncManager,2,0,0,2,0,0,0,0,4
SharedKnowledge_SharkFW.net.sharkfw.knowledgeBase.sync.manager.SyncMergeInfoSerializer,0,0,0,0,0,0,0,0,0
SharedKnowledge_SharkFW.net.sharkfw.knowledgeBase.broadcast.SpatialFilter,0,0,0,0,0,0,0,1,1
jcabi_jcabi-http.com.jcabi.http.Request,1,0,0,1,0,0,0,1,3
jcabi_jcabi-http.com.jcabi.http.response.JsonResponse,4,0,0,4,0,0,0,0,8
jcabi_jcabi-http.com.jcabi.http.response.AbstractResponse,0,0,0,0,0,0,0,0,0
jcabi_jcabi-http.com.jcabi.http.response.XmlResponse,3,0,0,3,0,0,0,2,8
jcabi_jcabi-http.com.jcabi.http.mock.MkContainer,4,0,0,4,0,0,0,6,14
jcabi_jcabi-http.com.jcabi.http.mock.MkGrizzlyContainer,4,0,0,4,0,0,0,4,12
jcabi_jcabi-http.com.jcabi.http.response.JacksonResponse,7,0,0,7,0,0,0,0,14
jcabi_jcabi-http.com.jcabi.http.response.JsoupResponse,0,0,0,0,0,0,0,0,0
jcabi_jcabi-http.com.jcabi.http.request.JdkRequest,4,0,0,1,0,0,0,0,5
jcabi_jcabi-http.com.jcabi.http.response.RestResponse,1,0,0,1,0,0,0,1,3
jcabi_jcabi-http.com.jcabi.http.response.WebLinkingResponse,2,0,0,2,0,0,0,0,4
jcabi_jcabi-http.com.jcabi.http.mock.GrizzlyQuery,0,0,0,0,0,0,0,0,0
jcabi_jcabi-http.com.jcabi.http.mock.MkQueryMatchers,0,0,0,0,0,0,0,0,0
jcabi_jcabi-http.com.jcabi.http.mock.MkAnswerMatchers,0,0,0,0,0,0,0,0,0
jcabi_jcabi-http.com.jcabi.http.request.BaseRequest,3,0,0,1,0,0,0,0,4
jcabi_jcabi-http.com.jcabi.http.request.FakeRequest,1,0,0,0,0,0,0,1,2
jcabi_jcabi-http.com.jcabi.http.request.DefaultResponse,0,0,0,0,0,0,0,0,0
jcabi_jcabi-http.com.jcabi.http.request.Boundary,0,0,0,0,0,0,0,0,0
bonigarcia_dualsub.io.github.bonigarcia.dualsub.translate.Translator,0,0,0,0,0,0,0,1,1
bonigarcia_dualsub.io.github.bonigarcia.dualsub.srt.SrtUtils,1,0,0,1,0,0,1,6,9
bonigarcia_dualsub.io.github.bonigarcia.dualsub.util.Charset,0,0,0,0,0,0,1,1,2
bonigarcia_dualsub.io.github.bonigarcia.dualsub.srt.Srt,0,0,0,0,0,0,1,0,1
bonigarcia_dualsub.io.github.bonigarcia.dualsub.srt.Merger,0,0,0,0,0,0,3,2,5
wildfly_wildfly-core.org.jboss.as.platform.mbean.PlatformMBeanUtil,1,1,0,0,0,0,0,0,2
wildfly_wildfly-core.org.wildfly.core.testrunner.ManagementClient,24,5,0,23,0,4,0,3,59
wildfly_wildfly-core.org.jboss.as.controller.operations.common.Util,100,6,0,78,0,3,2,33,222
wildfly_wildfly-core.org.jboss.as.test.deployment.trivial.ServiceActivatorDeploymentUtil,8,3,0,8,0,5,0,3,27
wildfly_wildfly-core.org.jboss.as.test.integration.management.interfaces.NativeManagementInterface,0,0,0,0,0,0,0,1,1
wildfly_wildfly-core.org.jboss.as.test.integration.management.interfaces.HttpManagementInterface,0,0,0,0,0,0,0,1,1
wildfly_wildfly-core.org.jboss.as.test.integration.management.interfaces.CliManagementInterface,0,0,0,0,0,0,0,1,1
wildfly_wildfly-core.org.jboss.as.test.integration.management.rbac.RbacUtil,0,0,0,0,0,0,0,6,6
wildfly_wildfly-core.org.jboss.as.test.integration.management.util.CLIWrapper,83,1,0,76,0,1,0,34,195
wildfly_wildfly-core.org.jboss.as.test.integration.management.cli.CliProcessBuilder,44,1,0,44,0,13,0,4,106
wildfly_wildfly-core.org.jboss.as.cli.CommandContext,81,1,0,48,0,33,5,58,226
wildfly_wildfly-core.org.jboss.as.test.integration.management.cli.CliProcessWrapper,7,0,0,6,0,6,0,0,19
wildfly_wildfly-core.org.jboss.as.test.deployment.DeploymentArchiveUtils,0,0,0,0,0,0,0,6,6
wildfly_wildfly-core.org.jboss.as.test.deployment.DeploymentInfoUtils,4,4,0,4,0,4,0,0,16
wildfly_wildfly-core.org.jboss.as.test.integration.management.util.CLITestUtil,26,0,0,26,0,10,0,12,74
wildfly_wildfly-core.org.jboss.as.cli.Util,5,1,0,5,0,0,0,7,18
wildfly_wildfly-core.org.jboss.as.cli.impl.ReadlineConsole,1,0,0,0,0,0,0,0,1
wildfly_wildfly-core.org.jboss.as.cli.CommandContextFactory,10,0,0,10,0,5,0,4,29
wildfly_wildfly-core.org.jboss.as.test.shared.TestSuiteEnvironment,12,1,0,9,0,4,0,9,35
wildfly_wildfly-core.org.jboss.as.cli.CommandLineCompleter,12,4,0,12,0,0,0,0,28
wildfly_wildfly-core.org.jboss.as.cli.operation.impl.DefaultOperationRequestBuilder,1,0,0,1,0,1,0,0,3
wildfly_wildfly-core.org.jboss.as.controller.PathAddress,54,0,0,39,0,1,0,76,170
wildfly_wildfly-core.org.jboss.as.test.shared.AssumeTestGroupUtil,0,0,0,0,0,0,0,1,1
wildfly_wildfly-core.org.jboss.as.test.syslogserver.BlockedSyslogServerEventHandler,2,0,0,2,0,0,0,1,5
wildfly_wildfly-core.org.jboss.as.test.layers.LayersTest,0,0,0,0,0,0,0,1,1
wildfly_wildfly-core.org.wildfly.core.launcher.StandaloneCommandBuilder,1,1,0,1,0,0,0,0,3
wildfly_wildfly-core.org.wildfly.core.launcher.DomainCommandBuilder,1,1,0,1,0,0,0,0,3
wildfly_wildfly-core.org.jboss.as.test.integration.management.util.CustomCLIExecutor,0,0,0,0,0,0,0,0,0
wildfly_wildfly-core.org.jboss.as.test.integration.management.util.ServerReload,0,0,0,0,0,0,0,3,3
wildfly_wildfly-core.org.jboss.as.controller.client.ModelControllerClient,20,0,0,20,0,1,0,1,42
wildfly_wildfly-core.org.jboss.as.controller.client.helpers.Operations,38,4,0,27,0,0,0,19,88
wildfly_wildfly-core.org.wildfly.core.testrunner.ServerController,12,0,0,11,0,1,0,20,44
wildfly_wildfly-core.org.jboss.as.test.syslogserver.BlockedAllProtocolsSyslogServerEventHandler,2,0,0,0,0,0,0,0,2
wildfly_wildfly-core.org.jboss.as.cli.scriptsupport.CLI,0,0,0,0,0,0,0,3,3
wildfly_wildfly-core.org.jboss.as.test.syslogserver.Rfc5424SyslogEvent,1,0,0,0,0,0,0,0,1
wildfly_wildfly-core.org.jboss.as.test.integration.security.common.CoreUtils,0,0,0,0,0,0,0,9,9
wildfly_wildfly-core.org.jboss.as.controller.PathElement,21,0,0,15,0,0,0,11,47
wildfly_wildfly-core.org.jboss.as.test.integration.domain.management.util.DomainLifecycleUtil,48,6,0,40,0,5,0,45,144
wildfly_wildfly-core.org.jboss.as.test.integration.domain.management.util.DomainTestSupport,8,0,0,8,0,0,0,3,19
wildfly_wildfly-core.org.jboss.as.test.integration.domain.management.util.WildFlyManagedConfiguration,1,0,0,1,0,0,0,6,8
wildfly_wildfly-core.org.jboss.as.controller.client.helpers.domain.DomainDeploymentManager,1,0,0,1,0,0,0,0,2
wildfly_wildfly-core.org.jboss.as.controller.access.management.AccessConstraintKey,1,1,0,1,0,0,0,0,3
wildfly_wildfly-core.org.jboss.as.test.integration.management.rbac.PermissionsCoverageTestUtil,0,0,0,0,0,0,0,1,1
wildfly_wildfly-core.org.jboss.as.test.integration.management.util.ModelUtil,17,0,0,4,0,1,0,11,33
wildfly_wildfly-core.org.jboss.as.test.integration.management.api.ReadConfigAsFeaturesTestBase,0,0,0,0,0,0,0,2,2
wildfly_wildfly-core.org.jboss.as.controller.client.OperationBuilder,4,0,0,2,0,2,0,0,8
wildfly_wildfly-core.org.jboss.as.controller.operations.common.SchemaLocationAddHandler,2,0,0,2,0,0,0,0,4
wildfly_wildfly-core.org.jboss.as.test.integration.domain.management.util.DomainTestUtils,0,0,0,0,0,0,0,1,1
wildfly_wildfly-core.org.jboss.as.core.model.test.KnownIssuesValidationConfiguration,0,1,0,0,0,0,0,0,1
wildfly_wildfly-core.org.jboss.as.test.shared.TimeoutUtil,0,0,0,0,0,1,0,1,2
wildfly_wildfly-core.org.jboss.as.test.integration.management.util.HttpMgmtProxy,8,0,0,5,0,0,0,0,13
wildfly_wildfly-core.org.wildfly.test.jmx.ServiceActivatorDeploymentUtil,1,0,0,0,0,0,0,0,1
wildfly_wildfly-core.org.wildfly.core.embedded.EmbeddedProcessFactory,0,0,0,0,0,0,0,2,2
wildfly_wildfly-core.org.jboss.as.patching.metadata.PatchBuilder,43,0,0,42,0,3,0,2,90
wildfly_wildfly-core.org.jboss.as.patching.HashUtils,22,0,0,12,0,3,0,11,48
wildfly_wildfly-core.org.jboss.as.patching.metadata.PatchMerger,11,4,0,5,0,0,0,1,21
wildfly_wildfly-core.org.jboss.as.patching.IoUtils,1,0,0,0,0,0,0,2,3
wildfly_wildfly-core.org.jboss.as.server.Services,1,0,0,0,0,1,0,0,2
wildfly_wildfly-core.org.jboss.as.server.deployment.ModelContentReference,0,0,0,0,0,0,0,0,0
wildfly_wildfly-core.org.jboss.as.controller.HashUtil,0,0,0,0,0,0,0,0,0
wildfly_wildfly-core.org.jboss.as.server.deployment.DeploymentAddHandler,0,0,0,0,0,0,0,1,1
wildfly_wildfly-core.org.jboss.as.controller.logging.ControllerLogger,1,0,0,1,0,0,0,1,3
wildfly_wildfly-core.org.jboss.as.controller.ModelController,56,11,0,2,0,0,0,6,75
wildfly_wildfly-core.org.jboss.as.controller.persistence.ConfigurationFile,16,1,0,14,0,0,0,0,31
wildfly_wildfly-core.org.jboss.as.controller.AttributeDefinition,30,1,0,22,0,3,0,4,60
wildfly_wildfly-core.org.jboss.as.controller.persistence.FilePersistenceUtils,1,0,0,0,0,0,0,0,1
wildfly_wildfly-core.org.jboss.as.model.test.ModelTestKernelServices,154,48,0,47,0,2,0,20,271
wildfly_wildfly-core.org.jboss.as.logging.formatters.PatternFormatterResourceDefinition,1,0,0,1,0,0,0,0,2
wildfly_wildfly-core.org.jboss.as.logging.logmanager.ConfigurationPersistence,0,0,0,0,0,0,0,0,0
wildfly_wildfly-core.org.jboss.as.controller.ModelVersion,17,2,0,17,0,2,0,8,46
wildfly_wildfly-core.org.jboss.as.subsystem.test.SubsystemOperations,2,0,0,2,0,0,0,0,4
wildfly_wildfly-core.org.jboss.as.logging.filters.Filters,0,0,0,0,0,0,0,1,1
wildfly_wildfly-core.org.jboss.as.logging.validators.SuffixValidator,2,0,0,0,0,1,0,0,3
wildfly_wildfly-core.org.jboss.as.core.model.test.KernelServicesBuilder,25,3,0,25,0,4,0,2,59
wildfly_wildfly-core.org.jboss.as.controller.ManagementModel,0,0,0,0,0,0,0,1,1
wildfly_wildfly-core.org.jboss.as.core.model.test.AbstractCoreModelTest,1,0,0,1,0,0,0,0,2
wildfly_wildfly-core.org.jboss.as.model.test.ModelTestUtils,12,0,0,5,0,0,0,18,35
wildfly_wildfly-core.org.jboss.as.controller.ControlledProcessState,3,0,0,3,0,0,0,0,6
wildfly_wildfly-core.org.jboss.as.domain.http.server.ConsoleVersion,1,0,0,0,0,0,0,0,1
wildfly_wildfly-core.org.jboss.as.domain.http.server.cors.CorsUtil,4,0,0,0,0,0,0,0,4
wildfly_wildfly-core.org.jboss.as.subsystem.test.SchemaValidator,0,0,0,0,0,0,0,1,1
wildfly_wildfly-core.org.jboss.as.subsystem.test.KernelServicesBuilder,22,4,0,20,0,0,0,29,75
wildfly_wildfly-core.org.jboss.as.subsystem.test.AbstractSubsystemTest,8,0,0,8,0,0,0,1,17
wildfly_wildfly-core.org.jboss.as.subsystem.test.SubsystemDescriptionDump,0,0,0,0,0,0,0,0,0
wildfly_wildfly-core.org.jboss.as.controller.SimpleAttributeDefinitionBuilder,18,0,0,16,0,0,0,6,40
wildfly_wildfly-core.org.jboss.as.controller.AbstractAttributeDefinitionBuilder,4,0,0,4,0,0,0,6,14
wildfly_wildfly-core.org.jboss.as.controller.OperationFailedException,25,0,0,0,0,25,0,0,50
wildfly_wildfly-core.org.jboss.as.process.protocol.Pipe,2,0,0,1,0,0,0,0,3
wildfly_wildfly-core.org.jboss.as.process.stdin.BaseNCodecOutputStream,1,0,0,1,0,0,0,0,2
wildfly_wildfly-core.org.jboss.as.server.deployment.scanner.XmlCompletionScanner,1,0,0,1,0,0,0,0,2
wildfly_wildfly-core.org.jboss.as.server.deployment.scanner.FileSystemDeploymentService,50,3,0,22,0,3,0,2,80
wildfly_wildfly-core.org.jboss.as.server.deployment.scanner.ZipCompletionScanner,2,0,0,0,0,0,0,0,2
wildfly_wildfly-core.org.jboss.as.protocol.ProtocolConnectionUtils,3,0,0,2,0,5,0,0,10
wildfly_wildfly-core.org.jboss.as.controller.descriptions.ResourceDescriptionResolver,3,0,0,3,0,0,0,0,6
wildfly_wildfly-core.org.jboss.as.controller.registry.ManagementResourceRegistration,12,1,0,10,0,0,0,1,24
wildfly_wildfly-core.org.jboss.as.jmx.logging.JmxLogger,4,0,0,4,0,0,0,0,8
wildfly_wildfly-core.org.jboss.as.controller.ExpressionResolver,12,0,0,1,0,1,0,2,16
wildfly_wildfly-core.org.jboss.as.jmx.model.NameConverter,0,0,0,0,0,0,0,0,0
wildfly_wildfly-core.org.jboss.as.jmx.model.TypeConverters,4,0,0,4,0,0,0,0,8
wildfly_wildfly-core.org.jboss.as.repository.ContentRepository,17,0,0,13,0,1,0,0,31
wildfly_wildfly-core.org.jboss.as.repository.PathUtil,7,0,0,5,0,1,0,0,13
wildfly_wildfly-core.org.jboss.as.model.test.FailedOperationTransformationConfig,0,0,0,0,0,0,0,10,10
wildfly_wildfly-core.org.wildfly.event.logger.EventLogger,3,0,0,3,0,0,0,2,8
wildfly_wildfly-core.org.jboss.as.model.test.MavenUtil,0,0,0,0,0,0,0,0,0
wildfly_wildfly-core.org.jboss.as.model.test.ChildFirstClassLoaderBuilder,2,0,0,1,0,0,0,0,3
wildfly_wildfly-core.org.jboss.as.model.test.MavenSettings,1,0,0,1,0,0,0,0,2
wildfly_wildfly-core.org.jboss.as.controller.client.helpers.standalone.ServerDeploymentManager,0,0,0,0,0,0,0,9,9
wildfly_wildfly-core.org.jboss.as.cli.handlers.module.ModuleConfigImpl,0,0,0,0,0,0,0,1,1
wildfly_wildfly-core.org.jboss.as.cli.parsing.StateParser,1,0,0,0,0,0,0,0,1
wildfly_wildfly-core.org.jboss.as.cli.operation.impl.DefaultOperationCandidatesProvider,2,1,0,1,0,0,0,0,4
wildfly_wildfly-core.org.jboss.as.cli.operation.impl.DefaultOperationRequestAddress,0,0,0,0,0,0,0,0,0
wildfly_wildfly-core.org.jboss.as.cli.impl.BootScriptInvoker,1,0,0,0,0,2,0,1,4
wildfly_wildfly-core.org.jboss.as.cli.impl.aesh.HelpSupport,0,0,0,0,0,1,0,1,2
wildfly_wildfly-core.org.jboss.as.cli.handlers.ifelse.Operation,1,0,0,0,0,0,0,8,9
wildfly_wildfly-core.org.jboss.as.cli.operation.impl.DefaultCallbackHandler,76,0,0,76,0,0,0,0,152
wildfly_wildfly-core.org.jboss.as.cli.operation.ParsedCommandLine,36,0,0,36,0,0,0,0,72
wildfly_wildfly-core.org.jboss.as.cli.operation.CommandLineParser,9,0,0,9,0,0,0,0,18
wildfly_wildfly-core.org.jboss.as.cli.operation.OperationRequestAddress,13,0,0,13,0,0,0,0,26
wildfly_wildfly-core.org.jboss.as.cli.impl.ValueTypeCompleter,17,0,0,0,0,0,0,0,17
wildfly_wildfly-core.org.jboss.as.cli.impl.AttributeNamePathCompleter,1,0,0,0,0,0,0,0,1
wildfly_wildfly-core.org.jboss.as.cli.util.CLIExpressionResolver,1,0,0,1,0,0,0,0,2
wildfly_wildfly-core.org.jboss.as.cli.ConnectionInfo,0,0,0,0,0,0,0,0,0
wildfly_wildfly-core.org.jboss.as.cli.handlers.ModuleNameTabCompleter,0,0,0,0,0,0,0,0,0
wildfly_wildfly-core.org.jboss.as.controller.ModelControllerLock,13,0,0,13,0,2,0,0,28
wildfly_wildfly-core.org.jboss.as.controller.BootErrorCollector,1,0,0,0,0,0,0,0,1
wildfly_wildfly-core.org.jboss.as.controller.capability.RuntimeCapability,1,0,0,0,0,0,0,0,1
wildfly_wildfly-core.org.jboss.as.controller.CapabilityRegistry,3,0,0,3,0,0,0,0,6
wildfly_wildfly-core.org.jboss.as.controller.StringListAttributeDefinition,3,0,0,1,0,0,0,0,4
wildfly_wildfly-core.org.jboss.as.controller.CapabilityReferenceRecorder,2,0,0,0,0,0,0,0,2
wildfly_wildfly-core.org.jboss.as.controller.EnvVarAttributeOverrider,1,0,0,1,0,0,0,0,2
wildfly_wildfly-core.org.jboss.as.controller.ExpressionResolverImpl,0,0,0,0,0,0,0,3,3
wildfly_wildfly-core.org.jboss.as.controller.client.OperationMessageHandler,3,0,0,3,0,0,3,0,9
wildfly_wildfly-core.org.jboss.as.controller.client.OperationAttachments,1,0,0,1,0,0,0,0,2
wildfly_wildfly-core.org.jboss.as.controller.SimpleOperationDefinitionBuilder,6,0,0,5,0,1,0,0,12
wildfly_wildfly-core.org.jboss.as.controller.access.TargetResource,0,0,0,0,0,1,0,0,1
wildfly_wildfly-core.org.jboss.as.controller.access.permission.CombinationManagementPermission,2,0,0,2,0,0,0,0,4
wildfly_wildfly-core.org.jboss.as.controller.access.permission.SimpleManagementPermission,1,0,0,0,0,0,0,0,1
wildfly_wildfly-core.org.jboss.as.controller.access.permission.ManagementPermissionCollection,2,0,0,1,0,2,0,0,5
wildfly_wildfly-core.org.jboss.as.controller.registry.Resource,24,0,0,24,0,6,0,5,59
wildfly_wildfly-core.org.jboss.as.controller.access.constraint.AbstractSensitivity,11,0,0,11,0,0,0,0,22
wildfly_wildfly-core.org.jboss.as.controller.access.management.AuthorizedAddress,0,0,0,0,0,0,0,0,0
wildfly_wildfly-core.org.jboss.as.controller.operations.global.LocaleResolver,1,0,0,0,0,0,0,0,1
wildfly_wildfly-core.org.jboss.as.controller.remote.ResponseAttachmentInputStreamSupport,4,0,0,2,0,0,0,0,6
wildfly_wildfly-core.org.jboss.as.controller.services.path.AbstractPathService,1,1,0,0,0,0,0,1,3
wildfly_wildfly-core.org.jboss.as.controller.registry.AttributeAccess,4,0,0,4,0,0,0,0,8
wildfly_wildfly-core.org.jboss.as.controller.registry.ImmutableManagementResourceRegistration,16,0,0,6,0,0,0,0,22
wildfly_wildfly-core.org.jboss.as.controller.interfaces.InterfaceCriteria,2,0,0,1,0,0,0,0,3
wildfly_wildfly-core.org.jboss.as.controller.interfaces.OverallInterfaceCriteria,5,0,0,0,0,0,0,0,5
wildfly_wildfly-core.org.jboss.as.controller.interfaces.InetAddressMatchInterfaceCriteria,2,1,0,1,0,0,0,0,4
wildfly_wildfly-core.org.jboss.as.controller.interfaces.ParsedInterfaceCriteria,1,0,0,1,0,0,0,0,2
wildfly_wildfly-core.org.jboss.as.controller.interfaces.SubnetMatchInterfaceCriteria,1,0,0,0,0,0,0,0,1
wildfly_wildfly-core.org.jboss.as.controller.interfaces.NotInterfaceCriteria,2,0,0,0,0,0,0,0,2
wildfly_wildfly-core.org.jboss.as.controller.interfaces.AbstractInterfaceCriteria,2,1,0,0,0,0,0,0,3
wildfly_wildfly-core.org.jboss.as.controller.interfaces.AnyInterfaceCriteria,2,0,0,0,0,0,0,0,2
wildfly_wildfly-core.org.jboss.as.controller.parsing.ParseUtils,1,0,0,0,0,0,0,0,1
wildfly_wildfly-core.org.jboss.as.controller.notification.Notification,0,0,0,0,0,0,0,0,0
wildfly_wildfly-core.org.jboss.as.controller.persistence.ConfigurationExtension,6,0,0,6,0,0,0,0,12
wildfly_wildfly-core.org.jboss.as.controller.transform.description.ResourceTransformationDescriptionBuilder,10,0,0,10,0,0,0,2,22
wildfly_wildfly-core.org.jboss.as.controller.transform.description.BaseAttributeTransformationDescriptionBuilder,19,0,0,19,0,0,0,2,40
wildfly_wildfly-core.org.jboss.as.controller.transform.description.ChainedTransformationDescriptionBuilder,7,0,0,7,0,0,0,3,17
wildfly_wildfly-core.org.jboss.as.controller.transform.TransformersSubRegistration,1,0,0,1,0,0,0,0,2
wildfly_wildfly-core.org.jboss.as.controller.PropertiesAttributeDefinition,2,0,0,0,0,0,0,0,2
wildfly_wildfly-core.org.jboss.as.controller.remote.RemoteProxyController,5,0,0,0,0,1,0,0,6
wildfly_wildfly-core.org.jboss.as.controller.client.OperationResponse,1,0,0,1,0,1,0,0,3
wildfly_wildfly-core.org.jboss.as.controller.client.Operation,5,0,0,0,0,0,0,7,12
wildfly_wildfly-core.org.jboss.as.controller.remote.BlockingQueueOperationListener,0,0,0,0,0,0,0,3,3
wildfly_wildfly-core.org.jboss.as.domain.management.security.adduser.State,5,1,0,1,0,0,0,0,7
wildfly_wildfly-core.org.jboss.as.domain.management.security.adduser.PropertiesFileLoader,2,0,0,2,0,0,0,4,8
wildfly_wildfly-core.org.jboss.as.domain.management.logging.DomainManagementLogger,1,0,0,1,0,0,0,0,2
wildfly_wildfly-core.org.jboss.as.domain.management.security.adduser.UpdateUser,1,0,0,1,0,0,0,0,2
wildfly_wildfly-core.org.jboss.as.domain.management.security.adduser.UpdatePropertiesHandler,1,0,0,0,0,0,0,0,1
wildfly_wildfly-core.org.jboss.as.domain.management.security.password.LengthRestriction,0,0,0,0,0,0,0,1,1
wildfly_wildfly-core.org.jboss.as.domain.management.security.password.ValueRestriction,0,0,0,0,0,0,0,1,1
wildfly_wildfly-core.org.jboss.as.domain.management.security.password.RegexRestriction,0,0,0,0,0,0,0,1,1
wildfly_wildfly-core.org.jboss.as.domain.management.security.password.UsernamePasswordMatch,0,0,0,0,0,0,0,1,1
wildfly_wildfly-core.org.jboss.as.domain.management.security.password.PasswordCheckUtil,0,0,0,0,0,0,0,1,1
wildfly_wildfly-core.org.jboss.as.domain.management.security.password.simple.SimplePasswordStrengthChecker,5,0,0,5,0,0,0,0,10
wildfly_wildfly-core.org.jboss.as.domain.management.security.password.simple.SimpleDictionary,0,0,0,0,0,0,0,0,0
wildfly_wildfly-core.org.jboss.as.domain.management.security.password.simple.SimpleKeyboard,2,0,0,0,0,0,0,0,2
wildfly_wildfly-core.org.jboss.as.domain.management.controller.FindNonProgressingOperationHandler,2,0,0,0,0,1,0,0,3
wildfly_wildfly-core.org.jboss.as.domain.management.audit.validators.SuffixValidator,1,0,0,0,0,0,0,0,1
wildfly_wildfly-core.org.wildfly.core.embedded.EmbeddedStandaloneServerFactory,5,0,0,0,0,0,0,0,5
wildfly_wildfly-core.org.wildfly.core.embedded.StandaloneSystemPropertyContext,0,0,0,0,0,0,0,0,0
wildfly_wildfly-core.org.jboss.as.network.NetworkUtils,2,0,0,0,0,0,0,0,2
wildfly_wildfly-core.org.jboss.as.patching.management.DeleteOp,0,0,0,0,0,0,0,1,1
wildfly_wildfly-core.org.jboss.as.patching.installation.InstalledIdentity,8,0,0,6,0,2,0,0,16
wildfly_wildfly-core.org.jboss.as.patching.installation.PatchableTarget,3,1,0,3,0,0,0,0,7
wildfly_wildfly-core.org.jboss.as.patching.tool.PatchTool,8,0,0,7,0,6,0,2,23
wildfly_wildfly-core.org.jboss.as.patching.runner.ContentTaskDefinitions,3,0,0,3,0,0,0,0,6
wildfly_wildfly-core.org.jboss.as.patching.installation.Identity,1,0,0,1,0,0,0,0,2
wildfly_wildfly-core.org.jboss.as.patching.validation.PatchHistoryIterator,2,0,0,2,0,0,0,0,4
wildfly_wildfly-core.org.jboss.as.patching.validation.PatchHistoryValidations,0,0,0,0,0,0,0,3,3
wildfly_wildfly-core.org.jboss.as.patching.metadata.PatchBundleXml,1,0,0,1,0,0,0,0,2
wildfly_wildfly-core.org.jboss.as.patching.metadata.PatchMetadataResolver,3,1,0,2,0,1,0,0,7
wildfly_wildfly-core.org.jboss.as.patching.validation.PatchingGarbageLocator,4,0,0,4,0,0,0,0,8
wildfly_wildfly-core.org.wildfly.core.jar.runtime.Arguments,4,0,0,1,0,1,0,0,6
wildfly_wildfly-core.org.wildfly.core.jar.boot.Main,0,0,0,0,0,1,0,1,2
wildfly_wildfly-core.org.wildfly.extension.requestcontroller.RequestController,0,0,0,0,0,0,0,0,0
wildfly_wildfly-core.org.jboss.as.remoting.RemotingServices,5,0,0,4,0,1,1,0,11
wildfly_wildfly-core.org.wildfly.extension.elytron.SecurityPropertiesWriteHandler,2,0,0,0,0,0,0,0,2
wildfly_wildfly-core.org.jboss.as.controller.OperationStepHandler,0,0,0,0,0,0,0,2,2
wildfly_wildfly-core.org.jboss.as.host.controller.ManagedServerBootCmdFactory,1,1,0,1,0,0,0,0,3
wildfly_wildfly-core.org.jboss.as.host.controller.discovery.S3Util,1,0,0,1,0,0,0,0,2
wildfly_wildfly-core.org.jboss.as.host.controller.model.jvm.JvmOptionsBuilderFactory,0,0,0,0,0,0,0,0,0
wildfly_wildfly-core.org.jboss.as.host.controller.model.jvm.JvmOptionsElement,1,1,0,1,0,0,0,0,3
wildfly_wildfly-core.org.jboss.as.host.controller.mgmt.HostInfo,1,0,0,1,0,0,0,0,2
wildfly_wildfly-core.org.jboss.as.host.controller.ignored.IgnoredDomainResourceRegistry,1,0,0,1,0,0,0,0,2
wildfly_wildfly-core.org.wildfly.core.launcher.AbstractCommandBuilder,2,0,0,2,0,0,0,0,4
wildfly_wildfly-core.org.wildfly.core.launcher.BootableJarCommandBuilder,1,0,0,1,0,0,0,0,2
wildfly_wildfly-core.org.wildfly.core.launcher.CliCommandBuilder,1,0,0,1,0,0,0,0,2
wildfly_wildfly-core.org.wildfly.core.launcher.Arguments,1,0,0,1,0,0,0,0,2
google_domaintest.foo.domaintest.http.HttpApiModule,8,0,0,0,0,0,0,0,8
google_domaintest.foo.domaintest.http.StashAction,2,0,0,2,0,0,0,0,4
google_domaintest.foo.domaintest.http.EchoAction,1,0,0,0,0,0,0,0,1
google_domaintest.foo.domaintest.http.TempAction,1,0,0,1,0,0,0,0,2
google_domaintest.foo.domaintest.http.TokenAction,1,0,0,1,0,0,0,0,2
google_domaintest.foo.domaintest.metrics.impl.MetricsImpl,1,0,0,1,0,0,0,0,2
google_domaintest.foo.domaintest.metrics.impl.MetricsTaskAction,0,0,0,0,0,0,0,4,4
google_domaintest.foo.domaintest.email.EmailApiModule,0,0,0,0,0,0,0,0,0
google_domaintest.foo.domaintest.email.AutoreplyAction,0,0,0,0,0,0,0,9,9
google_domaintest.foo.domaintest.action.Response,0,0,0,0,0,0,0,4,4
google_domaintest.foo.domaintest.action.ActionDelegator,2,0,0,0,0,0,0,0,2
holodeck-b2b_Holodeck-B2B.org.holodeckb2b.interfaces.messagemodel.IMessageUnit,4,0,0,3,0,2,0,0,9
holodeck-b2b_Holodeck-B2B.org.holodeckb2b.interfaces.messagemodel.IPayload,4,1,0,3,0,0,0,0,8
holodeck-b2b_Holodeck-B2B.org.holodeckb2b.interfaces.messagemodel.ISelectivePullRequest,1,0,0,1,0,0,0,0,2
holodeck-b2b_Holodeck-B2B.org.holodeckb2b.interfaces.workerpool.IWorkerConfiguration,3,0,0,2,0,3,0,0,8
holodeck-b2b_Holodeck-B2B.org.holodeckb2b.interfaces.core.HolodeckB2BCoreInterface,2,0,0,2,0,3,0,0,7
holodeck-b2b_Holodeck-B2B.org.holodeckb2b.interfaces.pmode.validation.IPModeValidator,1,0,0,0,0,1,0,0,2
holodeck-b2b_Holodeck-B2B.org.holodeckb2b.interfaces.core.IMessageProcessingContext,63,0,0,49,0,63,0,0,175
holodeck-b2b_Holodeck-B2B.org.holodeckb2b.interfaces.processingmodel.IMessageUnitProcessingState,2,0,0,2,0,2,0,0,6
holodeck-b2b_Holodeck-B2B.org.holodeckb2b.interfaces.messagemodel.IEbmsError,1,0,0,0,0,1,0,0,2
holodeck-b2b_Holodeck-B2B.org.holodeckb2b.interfaces.workerpool.WorkerPoolException,1,0,0,1,0,1,0,0,3
holodeck-b2b_Holodeck-B2B.org.holodeckb2b.interfaces.security.ISecurityProcessingResult,5,0,0,3,0,5,0,0,13
holodeck-b2b_Holodeck-B2B.org.holodeckb2b.interfaces.pmode.IPModeSet,1,1,0,1,0,1,0,0,4
holodeck-b2b_Holodeck-B2B.org.holodeckb2b.interfaces.security.IUsernameTokenProcessingResult,3,0,0,3,0,0,0,0,6
subchen_jetbrick-template-2x.jetbrick.template.parser.ast.ALU,11,0,0,0,0,0,0,0,11
jlinn_quartz-redis-jobstore.net.joelinn.quartz.jobstore.RedisJobStoreSchema,1,0,0,1,0,0,0,0,2
damiencarol_jsr203-hadoop.hdfs.jsr203.HadoopBasicFileAttributeView,1,0,0,0,0,0,0,0,1
damiencarol_jsr203-hadoop.hdfs.jsr203.HadoopUserPrincipal,1,0,0,0,0,0,0,0,1
google_truth.com.google.common.truth.extensions.re2j.Re2jSubjects,0,0,0,0,0,0,0,8,8
google_truth.com.google.common.truth.Subject,38,8,0,0,0,4,0,296,346
google_truth.com.google.common.truth.ExpectFailure,5,0,0,0,0,12,0,49,66
google_truth.com.google.common.truth.extensions.proto.LiteProtoSubject,0,0,0,0,0,0,0,1,1
google_truth.com.google.common.truth.extensions.proto.FieldScopes,0,0,0,0,0,0,0,10,10
google_truth.com.google.common.truth.extensions.proto.ProtoTruth,1,1,0,0,0,1,0,0,3
google_truth.com.google.common.truth.StringSubject,5,1,0,2,0,0,0,53,61
google_truth.com.google.common.truth.extensions.proto.ProtoSubjectBuilder,0,0,0,0,0,0,0,4,4
google_truth.com.google.common.truth.OptionalDoubleSubject,0,0,0,0,0,0,0,9,9
google_truth.com.google.common.truth.IntStreamSubject,3,0,0,2,0,3,0,25,33
google_truth.com.google.common.truth.Ordered,16,0,0,0,0,6,0,24,46
google_truth.com.google.common.truth.OptionalSubject,0,0,0,0,0,0,0,9,9
google_truth.com.google.common.truth.OptionalLongSubject,0,0,0,0,0,0,0,9,9
google_truth.com.google.common.truth.OptionalIntSubject,0,0,0,0,0,0,0,9,9
google_truth.com.google.common.truth.StreamSubject,3,0,0,2,0,3,0,25,33
google_truth.com.google.common.truth.LongStreamSubject,3,0,0,2,0,3,0,29,37
google_truth.com.google.common.truth.BooleanSubject,4,0,0,0,0,2,0,28,34
google_truth.com.google.common.truth.MathUtil,0,0,0,0,0,0,0,6,6
google_truth.com.google.common.truth.PrimitiveShortArraySubject,0,0,0,0,0,0,0,2,2
google_truth.com.google.common.truth.ObjectArraySubject,0,0,0,0,0,0,0,6,6
google_truth.com.google.common.truth.AbstractArraySubject,0,0,0,0,0,0,0,18,18
google_truth.com.google.common.truth.StandardSubjectBuilder,0,0,0,0,0,4,0,22,26
google_truth.com.google.common.truth.MapSubject,12,0,0,0,0,0,0,22,34
google_truth.com.google.common.truth.TruthFailureSubject,12,0,0,12,0,0,0,12,36
google_truth.com.google.common.truth.PrimitiveCharArraySubject,0,0,0,0,0,0,0,2,2
google_truth.com.google.common.truth.LongSubject,0,0,0,0,0,0,0,12,12
google_truth.com.google.common.truth.PrimitiveBooleanArraySubject,0,0,0,0,0,0,0,2,2
google_truth.com.google.common.truth.IterableSubject,26,0,0,0,0,0,0,42,68
google_truth.com.google.common.truth.Truth,0,0,0,0,0,0,0,8,8
google_truth.com.google.common.truth.ThrowableSubject,0,0,0,0,0,0,0,16,16
google_truth.com.google.common.truth.StackTraceCleaner,0,0,0,0,0,0,0,36,36
google_truth.com.google.common.truth.BigDecimalSubject,2,0,0,0,0,0,0,4,6
google_truth.com.google.common.truth.DoubleSubject,4,0,0,0,0,0,0,48,52
google_truth.com.google.common.truth.PrimitiveDoubleArraySubject,48,0,0,8,0,0,0,68,124
google_truth.com.google.common.truth.Platform,0,0,0,0,0,0,0,8,8
google_truth.com.google.common.truth.PrimitiveLongArraySubject,0,0,0,0,0,0,0,2,2
google_truth.com.google.common.truth.ComparisonFailureWithFacts,0,0,0,0,0,0,0,2,2
google_truth.com.google.common.truth.Fact,0,0,0,0,0,0,0,22,22
google_truth.com.google.common.truth.FloatSubject,4,0,0,0,0,0,0,52,56
google_truth.com.google.common.truth.PrimitiveFloatArraySubject,46,0,0,10,0,0,0,62,118
google_truth.com.google.common.truth.IntegerSubject,0,0,0,0,0,0,0,0,0
google_truth.com.google.common.truth.ClassSubject,0,0,0,0,0,0,0,4,4
google_truth.com.google.common.truth.Correspondence,4,0,0,0,0,0,0,50,54
google_truth.com.google.common.truth.PrimitiveByteArraySubject,0,0,0,0,0,0,0,2,2
google_truth.com.google.common.truth.PrimitiveIntArraySubject,0,0,0,0,0,0,0,2,2
google_truth.com.google.common.truth.GuavaOptionalSubject,0,0,0,0,0,0,0,0,0
.com.google.dart.util.Pub,0,0,0,0,0,0,0,0,0
pastekit_twist.com.dotweblabs.twirl.gae.GaeUnmarshaller,3,0,0,0,0,0,0,0,3
pastekit_twist.com.dotweblabs.twirl.ObjectStore,38,0,0,2,0,0,0,0,40
pastekit_twist.com.dotweblabs.twirl.object.KeyStructure,0,0,0,0,0,0,0,0,0
pastekit_twist.com.dotweblabs.twirl.Marshaller,6,0,0,0,0,0,0,1,7
pastekit_twist.com.dotweblabs.twirl.util.AnnotationUtil,5,0,0,0,0,0,0,0,5
pastekit_twist.com.dotweblabs.twirl.util.KeyUtil,1,0,0,0,0,0,0,0,1
pastekit_twist.com.dotweblabs.twirl.util.StringHelper,1,0,0,0,0,0,0,0,1
englishtown_vertx-cassandra.com.englishtown.vertx.cassandra.impl.DefaultCassandraSession,0,0,0,0,0,0,0,4,4
englishtown_vertx-cassandra.com.englishtown.vertx.cassandra.impl.JsonCassandraConfigurator,15,0,0,0,0,0,0,0,15
englishtown_vertx-cassandra.com.englishtown.vertx.cassandra.tablebuilder.CreateTable,0,0,0,0,0,0,0,0,0
englishtown_vertx-cassandra.com.englishtown.vertx.cassandra.tablebuilder.TableBuilder,2,0,0,2,0,0,0,0,4
englishtown_vertx-cassandra.com.englishtown.vertx.cassandra.tablebuilder.AlterTable,0,0,0,0,0,0,0,0,0
englishtown_vertx-cassandra.com.englishtown.vertx.cassandra.tablebuilder.DropTable,0,0,0,0,0,0,0,0,0
englishtown_vertx-cassandra.com.englishtown.vertx.cassandra.keyspacebuilder.KeyspaceBuilder,0,0,0,0,0,0,0,0,0
englishtown_vertx-cassandra.com.englishtown.vertx.cassandra.keyspacebuilder.DropKeyspace,0,0,0,0,0,0,0,0,0
englishtown_vertx-cassandra.com.englishtown.vertx.cassandra.keyspacebuilder.CreateKeyspace,0,0,0,0,0,0,0,0,0
englishtown_vertx-cassandra.com.englishtown.vertx.cassandra.keyspacebuilder.KeyspaceBuilderBase,0,0,0,0,0,0,0,0,0
englishtown_vertx-cassandra.com.englishtown.vertx.cassandra.promises.impl.DefaultWhenCassandraSession,2,0,0,0,0,0,0,0,2
englishtown_vertx-cassandra.com.englishtown.vertx.cassandra.mapping.impl.DefaultVertxMappingManager,0,0,0,0,0,0,0,0,0
vert-x3_codegen.io.vertx.core.json.JsonObject,8,0,0,6,0,0,0,0,14
vert-x3_codegen.io.vertx.codegen.ClassModel,127,0,0,127,0,1,0,3,258
vert-x3_codegen.io.vertx.codegen.DataObjectModel,56,0,0,50,0,0,0,0,106
vert-x3_codegen.io.vertx.codegen.EnumModel,4,0,0,4,0,0,0,0,8
vert-x3_codegen.io.vertx.codegen.ModuleModel,3,0,0,3,0,0,0,0,6
vert-x3_codegen.io.vertx.codegen.PackageModel,3,0,0,0,0,0,0,0,3
vert-x3_codegen.io.vertx.codegen.type.TypeInfo,2,0,0,2,0,0,0,0,4
vert-x3_codegen.io.vertx.codegen.type.TypeVariableInfo,1,0,0,1,0,0,0,0,2
vert-x3_codegen.io.vertx.codegen.type.ParameterizedTypeInfo,0,0,0,0,0,0,0,3,3
vert-x3_codegen.io.vertx.codegen.type.DataObjectInfo,1,0,0,1,0,0,0,0,2
vert-x3_codegen.io.vertx.codegen.type.ClassTypeInfo,2,0,0,2,0,0,0,0,4
vert-x3_codegen.io.vertx.codegen.type.TypeReflectionFactory,2,0,0,2,0,0,0,0,4
vert-x3_codegen.io.vertx.codegen.PropertyInfo,1,0,0,1,0,0,0,0,2
vert-x3_codegen.io.vertx.codegen.format.Case,1,0,0,0,0,0,0,0,1
vert-x3_codegen.io.vertx.codegen.Helper,1,0,0,0,0,0,0,0,1
vert-x3_codegen.io.vertx.codegen.doc.Token,5,0,0,5,0,0,0,0,10
vert-x3_codegen.io.vertx.codegen.doc.Doc,4,0,0,4,0,0,0,0,8
vert-x3_codegen.io.vertx.codegen.Compiler,8,0,0,4,0,0,0,0,12
vert-x3_codegen.io.vertx.codegen.writer.CodeWriter,2,0,0,2,0,0,0,7,11
google_closure-templates.com.google.template.soy.exprtree.BooleanNode,2,0,0,2,0,0,0,0,4
google_closure-templates.com.google.template.soy.exprtree.AbstractParentExprNode,8,0,0,4,0,0,0,0,12
google_closure-templates.com.google.template.soy.exprtree.FunctionNode,4,0,0,2,0,0,0,0,6
google_closure-templates.com.google.template.soy.base.internal.Identifier,2,0,0,2,0,0,0,0,4
google_closure-templates.com.google.template.soy.exprtree.IntegerNode,2,0,0,2,0,0,0,0,4
google_closure-templates.com.google.template.soy.error.ErrorReporter,66,2,0,62,0,0,0,10,140
google_closure-templates.com.google.template.soy.base.SourceLocation,34,0,0,8,0,0,0,0,42
google_closure-templates.com.google.template.soy.soytree.AbstractParentCommandNode,52,0,0,46,0,0,0,0,98
google_closure-templates.com.google.template.soy.soytree.HtmlOpenTagNode,8,0,0,8,0,0,0,0,16
google_closure-templates.com.google.template.soy.soytree.RawTextNode,20,0,0,20,0,0,0,0,40
google_closure-templates.com.google.template.soy.soytree.TemplateNode,8,0,0,4,0,0,0,0,12
google_closure-templates.com.google.template.soy.soyparse.SoyParseUtils,4,0,0,0,0,0,0,0,4
google_closure-templates.com.google.template.soy.AbstractSoyCompiler,2,0,0,0,0,0,0,0,2
google_closure-templates.com.google.template.soy.PerInputOutputFiles,2,0,0,0,0,4,0,0,6
google_closure-templates.com.google.template.soy.basicdirectives.ChangeNewlineToBrDirective,0,0,0,0,0,0,0,0,0
google_closure-templates.com.google.template.soy.basicdirectives.FilterImageDataUriDirective,0,0,0,0,0,0,0,0,0
google_closure-templates.com.google.template.soy.basicdirectives.TruncateDirective,4,0,0,0,0,0,0,0,4
google_closure-templates.com.google.template.soy.basicdirectives.CleanHtmlDirective,6,0,0,2,0,4,0,0,12
google_closure-templates.com.google.template.soy.basicdirectives.BasicDirectives,0,0,0,0,0,0,0,2,2
google_closure-templates.com.google.template.soy.basicdirectives.InsertWordBreaksDirective,0,0,0,0,0,0,0,0,0
google_closure-templates.com.google.template.soy.data.UnsafeSanitizedContentOrdainer,26,0,0,6,0,2,0,0,34
google_closure-templates.com.google.template.soy.basicdirectives.BasicEscapeDirective,2,0,0,0,0,0,0,0,2
google_closure-templates.com.google.template.soy.basicdirectives.TextDirective,2,0,0,0,0,0,0,0,2
google_closure-templates.com.google.template.soy.jbcsrc.shared.CompiledTemplates,40,0,0,34,0,0,0,0,74
google_closure-templates.com.google.template.soy.logging.LoggableElement,4,0,0,4,0,0,0,6,14
google_closure-templates.com.google.template.soy.data.LoggingAdvisingAppendable,6,0,0,6,0,0,0,0,12
google_closure-templates.com.google.template.soy.jbcsrc.SimpleLocalVariableManager,4,0,0,4,0,0,0,0,8
google_closure-templates.com.google.template.soy.jbcsrc.TemplateAnalysisImpl,0,0,0,0,0,0,0,0,0
google_closure-templates.com.google.template.soy.jbcsrc.FieldManager,2,0,0,2,0,2,0,0,6
google_closure-templates.com.google.template.soy.jbcsrc.BytecodeCompiler,4,0,0,4,0,0,0,0,8
google_closure-templates.com.google.template.soy.css.CssRegistry,4,0,0,4,0,0,0,0,8
google_closure-templates.com.google.template.soy.data.restricted.IntegerData,8,0,0,6,0,0,0,8,22
google_closure-templates.com.google.template.soy.data.SanitizedContents,22,0,0,18,0,2,0,0,42
google_closure-templates.com.google.template.soy.SoyFileSetParser,4,0,0,4,0,0,0,2,10
google_closure-templates.com.google.template.soy.jbcsrc.restricted.SoyExpression,32,0,0,32,0,0,0,32,96
google_closure-templates.com.google.template.soy.jbcsrc.internal.ClassData,2,0,0,2,0,0,0,0,4
google_closure-templates.com.google.template.soy.internal.exemptions.NamespaceExemptions,2,0,0,0,0,0,0,0,2
google_closure-templates.com.google.template.soy.jbcsrc.shared.Names,8,0,0,0,0,0,0,0,8
google_closure-templates.com.google.template.soy.jbcsrc.restricted.BytecodeProducer,0,0,0,0,0,2,0,0,2
google_closure-templates.com.google.template.soy.jbcsrc.restricted.TypeInfo,2,0,0,2,0,0,0,0,4
google_closure-templates.com.google.template.soy.jbcsrc.restricted.FieldRef,2,0,0,2,0,0,0,0,4
google_closure-templates.com.google.template.soy.jbcsrc.restricted.BytecodeUtils,16,0,0,6,0,0,0,0,22
google_closure-templates.com.google.template.soy.types.NullType,0,0,0,0,0,0,0,4,4
google_closure-templates.com.google.template.soy.types.IntType,2,0,0,2,0,0,0,10,14
google_closure-templates.com.google.template.soy.jbcsrc.api.PluginRuntimeInstanceInfo,0,0,0,0,0,0,0,0,0
google_closure-templates.com.google.template.soy.jbcsrc.api.SoySauce,40,0,0,36,0,14,0,0,90
google_closure-templates.com.google.template.soy.msgs.restricted.SoyMsgRawTextPart,8,0,0,8,0,0,0,6,22
google_closure-templates.com.google.template.soy.jbcsrc.runtime.JbcSrcRuntime,0,0,0,0,0,0,0,0,0
google_closure-templates.com.google.template.soy.jbcsrc.api.RenderResult,2,0,0,0,0,0,0,0,2
google_closure-templates.com.google.template.soy.logging.AnnotatedLoggableElement,0,0,0,0,0,0,0,2,2
google_closure-templates.com.google.template.soy.logging.ValidatedLoggingConfig,4,0,0,4,0,0,0,0,8
google_closure-templates.com.google.template.soy.data.restricted.StringData,14,0,0,14,0,0,0,0,28
google_closure-templates.com.google.template.soy.data.restricted.FloatData,12,0,0,6,0,0,0,0,18
google_closure-templates.com.google.template.soy.data.internal.SoyMapImpl,0,0,0,0,0,0,0,0,0
google_closure-templates.com.google.template.soy.soytree.TagName,10,0,0,10,0,0,0,0,20
google_closure-templates.com.google.template.soy.exprtree.ExprRootNode,4,0,0,4,0,0,0,0,8
google_closure-templates.com.google.template.soy.basetree.Node,6,0,0,6,0,0,0,0,12
google_closure-templates.com.google.template.soy.soytree.PrintNode,6,0,0,2,0,0,0,0,8
google_closure-templates.com.google.template.soy.soytree.LetContentNode,4,0,0,4,0,0,0,0,8
google_closure-templates.com.google.template.soy.passes.CombineConsecutiveRawTextNodesPass,8,0,0,8,0,0,0,0,16
google_closure-templates.com.google.template.soy.internal.base.UnescapeUtils,2,0,0,0,0,0,0,0,2
google_closure-templates.com.google.template.soy.internal.i18n.BidiFormatter,10,0,0,6,0,0,0,0,16
google_closure-templates.com.google.template.soy.internal.i18n.SoyBidiUtils,8,0,0,4,0,0,0,0,12
google_closure-templates.com.google.template.soy.internal.i18n.BidiUtils,14,0,0,0,0,0,0,0,14
google_closure-templates.com.google.template.soy.internal.i18n.BidiGlobalDir,2,0,0,2,0,0,0,0,4
google_closure-templates.com.google.template.soy.shared.SoyAstCache,2,0,0,2,0,0,0,0,4
google_closure-templates.com.google.template.soy.shared.internal.MainEntryPointUtils,4,0,0,0,0,0,0,0,4
google_closure-templates.com.google.template.soy.shared.internal.FindCalleesNotInFile,0,0,0,0,0,0,0,0,0
google_closure-templates.com.google.template.soy.shared.internal.EscapingConventions,0,0,0,0,0,0,0,0,0
google_closure-templates.com.google.template.soy.shared.internal.SharedRuntime,8,0,0,8,0,0,0,0,16
google_closure-templates.com.google.template.soy.shared.internal.InternalPlugins,8,4,0,2,0,0,0,0,14
google_closure-templates.com.google.template.soy.shared.internal.Sanitizers,32,0,0,16,0,0,0,0,48
google_closure-templates.com.google.template.soy.shared.internal.gencode.JavaGenerationUtils,2,0,0,0,0,0,0,0,2
google_closure-templates.com.google.template.soy.data.SoyList,2,0,0,2,0,0,0,0,4
google_closure-templates.com.google.template.soy.data.SoyLegacyObjectMap,4,0,0,4,0,0,0,0,8
google_closure-templates.com.google.template.soy.types.AnyType,0,0,0,0,0,0,0,6,6
google_closure-templates.com.google.template.soy.types.UnknownType,0,0,0,0,0,0,0,2,2
google_closure-templates.com.google.template.soy.types.BoolType,0,0,0,0,0,0,0,2,2
google_closure-templates.com.google.template.soy.types.StringType,4,0,0,4,0,0,0,6,14
google_closure-templates.com.google.template.soy.types.FloatType,2,0,0,2,0,0,0,2,6
google_closure-templates.com.google.template.soy.types.ListType,0,0,0,0,0,0,0,4,4
google_closure-templates.com.google.template.soy.types.LegacyObjectMapType,0,0,0,0,0,0,0,4,4
google_closure-templates.com.google.template.soy.sharedpasses.render.CountingFlushableAppendable,2,0,0,2,0,0,0,0,4
google_closure-templates.com.google.template.soy.soytree.AbstractParentSoyNode,24,0,0,24,0,0,0,0,48
google_closure-templates.com.google.template.soy.sharedpasses.render.RenderVisitor,2,0,0,2,0,0,0,0,4
google_closure-templates.com.google.template.soy.data.SoyValue,10,0,0,10,0,2,0,0,22
google_closure-templates.com.google.template.soy.soytree.TemplateElementNode,2,0,0,2,0,0,0,0,4
google_closure-templates.com.google.template.soy.passes.CheckGeneratedSourcesPass,4,0,0,4,0,0,0,0,8
google_closure-templates.com.google.template.soy.base.SourceFilePath,12,0,0,6,0,0,0,10,28
google_closure-templates.com.google.template.soy.SoyFileSet,0,0,0,0,0,0,0,0,0
google_closure-templates.com.google.template.soy.passes.StrictHtmlValidationPass,24,0,0,24,0,0,0,0,48
google_closure-templates.com.google.template.soy.soytree.FileSetMetadata,2,0,0,2,0,0,0,0,4
google_closure-templates.com.google.template.soy.passes.htmlmatcher.HtmlMatcherTagNode,2,0,0,0,0,0,0,0,2
google_closure-templates.com.google.template.soy.passes.htmlmatcher.HtmlMatcherGraph,10,0,0,10,0,0,0,2,22
google_closure-templates.com.google.template.soy.passes.htmlmatcher.HtmlMatcherAccumulatorNode,4,0,0,4,0,0,0,0,8
google_closure-templates.com.google.template.soy.passes.htmlmatcher.HtmlMatcherConditionNode,20,0,0,20,0,0,0,0,40
google_closure-templates.com.google.template.soy.soytree.IfCondNode,0,0,0,0,0,0,0,0,0
google_closure-templates.com.google.template.soy.soytree.SwitchCaseNode,0,0,0,0,0,0,0,0,0
google_closure-templates.com.google.template.soy.data.SanitizedContent,2,0,0,2,0,0,0,0,4
google_closure-templates.com.google.template.soy.data.SoyListData,8,0,0,6,0,0,0,0,14
google_closure-templates.com.google.template.soy.data.restricted.CollectionData,12,0,0,10,0,0,0,0,22
google_closure-templates.com.google.template.soy.data.SoyDataException,2,0,0,0,0,2,0,0,4
google_closure-templates.com.google.template.soy.data.SoyValueUnconverter,2,0,0,2,0,0,0,0,4
google_closure-templates.com.google.template.soy.data.SoyAbstractCachingValueProvider,6,0,0,6,0,2,0,0,14
google_closure-templates.com.google.template.soy.data.SoyMapData,4,0,0,4,0,0,0,0,8
google_closure-templates.com.google.template.soy.data.SoyValueConverter,6,0,0,4,0,0,0,0,10
google_closure-templates.com.google.template.soy.data.SoyMaps,8,0,0,8,0,0,0,0,16
google_closure-templates.com.google.template.soy.data.AbstractLoggingAdvisingAppendable,0,0,0,0,0,0,0,0,0
google_closure-templates.com.google.template.soy.data.internal.LazyProtoToSoyValueMap,8,0,0,8,0,0,0,8,24
google_closure-templates.com.google.template.soy.data.SoyRecord,2,0,0,2,0,0,0,0,4
google_closure-templates.com.google.template.soy.data.internal.DictImpl,6,0,0,6,0,2,0,0,14
google_closure-templates.com.google.template.soy.data.internal.ListImpl,6,0,0,6,0,0,0,0,12
google_closure-templates.com.google.template.soy.data.internal.LazyProtoToSoyValueList,8,0,0,8,0,0,0,0,16
google_closure-templates.com.google.template.soy.data.internalutils.InternalValueUtils,6,0,0,6,0,0,0,0,12
google_closure-templates.com.google.template.soy.data.internalutils.NodeContentKinds,6,0,0,0,0,0,0,0,6
google_closure-templates.com.google.template.soy.data.restricted.UndefinedData,2,0,0,2,0,0,0,0,4
google_closure-templates.com.google.template.soy.data.restricted.NullData,2,0,0,2,0,0,0,0,4
google_closure-templates.com.google.template.soy.data.restricted.BooleanData,2,0,0,2,0,0,0,0,4
google_closure-templates.com.google.template.soy.basetree.AbstractNode,2,0,0,2,0,0,0,0,4
google_closure-templates.com.google.template.soy.data.internal.Converters,0,0,0,0,0,0,0,2,2
google_closure-templates.com.google.template.soy.base.internal.UniqueNameGenerator,4,0,0,4,0,4,0,0,12
google_closure-templates.com.google.template.soy.base.internal.TemplateContentKind,4,0,0,2,0,0,0,0,6
google_closure-templates.com.google.template.soy.base.internal.BaseUtils,14,0,0,0,0,0,0,0,14
google_closure-templates.com.google.template.soy.base.internal.IndentedLinesBuilder,2,0,0,2,0,0,0,0,4
google_closure-templates.com.google.template.soy.soytree.TemplateMetadataSerializer,2,0,0,0,0,0,0,0,2
google_closure-templates.com.google.template.soy.exprtree.TemplateLiteralNode,0,0,0,0,0,0,0,0,0
google_closure-templates.com.google.template.soy.soytree.MsgNode,18,0,0,18,0,0,0,0,36
google_closure-templates.com.google.template.soy.soytree.HtmlAttributeNode,0,0,0,0,0,0,0,0,0
google_closure-templates.com.google.template.soy.soytree.HtmlCloseTagNode,2,0,0,2,0,0,0,0,4
google_closure-templates.com.google.template.soy.soytree.VeLogNode,10,0,0,10,0,0,0,0,20
google_closure-templates.com.google.template.soy.soytree.KeyNode,2,0,0,0,0,0,0,0,2
google_closure-templates.com.google.template.soy.soytree.TemplateDelegateNode,2,0,0,2,0,0,0,0,4
google_closure-templates.com.google.template.soy.soytree.SoyTreeUtils,2,0,0,2,0,0,0,0,4
google_closure-templates.com.google.template.soy.soytree.SoyFileSetNode,2,0,0,2,0,0,0,0,4
google_closure-templates.com.google.template.soy.soytree.MsgHtmlTagNode,12,0,0,12,0,0,0,0,24
google_closure-templates.com.google.template.soy.bididirectives.BidiSpanWrapDirective,2,0,0,0,0,0,0,0,2
google_closure-templates.com.google.template.soy.bididirectives.BidiUnicodeWrapDirective,2,0,0,0,0,0,0,0,2
google_closure-templates.com.google.template.soy.coredirectives.EscapeHtmlDirective,0,0,0,0,0,0,0,0,0
google_closure-templates.com.google.template.soy.types.SoyType,6,0,0,4,0,0,0,0,10
google_closure-templates.com.google.template.soy.types.TypeInterner,4,0,0,4,0,0,0,0,8
google_closure-templates.com.google.template.soy.types.RecordType,2,0,0,2,0,0,0,2,6
google_closure-templates.com.google.template.soy.types.SanitizedType,2,0,0,2,0,0,0,0,4
google_closure-templates.com.google.template.soy.types.SoyTypes,12,0,0,12,0,0,0,0,24
google_closure-templates.com.google.template.soy.types.MessageType,0,0,0,0,0,0,0,0,0
google_closure-templates.com.google.template.soy.types.SoyProtoType,2,0,0,2,0,0,0,0,4
google_closure-templates.com.google.template.soy.types.ast.NamedTypeNode,0,0,0,0,0,0,0,0,0
google_closure-templates.com.google.template.soy.types.ast.GenericTypeNode,2,0,0,2,0,0,0,0,4
google_closure-templates.com.google.template.soy.types.ast.RecordTypeNode,2,0,0,0,0,0,0,0,2
google_closure-templates.com.google.template.soy.types.ast.TemplateTypeNode,2,0,0,2,0,0,0,0,4
google_closure-templates.com.google.template.soy.types.ast.UnionTypeNode,0,0,0,0,0,0,0,0,0
google_closure-templates.com.google.template.soy.xliffmsgplugin.XliffMsgPlugin,4,0,0,4,0,0,0,0,8
google_closure-templates.com.google.template.soy.msgs.SoyMsgIdConverter,0,0,0,0,0,2,0,0,2
google_closure-templates.com.google.template.soy.msgs.SoyMsgBundleWithFullLocale,6,0,0,6,0,0,0,0,12
google_closure-templates.com.google.template.soy.msgs.internal.IcuSyntaxUtils,2,0,0,0,0,0,0,0,2
google_closure-templates.com.google.template.soy.msgs.internal.InsertMsgsVisitor,10,0,0,10,0,0,0,0,20
google_closure-templates.com.google.template.soy.msgs.internal.SoyMsgIdComputer,4,0,0,2,0,0,0,0,6
google_closure-templates.com.google.template.soy.msgs.restricted.SoyMsg,8,0,0,6,0,0,0,0,14
google_closure-templates.com.google.template.soy.msgs.restricted.SoyMsgBundleImpl,2,0,0,0,0,0,0,0,2
google_closure-templates.com.google.template.soy.msgs.SoyMsgBundle,4,0,0,2,0,0,0,0,6
google_closure-templates.com.google.template.soy.msgs.restricted.RenderOnlySoyMsgBundleImpl,2,0,0,0,0,0,0,0,2
google_closure-templates.com.google.template.soy.jssrc.dsl.CodeChunk,42,0,0,34,0,0,0,0,76
google_closure-templates.com.google.template.soy.jssrc.internal.JavaScriptValueFactoryImpl,2,0,0,2,0,0,0,0,4
google_closure-templates.com.google.template.soy.jssrc.internal.NullSafeAccumulator,0,0,0,0,0,0,0,16,16
google_closure-templates.com.google.template.soy.jssrc.internal.JsSrcUtils,0,0,0,0,0,0,0,0,0
google_closure-templates.com.google.template.soy.jssrc.internal.AliasUtils,8,0,0,8,0,0,0,0,16
google_closure-templates.com.google.template.soy.jssrc.internal.JsCodeBuilder,2,0,0,2,0,0,0,0,4
google_closure-templates.com.google.template.soy.jssrc.internal.GenJsCodeVisitor,0,0,0,0,0,0,0,0,0
google_closure-templates.com.google.template.soy.jssrc.dsl.Expression,0,0,0,0,0,0,0,0,0
google_closure-templates.com.google.template.soy.jssrc.dsl.SoyJsPluginUtils,6,0,0,6,0,0,0,0,12
google_closure-templates.com.google.template.soy.jssrc.dsl.CodeChunkUtils,0,0,0,0,0,0,0,0,0
google_closure-templates.com.google.template.soy.jssrc.SoyJsSrcOptions,2,0,0,2,0,0,0,0,4
google_closure-templates.com.google.template.soy.jssrc.restricted.JsExprUtils,8,0,0,4,0,0,0,0,12
google_closure-templates.com.google.template.soy.exprtree.RecordLiteralNode,0,0,0,0,0,0,0,0,0
google_closure-templates.com.google.template.soy.exprtree.ExprNode,4,0,0,0,0,0,0,0,4
google_closure-templates.com.google.template.soy.exprtree.AbstractOperatorNode,0,0,0,0,0,0,0,0,0
google_closure-templates.com.google.template.soy.exprtree.MethodCallNode,0,0,0,0,0,0,0,0,0
google_closure-templates.com.google.template.soy.exprtree.ListLiteralNode,2,0,0,0,0,0,0,0,2
google_closure-templates.com.google.template.soy.exprtree.StringNode,4,0,0,4,0,0,0,0,8
google_closure-templates.com.google.template.soy.pysrc.restricted.PyExprUtils,2,0,0,2,0,0,0,0,4
google_closure-templates.com.google.template.soy.pysrc.internal.PyCodeBuilder,6,0,0,6,0,0,0,0,12
google_closure-templates.com.google.template.soy.pysrc.internal.PythonValueFactoryImpl,2,0,0,2,0,0,0,0,4
google_closure-templates.com.google.template.soy.pysrc.restricted.PyFunctionExprBuilder,0,0,0,0,0,0,0,0,0
google_closure-templates.com.google.template.soy.error.SourceSnippetPrinter,0,0,0,0,0,0,0,0,0
google_closure-templates.com.google.template.soy.error.SoyErrors,4,0,0,0,0,0,0,0,4
google_closure-templates.com.google.template.soy.i18ndirectives.I18nUtils,2,0,0,0,0,0,0,0,2
google_closure-templates.com.google.template.soy.tofu.SoyTofu,2,0,0,0,0,0,0,0,2
beothorn_webGrude.webGrude.Browser,0,0,0,0,0,0,0,0,0
OpenMRS_openmrs-module-fhir.org.openmrs.module.fhir.api.ConditionService,6,0,0,5,0,0,0,0,11
OpenMRS_openmrs-module-fhir.org.openmrs.module.fhir.api.AllergyIntoleranceService,4,0,0,0,0,0,0,0,4
OpenMRS_openmrs-module-fhir.org.openmrs.module.fhir.api.MedicationRequestService,4,0,0,1,0,0,0,0,5
OpenMRS_openmrs-module-fhir.org.openmrs.module.fhir.api.PractitionerService,6,0,0,0,0,0,0,0,6
OpenMRS_openmrs-module-fhir.org.openmrs.module.fhir.api.AppointmentService,1,0,0,0,0,0,0,0,1
OpenMRS_openmrs-module-fhir.org.openmrs.module.fhir.api.PersonService,4,0,0,0,0,0,0,0,4
OpenMRS_openmrs-module-fhir.org.openmrs.module.fhir.api.util.FHIRPersonUtil,4,0,0,2,0,0,0,0,6
OpenMRS_openmrs-module-fhir.org.openmrs.module.fhir.api.DiagnosticReportService,1,0,0,1,0,0,0,0,2
OpenMRS_openmrs-module-fhir.org.openmrs.module.fhir.api.PatientService,10,0,0,0,0,0,0,0,10
OpenMRS_openmrs-module-fhir.org.openmrs.module.fhir.api.EncounterService,15,0,0,2,0,0,0,0,17
OpenMRS_openmrs-module-fhir.org.openmrs.module.fhir.api.RelatedPersonService,6,0,0,4,0,0,0,0,10
OpenMRS_openmrs-module-fhir.org.openmrs.module.fhir.api.LocationService,7,1,0,1,0,0,0,0,9
OpenMRS_openmrs-module-fhir.org.openmrs.module.fhir.api.util.FHIRLocationUtil,0,0,0,0,0,0,0,0,0
OpenMRS_openmrs-module-fhir.org.openmrs.module.fhir.api.ObsService,9,0,0,1,0,0,0,0,10
OpenMRS_openmrs-module-fhir.org.openmrs.module.fhir.api.util.FHIRObsUtil,2,0,0,0,0,0,0,0,2
OpenMRS_openmrs-module-fhir.org.openmrs.module.fhir.api.FamilyMemberHistoryService,3,0,0,0,0,0,0,0,3
OpenMRS_openmrs-module-fhir.org.openmrs.module.fhir.swagger.SwaggerSpecificationCreator,2,0,0,1,0,0,0,0,3
OpenMRS_openmrs-module-fhir.org.openmrs.module.fhir.api.merge.MergeResult,1,0,0,1,0,0,0,0,2
OpenMRS_openmrs-module-fhir.org.openmrs.module.fhir.api.helper.FHIRClientHelper,1,0,0,0,0,0,0,0,1
jitsi_jigasi.org.jitsi.jigasi.AbstractGateway,3,0,0,3,0,0,0,0,6
jitsi_jigasi.org.jitsi.jigasi.JigasiBundleActivator,2,0,0,2,0,0,0,0,4
jitsi_jigasi.org.jitsi.jigasi.rest.RESTUtil,1,0,0,0,0,0,0,0,1
elibom_jogger.com.elibom.jogger.DefaultExceptionHandler,0,0,0,0,0,3,0,3,6
elibom_jogger.com.elibom.jogger.Jogger,2,0,0,1,0,0,0,1,4
elibom_jogger.com.elibom.jogger.http.Response,1,0,0,1,0,0,0,10,12
elibom_jogger.com.elibom.jogger.http.Request,9,0,0,4,0,0,0,0,13
elibom_jogger.com.elibom.jogger.asset.FileAssetLoader,0,0,0,0,0,0,0,0,0
elibom_jogger.com.elibom.jogger.test.JoggerTest,1,0,0,1,0,0,0,0,2
elibom_jogger.com.elibom.jogger.test.MockRequest,1,0,0,0,0,0,0,0,1
elibom_jogger.com.elibom.jogger.middleware.router.RouterMiddleware,8,0,0,8,0,0,0,0,16
elibom_jogger.com.elibom.jogger.middleware.statik.StaticMiddleware,0,0,0,0,0,0,0,6,6
elibom_jogger.com.elibom.jogger.template.JadeTemplateEngine,0,0,0,0,0,0,0,0,0
elibom_jogger.com.elibom.jogger.template.FreemarkerTemplateEngine,0,0,0,0,0,0,0,0,0
elibom_jogger.com.elibom.jogger.middleware.router.loader.AbstractFileRoutesLoader,2,0,0,2,0,0,0,0,4
elibom_jogger.com.elibom.jogger.exception.WebApplicationException,12,0,0,12,0,12,0,0,36
fizzed_java-stork.com.fizzed.stork.test.LaunchData,14,3,0,14,0,0,0,0,31
fizzed_java-stork.com.fizzed.stork.deploy.DeployOptions,2,0,0,2,0,0,0,0,4
fizzed_java-stork.com.fizzed.stork.deploy.Targets,3,0,0,1,0,2,0,0,6
fizzed_java-stork.com.fizzed.stork.deploy.Assemblys,2,0,0,2,0,1,0,0,5
extjwnl_extjwnl.net.sf.extjwnl.data.Pointer,3,0,0,1,0,0,0,0,4
extjwnl_extjwnl.net.sf.extjwnl.data.Synset,42,0,0,27,0,1,0,0,70
extjwnl_extjwnl.net.sf.extjwnl.data.IndexWord,12,0,0,1,0,0,0,0,13
extjwnl_extjwnl.net.sf.extjwnl.data.Word,1,0,0,1,0,0,0,0,2
extjwnl_extjwnl.net.sf.extjwnl.data.LexFileNameFileIdMap,1,0,0,1,0,0,0,0,2
extjwnl_extjwnl.net.sf.extjwnl.data.Verb,1,0,0,0,0,0,0,0,1
extjwnl_extjwnl.net.sf.extjwnl.dictionary.Dictionary,49,0,0,46,0,0,0,9,104
extjwnl_extjwnl.net.sf.extjwnl.data.IndexWordSet,4,0,0,3,0,0,0,0,7
extjwnl_extjwnl.net.sf.extjwnl.data.VerbSynset,1,0,0,1,0,0,0,0,2
extjwnl_extjwnl.net.sf.extjwnl.data.AdjectiveSynset,0,0,0,0,0,0,0,0,0
extjwnl_extjwnl.net.sf.extjwnl.data.Exc,3,0,0,2,0,0,0,0,5
extjwnl_extjwnl.net.sf.extjwnl.data.BaseDictionaryElement,1,0,0,1,0,0,0,0,2
extjwnl_extjwnl.net.sf.extjwnl.data.list.PointerTargetNode,1,0,0,1,0,0,0,0,2
extjwnl_extjwnl.net.sf.extjwnl.data.list.PointerTargetTree,3,0,0,0,0,0,0,0,3
extjwnl_extjwnl.net.sf.extjwnl.data.relationship.Relationship,2,0,0,2,0,0,0,0,4
extjwnl_extjwnl.net.sf.extjwnl.data.relationship.SymmetricRelationship,1,0,0,1,0,0,0,0,2
extjwnl_extjwnl.net.sf.extjwnl.data.relationship.RelationshipList,3,0,0,3,0,0,0,0,6
extjwnl_extjwnl.net.sf.extjwnl.data.relationship.RelationshipFinder,6,0,0,6,0,0,0,0,12
extjwnl_extjwnl.net.sf.extjwnl.data.relationship.AsymmetricRelationship,1,0,0,1,0,0,0,0,2
extjwnl_extjwnl.net.sf.extjwnl.util.PointedCharSequence,0,0,0,0,0,0,0,0,0
extjwnl_extjwnl.net.sf.extjwnl.dictionary.MorphologicalProcessor,4,0,0,4,0,0,0,0,8
extjwnl_extjwnl.net.sf.extjwnl.princeton.file.PrincetonRandomAccessDictionaryFile,8,0,0,5,0,0,0,0,13
extjwnl_extjwnl.net.sf.extjwnl.princeton.file.PrincetonResourceDictionaryFile,8,0,0,5,0,0,0,0,13
xpqiu_fnlp.org.fnlp.demo.nlp.ChineseWordSegmentation,0,0,0,0,0,0,0,1,1
xpqiu_fnlp.org.fnlp.demo.ml.SequenceLabeling,0,0,0,0,0,0,0,1,1
xpqiu_fnlp.org.fnlp.nlp.corpus.StopWords,1,0,0,1,0,0,0,0,2
xpqiu_fnlp.org.fnlp.nlp.corpus.fnlp.FNLPCorpus,0,0,0,0,0,0,0,1,1
xpqiu_fnlp.org.fnlp.nlp.pipe.seq.String2Sequence,0,0,0,0,0,0,0,1,1
xpqiu_fnlp.org.fnlp.nlp.cn.Chars,0,0,0,0,0,0,0,3,3
xpqiu_fnlp.org.fnlp.nlp.cn.Sentenizer,0,0,0,0,0,0,0,1,1
xpqiu_fnlp.org.fnlp.nlp.cn.ChineseTrans,0,0,0,0,0,0,0,5,5
xpqiu_fnlp.org.fnlp.nlp.cn.tag.CWSTagger,1,0,0,1,0,0,0,0,2
xpqiu_fnlp.org.fnlp.nlp.cn.tag.POSTagger,0,0,0,0,0,0,0,1,1
xpqiu_fnlp.org.fnlp.nlp.tag.Tagger,0,0,0,0,0,0,0,1,1
xpqiu_fnlp.org.fnlp.nlp.similarity.train.WordCluster,0,0,0,0,0,0,0,1,1
xpqiu_fnlp.org.fnlp.util.MyHashSparseArrays,0,0,0,0,0,0,0,1,1
xpqiu_fnlp.org.fnlp.util.MyArrays,0,0,0,0,0,0,0,2,2
xpqiu_fnlp.org.fnlp.ml.types.sv.HashSparseVector,0,0,0,0,0,0,0,2,2
xpqiu_fnlp.org.fnlp.ml.types.alphabet.LabelAlphabetEnum,0,0,0,0,0,0,0,1,1
vert-x3_service-proxy.io.vertx.serviceproxy.impl.utils.InterceptorUtils,0,0,0,0,0,0,0,2,2
vert-x3_service-proxy.io.vertx.serviceproxy.AuthorizationInterceptor,1,0,0,1,0,0,0,0,2
vert-x3_service-proxy.io.vertx.serviceproxy.generator.model.ProxyMethodInfo,1,1,0,1,0,0,0,0,3
vert-x3_service-proxy.io.vertx.serviceproxy.ServiceBinder,0,0,0,0,0,0,0,2,2
vert-x3_service-proxy.io.vertx.serviceproxy.ServiceProxyBuilder,0,0,0,0,0,0,0,2,2
gwtbootstrap3_gwtbootstrap3.org.gwtbootstrap3.client.ui.base.helper.StyleHelper,1,0,0,0,0,0,0,0,1
WASdev_standards.jsr352.jbatch.com.ibm.jbatch.container.servicesmanager.ServicesManagerImpl,1,0,0,1,0,0,0,0,2
WASdev_standards.jsr352.jbatch.com.ibm.jbatch.spi.BatchSPIManager,2,0,0,1,0,0,1,0,4
WASdev_standards.jsr352.jbatch.com.ibm.jbatch.jsl.model.JSLJob,1,0,0,1,0,0,0,0,2
WASdev_standards.jsr352.jbatch.com.ibm.jbatch.jsl.util.ValidatorHelper,1,0,0,1,0,0,0,0,2
WASdev_standards.jsr352.jbatch.com.ibm.jbatch.container.servicesmanager.ServiceTypes,1,0,0,1,0,0,0,0,2
WASdev_standards.jsr352.jbatch.com.ibm.jbatch.container.jobinstance.StepExecutionImpl,0,0,0,0,0,0,0,1,1
WASdev_standards.jsr352.jbatch.com.ibm.jbatch.container.servicesmanager.ServicesManager,0,0,0,0,0,0,1,1,2
Kixeye_kixmpp.com.kixeye.kixmpp.jdom.StAXElementBuilder,1,0,0,1,0,0,0,0,2
Kixeye_kixmpp.com.kixeye.kixmpp.server.module.muc.MucRoom,6,0,0,6,0,0,0,0,12
Kixeye_kixmpp.com.kixeye.kixmpp.server.KixmppServer,6,1,0,6,0,0,0,1,14
Kixeye_kixmpp.com.kixeye.kixmpp.client.KixmppClient,1,0,0,1,0,0,0,0,2
Kixeye_kixmpp.com.kixeye.kixmpp.p2p.discovery.ConstNodeDiscovery,1,0,0,0,0,0,0,0,1
Kixeye_kixmpp.com.kixeye.kixmpp.p2p.node.NodeId,4,0,0,0,0,0,0,0,4
Kixeye_kixmpp.com.kixeye.kixmpp.p2p.node.NodeServer,1,0,0,1,0,0,0,0,2
Kixeye_kixmpp.com.kixeye.kixmpp.p2p.ClusterClient,1,0,0,1,0,0,0,0,2
Kixeye_kixmpp.com.kixeye.kixmpp.p2p.message.MessageRegistry,1,0,0,1,0,0,0,0,2
Rayman2200_PDFA3.org.mustangproject.ZUGFeRD.LineCalculator,3,0,0,3,0,0,0,0,6
Rayman2200_PDFA3.org.mustangproject.Invoice,0,0,0,0,0,0,0,0,0
Wolfgang-Schuetzelhofer_jcypher.iot.jcypher.query.LiteralMap,2,0,0,2,0,0,0,0,4
Wolfgang-Schuetzelhofer_jcypher.iot.jcypher.database.DBAccessFactory,0,0,0,0,0,0,0,1,1
Wolfgang-Schuetzelhofer_jcypher.iot.jcypher.graph.Graph,0,0,0,0,0,0,0,1,1
Wolfgang-Schuetzelhofer_jcypher.iot.jcypher.database.IDBAccess,7,0,0,7,0,3,0,9,26
Wolfgang-Schuetzelhofer_jcypher.iot.jcypher.query.api.pattern.Relation,2,0,0,2,0,0,0,1,5
Wolfgang-Schuetzelhofer_jcypher.iot.jcypher.query.factories.clause.MATCH,1,0,0,1,0,0,0,3,5
Wolfgang-Schuetzelhofer_jcypher.iot.jcypher.query.api.pattern.Element,3,1,0,3,0,0,0,1,8
Wolfgang-Schuetzelhofer_jcypher.iot.jcypher.query.api.pattern.Node,2,0,0,2,0,1,0,5,10
Wolfgang-Schuetzelhofer_jcypher.iot.jcypher.query.JcQuery,3,0,0,3,0,0,0,1,7
Wolfgang-Schuetzelhofer_jcypher.iot.jcypher.query.api.start.SPropertyValue,1,0,0,1,0,0,0,0,2
Wolfgang-Schuetzelhofer_jcypher.iot.jcypher.query.api.predicate.Concatenator,1,0,0,1,0,0,0,0,2
Wolfgang-Schuetzelhofer_jcypher.iot.jcypher.query.factories.clause.WHERE,1,0,0,1,0,0,0,0,2
Wolfgang-Schuetzelhofer_jcypher.iot.jcypher.query.factories.clause.RETURN,2,0,0,2,0,0,0,0,4
Wolfgang-Schuetzelhofer_jcypher.iot.jcypher.query.factories.clause.WITH,1,0,0,1,0,0,0,0,2
Wolfgang-Schuetzelhofer_jcypher.iot.jcypher.query.api.collection.Do,1,0,0,1,0,0,0,0,2
Wolfgang-Schuetzelhofer_jcypher.iot.jcypher.query.factories.clause.CREATE,1,0,0,1,0,0,0,0,2
Wolfgang-Schuetzelhofer_jcypher.iot.jcypher.query.api.using.UsingIndex,1,0,0,1,0,0,0,0,2
Wolfgang-Schuetzelhofer_jcypher.iot.jcypher.query.factories.clause.DO,3,0,0,3,0,0,0,0,6
Wolfgang-Schuetzelhofer_jcypher.iot.jcypher.query.api.index.IndexFor,1,0,0,1,0,0,0,0,2
Wolfgang-Schuetzelhofer_jcypher.iot.jcypher.query.factories.clause.UNION,1,0,0,1,0,0,0,0,2
Wolfgang-Schuetzelhofer_jcypher.iot.jcypher.query.values.JcNumber,2,0,0,2,0,0,0,0,4
Wolfgang-Schuetzelhofer_jcypher.iot.jcypher.query.values.JcCollection,2,0,0,2,0,0,0,0,4
Wolfgang-Schuetzelhofer_jcypher.iot.jcypher.query.values.JcElement,1,0,0,1,0,0,0,0,2
Wolfgang-Schuetzelhofer_jcypher.iot.jcypher.query.values.JcRelation,2,0,0,2,0,0,0,0,4
Wolfgang-Schuetzelhofer_jcypher.iot.jcypher.query.values.JcPath,1,0,0,1,0,0,0,0,2
Wolfgang-Schuetzelhofer_jcypher.iot.jcypher.query.values.MathFunctions,1,0,0,1,0,0,0,0,2
Wolfgang-Schuetzelhofer_jcypher.iot.jcypher.domain.DomainAccessFactory,57,0,0,57,0,25,0,3,142
Wolfgang-Schuetzelhofer_jcypher.iot.jcypher.domain.DomainInformation,0,0,0,0,0,0,0,0,0
Wolfgang-Schuetzelhofer_jcypher.iot.jcypher.graph.GrRelation,1,0,0,1,0,0,0,0,2
Wolfgang-Schuetzelhofer_jcypher.iot.jcypher.domainquery.QueryPersistor,1,0,0,1,0,0,0,0,2
Wolfgang-Schuetzelhofer_jcypher.iot.jcypher.domainquery.internal.QueryRecorder,14,0,0,14,0,0,0,0,28
Wolfgang-Schuetzelhofer_jcypher.iot.jcypher.facade.JSONDBFacade,0,0,0,0,0,0,0,0,0
Wolfgang-Schuetzelhofer_jcypher.iot.jcypher.domain.IDomainAccess,27,13,0,27,0,0,0,0,67
Wolfgang-Schuetzelhofer_jcypher.iot.jcypher.domain.IGenericDomainAccess,2,0,0,2,0,0,0,0,4
pcingola_SnpEff.org.snpeff.util.Log,120,36,0,119,0,28,0,347,650
pcingola_SnpEff.org.snpeff.snpEffect.testCases.integration.TestCasesIntegrationBase,0,0,0,0,0,1,0,0,1
pcingola_SnpEff.org.snpeff.align.StringDiff,5,0,0,5,0,0,0,0,10
pcingola_SnpEff.org.snpeff.snpEffect.testCases.unity.TestCasesBase,0,0,0,0,0,1,0,2,3
pcingola_SnpEff.org.snpeff.vcf.VcfEntry,1,0,0,0,0,0,0,0,1
nicklondhe_newsindexer.edu.buffalo.cse.irf14.analysis.Tokenizer,5,0,0,0,0,5,0,0,10
nicklondhe_newsindexer.edu.buffalo.cse.irf14.analysis.test.TFRuleBaseTest,10,0,0,0,0,8,0,0,18
nicklondhe_newsindexer.edu.buffalo.cse.irf14.analysis.TokenStream,6,1,0,6,0,0,0,0,13
nicklondhe_newsindexer.edu.buffalo.cse.irf14.analysis.Token,4,1,0,4,0,0,0,0,9
nicklondhe_newsindexer.edu.buffalo.cse.irf14.document.Parser,3,0,0,0,0,4,0,0,7
nicklondhe_newsindexer.edu.buffalo.cse.irf14.index.IndexReader,2,0,0,0,0,0,0,0,2
meyerjp3_psychometrics.com.itemanalysis.psychometrics.kernel.ScottsBandwidth,0,0,0,0,0,0,0,0,0
meyerjp3_psychometrics.com.itemanalysis.psychometrics.kernel.SimplePluginBandwidth,0,0,0,0,0,0,0,0,0
meyerjp3_psychometrics.com.itemanalysis.psychometrics.kernel.KernelDensity,0,0,0,0,0,0,0,0,0
meyerjp3_psychometrics.com.itemanalysis.psychometrics.kernel.UserSuppliedBandwidth,0,0,0,0,0,0,0,0,0
meyerjp3_psychometrics.com.itemanalysis.psychometrics.kernel.LeastSquaresCrossValidation,0,0,0,0,0,0,0,2,2
meyerjp3_psychometrics.com.itemanalysis.psychometrics.kernel.LikelihoodCrossValidation,0,0,0,0,0,0,0,1,1
meyerjp3_psychometrics.com.itemanalysis.psychometrics.analysis.AbstractMultivariateFunction,2,0,0,0,0,0,0,0,2
meyerjp3_psychometrics.com.itemanalysis.psychometrics.polycor.PolychoricMaximumLikelihood,1,0,0,1,0,0,0,0,2
meyerjp3_psychometrics.com.itemanalysis.psychometrics.polycor.PolychoricTwoStep,0,0,0,0,0,0,0,0,0
meyerjp3_psychometrics.com.itemanalysis.psychometrics.polycor.AbstractPolychoricCorrelation,1,0,0,1,0,0,0,0,2
meyerjp3_psychometrics.com.itemanalysis.psychometrics.factoranalysis.GPArotation,1,0,0,1,0,0,0,0,2
meyerjp3_psychometrics.com.itemanalysis.psychometrics.factoranalysis.ExploratoryFactorAnalysis,7,0,0,7,0,0,0,5,19
meyerjp3_psychometrics.com.itemanalysis.psychometrics.quadrature.AbstractQuadratureRule,2,0,0,2,0,0,0,0,4
meyerjp3_psychometrics.com.itemanalysis.psychometrics.distribution.BivariateNormalDistribution,0,0,0,0,0,0,0,1,1
meyerjp3_psychometrics.com.itemanalysis.psychometrics.distribution.KernelDensity,0,0,0,0,0,0,0,0,0
meyerjp3_psychometrics.com.itemanalysis.psychometrics.distribution.MultivariateNormalDistribution,3,0,0,0,0,0,0,0,3
meyerjp3_psychometrics.com.itemanalysis.psychometrics.statistics.StreamingCovarianceMatrix,5,0,0,5,0,0,0,0,10
meyerjp3_psychometrics.com.itemanalysis.psychometrics.statistics.WeightedOnlineCorrelation,1,0,0,1,0,0,0,0,2
meyerjp3_psychometrics.com.itemanalysis.psychometrics.statistics.TwoWayTable,1,0,0,1,0,0,0,0,2
meyerjp3_psychometrics.com.itemanalysis.psychometrics.statistics.InclusiveInterval,2,0,0,0,0,0,0,0,2
meyerjp3_psychometrics.com.itemanalysis.psychometrics.histogram.Histogram,0,0,0,0,0,0,0,0,0
meyerjp3_psychometrics.com.itemanalysis.psychometrics.reliability.GuttmanLambda1,1,0,0,1,0,0,0,0,2
meyerjp3_psychometrics.com.itemanalysis.psychometrics.reliability.CoefficientAlpha,1,0,0,1,0,0,0,0,2
meyerjp3_psychometrics.com.itemanalysis.psychometrics.classicalitemanalysis.TextItemResponseSummary,3,0,0,3,0,0,0,0,6
meyerjp3_psychometrics.com.itemanalysis.psychometrics.classicalitemanalysis.NumericItemResponseSummary,3,0,0,3,0,0,0,0,6
meyerjp3_psychometrics.com.itemanalysis.psychometrics.classicalitemanalysis.ConditionalNumericItemResponseSummary,1,0,0,1,0,0,0,0,2
meyerjp3_psychometrics.com.itemanalysis.psychometrics.cmh.CmhTable,1,0,0,1,0,0,0,0,2
meyerjp3_psychometrics.com.itemanalysis.psychometrics.cmh.CochranMantelHaenszel,1,0,0,1,0,0,0,0,2
meyerjp3_psychometrics.com.itemanalysis.psychometrics.scaling.RawScore,0,0,0,0,0,0,0,0,0
meyerjp3_psychometrics.com.itemanalysis.psychometrics.irt.model.IrmPCM,4,0,0,1,0,0,0,0,5
meyerjp3_psychometrics.com.itemanalysis.psychometrics.irt.model.IrmBinaryModel,0,0,0,0,0,0,0,1,1
meyerjp3_psychometrics.com.itemanalysis.psychometrics.irt.model.Irm3PL,6,0,0,3,0,0,0,0,9
meyerjp3_psychometrics.com.itemanalysis.psychometrics.irt.model.IrmGPCM,9,0,0,3,0,0,0,1,13
meyerjp3_psychometrics.com.itemanalysis.psychometrics.irt.model.IrmGPCM2,6,0,0,3,0,0,0,0,9
meyerjp3_psychometrics.com.itemanalysis.psychometrics.irt.model.Irm4PL,2,0,0,1,0,0,0,0,3
meyerjp3_psychometrics.com.itemanalysis.psychometrics.irt.model.IrmGRM,4,0,0,0,0,0,0,0,4
meyerjp3_psychometrics.com.itemanalysis.psychometrics.irt.equating.StockingLordMethod,12,0,0,12,0,0,0,0,24
meyerjp3_psychometrics.com.itemanalysis.psychometrics.irt.equating.IrtTrueScoreEquating,4,0,0,4,0,0,0,0,8
meyerjp3_psychometrics.com.itemanalysis.psychometrics.irt.equating.IrtObservedScoreEquating,0,0,0,0,0,0,0,0,0
meyerjp3_psychometrics.com.itemanalysis.psychometrics.irt.equating.HaebaraMethod,10,0,0,10,0,0,0,1,21
meyerjp3_psychometrics.com.itemanalysis.psychometrics.irt.equating.IrtScaleLinking,6,0,0,6,0,0,0,0,12
meyerjp3_psychometrics.com.itemanalysis.psychometrics.irt.equating.MeanSigmaMethod,4,0,0,4,0,0,0,0,8
meyerjp3_psychometrics.com.itemanalysis.psychometrics.irt.model.ItemResponseModel,3,0,0,3,0,0,0,0,6
meyerjp3_psychometrics.com.itemanalysis.psychometrics.irt.equating.MeanMeanMethod,3,0,0,3,0,0,0,0,6
meyerjp3_psychometrics.com.itemanalysis.psychometrics.irt.estimation.ItemResponseFileSummary,2,0,0,2,0,0,0,0,4
meyerjp3_psychometrics.com.itemanalysis.psychometrics.irt.estimation.MarginalMaximumLikelihoodEstimation,10,0,0,10,0,0,0,2,22
meyerjp3_psychometrics.com.itemanalysis.psychometrics.irt.estimation.IrtExaminee,0,0,0,0,0,0,0,3,3
meyerjp3_psychometrics.com.itemanalysis.psychometrics.irt.estimation.ItemFitG2,0,0,0,0,0,0,0,1,1
meyerjp3_psychometrics.com.itemanalysis.psychometrics.irt.estimation.ItemFitSX2,2,0,0,2,0,0,0,1,5
meyerjp3_psychometrics.com.itemanalysis.psychometrics.irt.simulation.ItemResponseSimulator,0,0,0,0,0,0,0,2,2
meyerjp3_psychometrics.com.itemanalysis.psychometrics.irt.estimation.ItemResponseVector,1,0,0,1,0,0,0,0,2
meyerjp3_psychometrics.com.itemanalysis.psychometrics.irt.estimation.JointMaximumLikelihoodEstimation,12,1,0,12,0,0,0,1,26
meyerjp3_psychometrics.com.itemanalysis.psychometrics.irt.estimation.ItemParamPrior,0,0,0,0,0,0,0,1,1
meyerjp3_psychometrics.com.itemanalysis.psychometrics.irt.estimation.RaschFitStatistics,0,0,0,0,0,0,0,0,0
meyerjp3_psychometrics.com.itemanalysis.psychometrics.irt.estimation.IrtObservedScoreDistribution,2,0,0,2,0,0,0,4,8
meyerjp3_psychometrics.com.itemanalysis.psychometrics.WrightMap,0,0,0,0,0,0,0,1,1
levigo_jbig2-imageio.org.apache.pdfbox.jbig2.JBIG2Document,0,0,0,0,0,0,0,0,0
levigo_jbig2-imageio.org.apache.pdfbox.jbig2.JBIG2ImageReader,0,0,0,0,0,0,0,0,0
levigo_jbig2-imageio.org.apache.pdfbox.jbig2.io.DefaultInputStreamFactory,0,0,0,0,0,0,2,2,4
levigo_jbig2-imageio.org.apache.pdfbox.jbig2.JBIG2Page,0,0,0,0,0,0,3,3,6
levigo_jbig2-imageio.org.apache.pdfbox.jbig2.Bitmap,3,0,0,3,0,0,0,0,6
levigo_jbig2-imageio.org.apache.pdfbox.jbig2.util.cache.CacheFactory,0,0,0,0,0,0,0,0,0
levigo_jbig2-imageio.org.apache.pdfbox.jbig2.util.log.LoggerFactory,0,0,0,0,0,0,0,0,0
levigo_jbig2-imageio.org.apache.pdfbox.jbig2.segments.PageInformation,2,0,0,2,0,0,2,0,6
levigo_jbig2-imageio.org.apache.pdfbox.jbig2.segments.GenericRegion,1,0,0,1,0,0,3,3,8
levigo_jbig2-imageio.org.apache.pdfbox.jbig2.segments.RegionSegmentInformation,1,0,0,1,0,0,0,0,2
levigo_jbig2-imageio.org.apache.pdfbox.jbig2.segments.PatternDictionary,1,0,0,1,0,0,2,2,6
levigo_jbig2-imageio.org.apache.pdfbox.jbig2.segments.HalftoneRegion,1,0,0,1,0,0,0,0,2
levigo_jbig2-imageio.org.apache.pdfbox.jbig2.decoder.arithmetic.ArithmeticIntegerDecoder,0,0,0,0,0,0,0,0,0
levigo_jbig2-imageio.org.apache.pdfbox.jbig2.decoder.arithmetic.ArithmeticDecoder,1,0,0,1,0,0,0,1,3
levigo_jbig2-imageio.org.apache.pdfbox.jbig2.decoder.mmr.MMRDecompressor,0,0,0,0,0,0,0,0,0
levigo_jbig2-imageio.org.apache.pdfbox.jbig2.io.InputStreamFactory,0,0,0,0,0,0,0,0,0
levigo_jbig2-imageio.org.apache.pdfbox.jbig2.image.Bitmaps,0,0,0,0,0,0,0,0,0
reines_dropwizard-debpkg-maven-plugin.com.jamierf.dropwizard.debpkg.config.DebConfiguration,2,0,0,2,0,0,0,0,4
reines_dropwizard-debpkg-maven-plugin.com.jamierf.dropwizard.debpkg.config.JvmConfiguration,2,0,0,2,0,0,0,0,4
reines_dropwizard-debpkg-maven-plugin.com.jamierf.dropwizard.debpkg.config.UnixConfiguration,2,0,0,2,0,0,0,0,4
reines_dropwizard-debpkg-maven-plugin.com.jamierf.dropwizard.debpkg.config.PathConfiguration,2,0,0,2,0,0,0,0,4
reines_dropwizard-debpkg-maven-plugin.com.jamierf.dropwizard.debpkg.DropwizardMojo,2,0,0,1,0,0,0,0,3
reines_dropwizard-debpkg-maven-plugin.com.jamierf.dropwizard.debpkg.config.PgpConfiguration,1,0,0,1,0,0,0,0,2
reines_dropwizard-debpkg-maven-plugin.com.jamierf.dropwizard.debpkg.config.ResourceConfiguration,1,0,0,1,0,0,0,0,2
reines_dropwizard-debpkg-maven-plugin.com.jamierf.dropwizard.debpkg.resource.Resource,0,0,0,0,0,0,0,0,0
reines_dropwizard-debpkg-maven-plugin.com.jamierf.dropwizard.debpkg.filter.DependencyFilter,1,0,0,0,0,0,0,0,1
reines_dropwizard-debpkg-maven-plugin.com.jamierf.dropwizard.debpkg.validation.ApplicationValidator,0,0,0,0,0,0,0,1,1
reines_dropwizard-debpkg-maven-plugin.com.jamierf.dropwizard.debpkg.template.Templater,0,0,0,0,0,0,0,0,0
reines_dropwizard-debpkg-maven-plugin.com.jamierf.dropwizard.debpkg.transforms.ResourceProducer,6,0,0,6,0,0,0,0,12
HdrHistogram_HdrHistogram.org.HdrHistogram.Histogram,3,1,0,1,0,1,0,0,6
HdrHistogram_HdrHistogram.org.HdrHistogram.HistogramIterationValue,5,4,0,5,0,0,0,0,14
HdrHistogram_HdrHistogram.org.HdrHistogram.HistogramLogWriter,2,0,0,2,0,0,0,0,4
HdrHistogram_HdrHistogram.org.HdrHistogram.HistogramLogReader,5,0,0,5,0,0,0,0,10
HdrHistogram_HdrHistogram.org.HdrHistogram.SynchronizedDoubleHistogram,0,0,0,0,0,0,0,1,1
HdrHistogram_HdrHistogram.org.HdrHistogram.ConcurrentHistogram,0,0,0,0,0,0,0,0,0
HdrHistogram_HdrHistogram.org.HdrHistogram.DoubleHistogram,12,4,0,6,0,0,0,0,22
netizen539_civcraft.com.avrgaming.civcraft.util.MultiInventory,1,0,0,1,0,0,0,0,2
wso2_siddhi.io.siddhi.query.api.execution.query.Query,24,0,0,24,0,0,0,60,108
wso2_siddhi.io.siddhi.query.api.definition.AggregationDefinition,1,0,0,1,0,0,0,3,5
wso2_siddhi.io.siddhi.query.api.SiddhiApp,2,0,0,2,0,0,0,11,15
wso2_siddhi.io.siddhi.query.api.definition.Attribute,0,0,0,0,0,0,0,0,0
wso2_siddhi.io.siddhi.query.api.expression.math.Mod,1,0,0,1,0,0,0,0,2
wso2_siddhi.io.siddhi.query.api.expression.condition.Or,1,0,0,1,0,0,0,0,2
wso2_siddhi.io.siddhi.query.api.expression.Expression,1,0,0,1,0,0,0,1,3
wso2_siddhi.io.siddhi.query.api.execution.query.selection.Selector,1,0,0,1,0,0,0,0,2
wso2_siddhi.io.siddhi.query.api.execution.partition.Partition,1,0,0,1,0,0,0,1,3
wso2_siddhi.io.siddhi.query.api.execution.query.StoreQuery,2,0,0,2,0,0,0,5,9
wso2_siddhi.io.siddhi.query.api.execution.query.OnDemandQuery,2,0,0,2,0,0,0,2,6
wso2_siddhi.io.siddhi.query.api.definition.StreamDefinition,23,3,0,19,0,0,0,34,79
wso2_siddhi.io.siddhi.query.api.definition.AbstractDefinition,1,1,0,0,0,0,0,0,2
wso2_siddhi.io.siddhi.query.api.annotation.Annotation,1,0,0,1,0,0,0,0,2
wso2_siddhi.io.siddhi.query.api.util.ExceptionUtil,0,0,0,0,0,0,0,0,0
wso2_siddhi.io.siddhi.query.api.definition.TableDefinition,0,0,0,0,0,0,0,3,3
wso2_siddhi.io.siddhi.query.api.definition.TriggerDefinition,0,0,0,0,0,0,0,2,2
wso2_siddhi.io.siddhi.query.api.definition.FunctionDefinition,1,0,0,1,0,0,0,0,2
subchen_jetbrick-template-1x.jetbrick.template.JetEngine,0,0,0,0,0,2,0,2,4
subchen_jetbrick-template-1x.jetbrick.template.JetConfig,1,0,0,1,0,0,0,0,2
subchen_jetbrick-template-1x.jetbrick.template.JetContext,0,0,0,0,0,0,0,0,0
subchen_jetbrick-template-1x.jetbrick.template.utils.NumberUtils,5,0,0,1,0,0,0,0,6
subchen_jetbrick-template-1x.jetbrick.template.utils.PathUtils,2,1,0,0,0,0,0,0,3
subchen_jetbrick-template-1x.jetbrick.template.utils.finder.AnnotationClassReader,0,0,0,0,0,0,0,0,0
subchen_jetbrick-template-1x.jetbrick.template.runtime.JetUtils,2,0,0,0,0,0,0,0,2
igniterealtime_Spark.org.jivesoftware.spark.util.Encryptor,0,0,0,0,0,1,0,0,1
igniterealtime_Spark.org.jivesoftware.spark.util.StringUtils,0,0,0,0,0,0,0,0,0
igniterealtime_Spark.org.jivesoftware.spark.plugin.PluginDependency,1,0,0,1,0,0,0,0,2
HadoopGenomics_Hadoop-BAM.org.seqdoop.hadoop_bam.SAMRecordWritable,0,0,0,0,0,0,0,0,0
HadoopGenomics_Hadoop-BAM.org.seqdoop.hadoop_bam.util.SAMFileMerger,1,0,0,0,0,0,0,0,1
HadoopGenomics_Hadoop-BAM.org.seqdoop.hadoop_bam.BAMInputFormat,8,0,0,3,0,0,0,0,11
HadoopGenomics_Hadoop-BAM.org.seqdoop.hadoop_bam.AnySAMInputFormat,2,0,0,2,0,0,0,0,4
HadoopGenomics_Hadoop-BAM.org.seqdoop.hadoop_bam.LineReader,3,0,0,2,0,0,0,0,5
HadoopGenomics_Hadoop-BAM.org.seqdoop.hadoop_bam.util.VCFHeaderReader,2,1,0,1,0,0,0,0,4
HadoopGenomics_Hadoop-BAM.org.seqdoop.hadoop_bam.SequencedFragment,40,0,0,29,0,0,0,0,69
HadoopGenomics_Hadoop-BAM.org.seqdoop.hadoop_bam.VariantContextWritable,3,0,0,1,0,1,0,0,5
HadoopGenomics_Hadoop-BAM.org.seqdoop.hadoop_bam.SplittingBAMIndex,1,0,0,0,0,0,0,0,1
HadoopGenomics_Hadoop-BAM.org.seqdoop.hadoop_bam.util.IntervalUtil,1,0,0,0,0,0,0,0,1
HadoopGenomics_Hadoop-BAM.org.seqdoop.hadoop_bam.util.WrapSeekable,0,0,0,0,0,0,0,0,0
HadoopGenomics_Hadoop-BAM.org.seqdoop.hadoop_bam.FastaInputFormat,1,0,0,1,0,0,0,0,2
HadoopGenomics_Hadoop-BAM.org.seqdoop.hadoop_bam.util.ConfHelper,3,0,0,0,0,0,0,0,3
HadoopGenomics_Hadoop-BAM.org.seqdoop.hadoop_bam.util.BGZFSplitGuesser,1,0,0,0,0,0,0,0,1
HadoopGenomics_Hadoop-BAM.org.seqdoop.hadoop_bam.CRAMInputFormat,1,0,0,1,0,0,0,0,2
dropwizard_metrics.com.codahale.metrics.collectd.CollectdReporter,4,0,0,3,0,0,0,0,7
dropwizard_metrics.com.codahale.metrics.MetricRegistry,82,0,0,74,0,8,0,2,166
dropwizard_metrics.com.codahale.metrics.collectd.Sanitize,0,0,0,0,0,0,0,0,0
dropwizard_metrics.io.dropwizard.metrics.jetty10.InstrumentedQueuedThreadPool,1,0,0,1,0,0,0,0,2
dropwizard_metrics.io.dropwizard.metrics.jetty10.InstrumentedHandler,0,0,0,0,0,0,0,0,0
dropwizard_metrics.com.codahale.metrics.Gauge,5,0,0,1,0,0,0,0,6
dropwizard_metrics.com.codahale.metrics.servlet.InstrumentedFilterContextListener,0,0,0,0,0,0,0,1,1
dropwizard_metrics.com.codahale.metrics.jdbi.InstrumentedTimingCollector,11,0,0,11,0,0,0,0,22
dropwizard_metrics.com.codahale.metrics.jdbi3.strategies.DelegatingStatementNameStrategy,0,0,0,0,0,0,0,0,0
dropwizard_metrics.com.codahale.metrics.jdbi3.strategies.TimedAnnotationNameStrategy,0,0,0,0,0,0,0,0,0
dropwizard_metrics.com.codahale.metrics.jdbi3.InstrumentedTimingCollector,4,0,0,4,0,0,0,0,8
dropwizard_metrics.com.codahale.metrics.jdbi3.InstrumentedSqlLogger,0,0,0,0,0,0,0,2,2
dropwizard_metrics.com.codahale.metrics.httpclient.HttpClientMetricNameStrategy,0,0,0,0,0,1,0,2,3
dropwizard_metrics.com.codahale.metrics.health.HealthCheckRegistry,12,0,0,1,0,1,0,4,18
dropwizard_metrics.com.codahale.metrics.servlets.HealthCheckServlet,0,0,0,0,0,0,0,2,2
dropwizard_metrics.com.codahale.metrics.servlets.MetricsServlet,0,0,0,0,0,0,0,2,2
dropwizard_metrics.io.dropwizard.metrics.servlet.InstrumentedFilterContextListener,0,0,0,0,0,0,0,1,1
dropwizard_metrics.com.codahale.metrics.EWMA,3,0,0,3,0,0,0,0,6
dropwizard_metrics.com.codahale.metrics.SlidingTimeWindowReservoir,1,1,0,1,0,0,0,0,3
dropwizard_metrics.com.codahale.metrics.InstrumentedExecutorService,3,0,0,3,0,0,0,0,6
dropwizard_metrics.com.codahale.metrics.Meter,18,0,0,18,0,0,0,0,36
dropwizard_metrics.com.codahale.metrics.Counter,2,0,0,2,0,0,0,0,4
dropwizard_metrics.com.codahale.metrics.ScheduledReporter,2,0,0,1,0,1,0,8,12
dropwizard_metrics.com.codahale.metrics.Reservoir,8,0,0,8,0,0,0,0,16
dropwizard_metrics.com.codahale.metrics.Timer,7,0,0,4,0,0,0,0,11
dropwizard_metrics.com.codahale.metrics.Slf4jReporter,0,0,0,0,0,0,0,6,6
dropwizard_metrics.com.codahale.metrics.Histogram,2,0,0,2,0,0,0,1,5
dropwizard_metrics.com.codahale.metrics.Snapshot,1,0,0,0,0,0,0,0,1
dropwizard_metrics.com.codahale.metrics.WeightedSnapshot,0,0,0,0,0,0,0,0,0
dropwizard_metrics.com.codahale.metrics.SlidingWindowReservoir,0,0,0,0,0,0,0,0,0
dropwizard_metrics.com.codahale.metrics.UniformReservoir,1,0,0,1,0,0,0,0,2
dropwizard_metrics.com.codahale.metrics.InstrumentedScheduledExecutorService,3,0,0,3,0,0,0,0,6
dropwizard_metrics.com.codahale.metrics.NoopMetricRegistry,10,0,0,1,0,0,0,2,13
dropwizard_metrics.com.codahale.metrics.MetricRegistryListener,0,0,0,0,0,1,0,6,7
dropwizard_metrics.com.codahale.metrics.SlidingTimeWindowMovingAverages,2,0,0,0,0,0,0,0,2
dropwizard_metrics.com.codahale.metrics.RatioGauge,0,0,0,0,0,0,0,0,0
dropwizard_metrics.com.codahale.metrics.ConsoleReporter,0,0,0,0,0,0,0,0,0
dropwizard_metrics.com.codahale.metrics.FixedNameCsvFileProvider,2,0,0,0,0,0,0,0,2
dropwizard_metrics.com.codahale.metrics.SlidingTimeWindowArrayReservoir,2,2,0,2,0,0,0,0,6
dropwizard_metrics.com.codahale.metrics.DefaultSettableGauge,1,0,0,0,0,0,0,0,1
dropwizard_metrics.com.codahale.metrics.MetricFilter,3,0,0,3,0,0,0,0,6
dropwizard_metrics.com.codahale.metrics.CsvReporter,0,0,0,0,0,0,0,1,1
dropwizard_metrics.com.codahale.metrics.ChunkedAssociativeLongArray,0,0,0,0,0,0,0,1,1
dropwizard_metrics.com.codahale.metrics.Clock,2,0,0,0,0,0,0,0,2
dropwizard_metrics.com.codahale.metrics.SharedMetricRegistries,3,0,0,3,0,0,0,2,8
dropwizard_metrics.com.codahale.metrics.graphite.GraphiteUDP,1,0,0,1,0,0,0,1,3
dropwizard_metrics.com.codahale.metrics.graphite.PickledGraphite,1,0,0,0,0,1,0,1,3
dropwizard_metrics.com.codahale.metrics.graphite.GraphiteSanitize,1,0,0,0,0,0,0,0,1
dropwizard_metrics.com.codahale.metrics.graphite.GraphiteReporter,0,0,0,0,0,0,0,18,18
dropwizard_metrics.com.codahale.metrics.graphite.Graphite,0,0,0,0,0,0,0,3,3
dropwizard_metrics.com.codahale.metrics.graphite.GraphiteRabbitMQ,3,0,0,0,0,3,0,2,8
dropwizard_metrics.com.codahale.metrics.caffeine.MetricsStatsCounter,2,0,0,2,0,0,0,0,4
dropwizard_metrics.com.codahale.metrics.httpclient5.HttpClientMetricNameStrategy,0,0,0,0,0,1,0,1,2
dropwizard_metrics.com.codahale.metrics.httpclient5.InstrumentedHttpClientConnectionManager,1,0,0,1,0,0,0,0,2
dropwizard_metrics.com.codahale.metrics.httpclient5.InstrumentedAsyncClientConnectionManager,1,0,0,1,0,0,0,0,2
dropwizard_metrics.com.codahale.metrics.httpclient5.InstrumentedHttpAsyncClients,1,0,0,1,0,1,0,0,3
dropwizard_metrics.com.codahale.metrics.jetty9.InstrumentedQueuedThreadPool,1,0,0,1,0,0,0,0,2
dropwizard_metrics.com.codahale.metrics.jetty9.InstrumentedHandler,0,0,0,0,0,0,0,0,0
dropwizard_metrics.com.codahale.metrics.log4j2.InstrumentedAppender,6,0,0,6,0,0,0,0,12
dropwizard_metrics.com.codahale.metrics.jvm.ThreadDeadlockDetector,1,0,0,1,0,0,0,0,2
dropwizard_metrics.com.codahale.metrics.health.HealthCheck,1,0,0,0,0,0,0,0,1
dropwizard_metrics.com.codahale.metrics.health.AsyncHealthCheckDecorator,3,0,0,1,0,0,0,1,5
dropwizard_metrics.com.codahale.metrics.health.HealthCheckFilter,0,0,0,0,0,0,0,0,0
dropwizard_metrics.com.codahale.metrics.health.SharedHealthCheckRegistries,1,0,0,1,0,0,0,3,5
dropwizard_metrics.com.codahale.metrics.jvm.CpuTimeClock,1,0,0,1,0,0,0,0,2
dropwizard_metrics.com.codahale.metrics.jvm.ClassLoadingGaugeSet,0,0,0,0,0,0,0,0,0
dropwizard_metrics.com.codahale.metrics.jvm.JvmAttributeGaugeSet,0,0,0,0,0,0,0,0,0
dropwizard_metrics.com.codahale.metrics.jvm.MemoryUsageGaugeSet,0,0,0,0,0,0,0,0,0
dropwizard_metrics.com.codahale.metrics.jvm.ThreadDump,0,0,0,0,0,0,0,0,0
dropwizard_metrics.com.codahale.metrics.jvm.BufferPoolMetricSet,0,0,0,0,0,0,0,0,0
dropwizard_metrics.com.codahale.metrics.jvm.ThreadStatesGaugeSet,2,0,0,2,0,0,0,0,4
dropwizard_metrics.com.codahale.metrics.jvm.JmxAttributeGauge,2,0,0,0,0,0,0,0,2
dropwizard_metrics.com.codahale.metrics.jvm.GarbageCollectorMetricSet,0,0,0,0,0,0,0,0,0
dropwizard_metrics.io.dropwizard.metrics.jetty11.InstrumentedQueuedThreadPool,1,0,0,1,0,0,0,0,2
dropwizard_metrics.io.dropwizard.metrics.jetty11.InstrumentedHandler,0,0,0,0,0,0,0,0,0
dropwizard_metrics.com.codahale.metrics.logback.InstrumentedAppender,2,0,0,2,0,0,0,0,4
dropwizard_metrics.io.dropwizard.metrics.caffeine3.MetricsStatsCounter,0,0,0,0,0,0,0,0,0
dropwizard_metrics.com.codahale.metrics.jmx.DefaultObjectNameFactory,1,0,0,0,0,0,0,0,1
dropwizard_metrics.com.codahale.metrics.jmx.JmxReporter,0,0,0,0,0,0,0,3,3
dropwizard_metrics.io.dropwizard.metrics.servlets.HealthCheckServlet,0,0,0,0,0,0,0,2,2
dropwizard_metrics.io.dropwizard.metrics.servlets.MetricsServlet,0,0,0,0,0,0,0,2,2
dropwizard_metrics.com.codahale.metrics.httpclient.InstrumentedHttpClientConnectionManager,1,0,0,1,0,0,0,0,2
google_google-http-java-client.com.google.api.client.http.GzipSupport,1,0,0,0,0,0,0,0,1
google_google-http-java-client.com.google.api.client.http.javanet.NetHttpRequest,6,0,0,3,0,4,0,0,13
google_google-http-java-client.com.google.api.client.util.escape.PercentEscaper,0,0,0,0,0,0,0,0,0
google_google-http-java-client.com.google.api.client.testing.util.SecurityTestUtils,0,0,0,0,0,0,0,0,0
google_google-http-java-client.com.google.api.client.json.webtoken.JsonWebSignature,0,0,0,0,0,0,0,0,0
google_google-http-java-client.com.google.api.client.testing.http.MockLowLevelHttpResponse,1,0,0,1,0,0,0,0,2
google_google-http-java-client.com.google.api.client.xml.Xml,51,0,0,51,0,6,0,1,109
google_google-http-java-client.com.google.api.client.util.GenericData,0,0,0,0,0,0,0,0,0
google_google-http-java-client.com.google.api.client.http.apache.v2.ApacheHttpTransport,2,0,0,2,0,1,0,2,7
google_google-http-java-client.com.google.api.client.http.GenericUrl,2,0,0,2,0,1,0,0,5
google_google-http-java-client.com.google.api.client.http.apache.v2.ApacheHttpRequest,2,0,0,2,0,0,0,0,4
ks-no_eventstore2.no.ks.eventstore2.command.CommandDispatcher,0,0,0,0,0,0,0,2,2
ks-no_eventstore2.no.ks.eventstore2.saga.SqlSagaRepository,0,0,0,0,0,0,0,0,0
ks-no_eventstore2.no.ks.eventstore2.Event,1,0,0,1,0,0,0,0,2
ks-no_eventstore2.no.ks.eventstore2.eventstore.MongoDBJournalV2,12,0,0,8,0,0,0,16,36
SonarCommunity_sonar-csharp.org.sonarsource.dotnet.shared.plugins.CodeCoverageProvider,4,0,0,4,0,0,0,0,8
SonarCommunity_sonar-csharp.org.sonarsource.dotnet.shared.sarif.SarifParser01And04,0,0,0,0,0,0,0,6,6
SonarCommunity_sonar-csharp.org.sonarsource.dotnet.shared.plugins.SarifParserCallbackImpl,17,0,0,0,0,0,0,0,17
SonarCommunity_sonar-csharp.org.sonarsource.dotnet.shared.sarif.SarifParserFactory,0,0,0,0,0,0,0,3,3
SonarCommunity_sonar-csharp.org.sonarsource.dotnet.shared.sarif.SarifParser10,1,0,0,0,0,0,0,13,14
SonarCommunity_sonar-csharp.org.sonarsource.dotnet.shared.plugins.UnitTestResultsProvider,2,0,0,2,0,0,0,0,4
SonarCommunity_sonar-csharp.org.sonarsource.dotnet.shared.plugins.SensorContextUtils,0,0,0,0,0,0,0,0,0
SonarCommunity_sonar-csharp.org.sonarsource.dotnet.shared.plugins.DotNetSensor,12,0,0,3,0,0,0,0,15
SonarCommunity_sonar-csharp.org.sonarsource.dotnet.shared.plugins.RoslynDataImporter,4,0,0,0,0,0,0,1,5
SonarCommunity_sonar-csharp.org.sonarsource.dotnet.shared.plugins.RoslynProfileExporter,5,0,0,0,0,1,0,0,6
SonarCommunity_sonar-csharp.org.sonarsource.dotnet.shared.plugins.PropertiesSensor,0,0,0,0,0,0,0,3,3
SonarCommunity_sonar-csharp.org.sonarsource.dotnet.shared.plugins.AbstractGlobalProtobufFileProcessor,9,0,0,7,0,0,0,0,16
SonarCommunity_sonar-csharp.org.sonarsource.dotnet.shared.plugins.ProtobufDataImporter,1,0,0,0,0,0,0,0,1
SonarCommunity_sonar-csharp.org.sonarsource.dotnet.shared.plugins.GeneratedFileFilter,3,0,0,1,0,0,0,0,4
SonarCommunity_sonar-csharp.org.sonarsource.dotnet.shared.plugins.AnalysisWarningsSensor,1,0,0,0,0,0,0,2,3
SonarCommunity_sonar-csharp.org.sonarsource.dotnet.shared.plugins.RealPathProvider,5,0,0,0,0,0,0,0,5
SonarCommunity_sonar-csharp.org.sonarsource.dotnet.shared.plugins.LogSensor,1,0,0,0,0,0,0,0,1
SonarCommunity_sonar-csharp.org.sonarsource.dotnet.shared.plugins.ReportPathCollector,2,0,0,2,0,0,0,0,4
SonarCommunity_sonar-csharp.org.sonarsource.dotnet.shared.plugins.AbstractModuleConfiguration,8,0,0,2,0,0,0,0,10
SonarCommunity_sonar-csharp.org.sonar.plugins.dotnet.tests.CoverageReportImportSensor,6,0,0,5,0,0,0,2,13
SonarCommunity_sonar-csharp.org.sonarsource.dotnet.shared.plugins.AbstractSonarLintProfileExporter,0,0,0,0,0,0,0,1,1
SonarCommunity_sonar-csharp.org.sonarsource.dotnet.shared.plugins.WrongEncodingFileFilter,0,0,0,0,0,0,0,0,0
SonarCommunity_sonar-csharp.org.sonarsource.dotnet.shared.plugins.FileTypeSensor,5,0,0,1,0,0,0,0,6
SonarCommunity_sonar-csharp.org.sonarsource.dotnet.shared.plugins.ProjectTypeCollector,12,0,0,12,0,0,0,0,24
SonarCommunity_sonar-csharp.org.sonarsource.dotnet.shared.plugins.AbstractLanguageConfiguration,0,0,0,0,0,0,0,0,0
SonarCommunity_sonar-csharp.org.sonarsource.dotnet.shared.plugins.protobuf.SymbolRefsImporter,1,0,0,1,0,0,0,0,2
SonarCommunity_sonar-csharp.org.sonarsource.dotnet.shared.plugins.protobuf.RawProtobufImporter,1,0,0,0,0,0,0,1,2
SonarCommunity_sonar-csharp.org.sonarsource.dotnet.shared.plugins.protobuf.HighlightImporter,1,0,0,1,0,0,0,0,2
SonarCommunity_sonar-csharp.org.sonarsource.dotnet.shared.plugins.protobuf.FileMetadataImporter,1,0,0,1,0,0,0,0,2
SonarCommunity_sonar-csharp.org.sonarsource.dotnet.shared.plugins.protobuf.LogImporter,3,0,0,3,0,0,0,0,6
SonarCommunity_sonar-csharp.org.sonar.plugins.dotnet.tests.XmlParserHelper,2,0,0,1,0,0,0,2,5
SonarCommunity_sonar-csharp.org.sonar.plugins.dotnet.tests.OpenCoverReportParser,12,0,0,11,0,0,0,4,27
SonarCommunity_sonar-csharp.org.sonar.plugins.dotnet.tests.BranchPoint,0,0,0,0,0,0,0,0,0
SonarCommunity_sonar-csharp.org.sonar.plugins.dotnet.tests.PathSuffixPredicate,0,0,0,0,0,0,0,0,0
SonarCommunity_sonar-csharp.org.sonar.plugins.dotnet.tests.Coverage,3,0,0,3,0,0,0,0,6
SonarCommunity_sonar-csharp.org.sonar.plugins.dotnet.tests.UnitTestResultsImportSensor,1,0,0,1,0,0,0,0,2
SonarCommunity_sonar-csharp.org.sonar.plugins.dotnet.tests.NCover3ReportParser,3,0,0,2,0,0,0,4,9
SonarCommunity_sonar-csharp.org.sonar.plugins.dotnet.tests.NUnitTestResultsFileParser,4,0,0,4,0,0,0,2,10
SonarCommunity_sonar-csharp.org.sonar.plugins.dotnet.tests.CoverageCache,0,0,0,0,0,0,0,1,1
SonarCommunity_sonar-csharp.org.sonar.plugins.dotnet.tests.DotCoverReportParser,6,0,0,5,0,0,0,0,11
SonarCommunity_sonar-csharp.org.sonar.plugins.dotnet.tests.XUnitTestResultsFileParser,6,0,0,6,0,0,0,2,14
SonarCommunity_sonar-csharp.org.sonar.plugins.dotnet.tests.VisualStudioTestResultsFileParser,4,0,0,3,0,0,0,2,9
SonarCommunity_sonar-csharp.org.sonar.plugins.dotnet.tests.ScannerFileService,9,0,0,1,0,0,0,0,10
SonarCommunity_sonar-csharp.org.sonar.plugins.dotnet.tests.DotCoverReportsAggregator,1,0,0,0,0,0,0,4,5
SonarCommunity_sonar-csharp.org.sonar.plugins.dotnet.tests.CoverageAggregator,0,0,0,0,0,0,0,1,1
SonarCommunity_sonar-csharp.org.sonar.plugins.dotnet.tests.BranchCoverage,0,0,0,0,0,0,0,0,0
SonarCommunity_sonar-csharp.org.sonar.plugins.dotnet.tests.VisualStudioCoverageXmlReportParser,9,0,0,7,0,0,0,3,19
SonarCommunity_sonar-csharp.org.sonar.plugins.dotnet.tests.UnitTestResultsAggregator,1,0,0,0,0,0,0,0,1
SonarCommunity_sonar-csharp.org.sonar.plugins.dotnet.tests.WildcardPatternFileProvider,0,0,0,0,0,0,0,1,1
chenlb_mmseg4j-core.com.chenlb.mmseg4j.Dictionary,3,0,0,3,0,0,1,2,9
poetix_octarine.com.codepoetics.octarine.functional.paths.Path,1,0,0,0,0,0,0,0,1
poetix_octarine.com.codepoetics.octarine.functional.lenses.Lens,3,0,0,1,0,0,0,0,4
RNCryptor_JNCryptor.org.cryptonode.jncryptor.JNCryptor,2,0,0,1,0,0,0,0,3
RNCryptor_JNCryptor.org.cryptonode.jncryptor.AES256JNCryptor,5,0,0,4,0,0,0,0,9
RNCryptor_JNCryptor.org.cryptonode.jncryptor.AES256JNCryptorOutputStream,0,0,0,0,0,0,0,0,0
RNCryptor_JNCryptor.org.cryptonode.jncryptor.StreamUtils,1,0,0,0,0,0,0,0,1
RNCryptor_JNCryptor.org.cryptonode.jncryptor.TrailerInputStream,1,0,0,1,0,0,0,0,2
RNCryptor_JNCryptor.org.cryptonode.jncryptor.AES256Ciphertext,0,0,0,0,0,0,0,0,0
jlpoolen_libreveris.com.audiveris.installer.unix.UnixUtilities,0,0,0,0,0,0,0,2,2
javaee-samples_javaee7-samples.org.javaee7.websocket.endpoint.async.MyAsyncEndpointByteBufferClient,0,0,0,0,0,0,0,0,0
javaee-samples_javaee7-samples.org.javaee7.websocket.encoder.client.MyMessage,1,0,0,0,0,0,0,0,1
javaee-samples_javaee7-samples.org.javaee7.websocket.encoder.programmatic.MyMessage,1,0,0,0,0,0,0,0,1
javaee-samples_javaee7-samples.org.javaee7.jaxrs.dbaccess.Employee,1,0,0,0,0,0,0,0,1
javaee-samples_javaee7-samples.org.javaee7.jaxrs.client.Person,3,0,0,3,0,0,0,0,6
javaee-samples_javaee7-samples.org.javaee7.jaxrs.resource.validation.Name,0,0,0,0,0,0,0,6,6
javaee-samples_javaee7-samples.org.javaee7.interceptor.aroundconstruct.Greeting,1,0,0,1,0,0,0,0,2
javaee-samples_javaee7-samples.org.javaee7.ejb.stateless.remote.Account,0,0,0,0,0,0,0,0,0
javaee-samples_javaee7-samples.org.javaee7.ejb.stateless.AccountSessionBean,0,0,0,0,0,0,0,0,0
javaee-samples_javaee7-samples.org.javaee7.ejb.timer.PingsListener,0,0,0,0,0,0,0,0,0
javaee-samples_javaee7-samples.org.javaee7.ejb.async.MyAsyncBeanClassLevel,1,0,0,0,0,0,0,0,1
javaee-samples_javaee7-samples.org.javaee7.ejb.async.MyAsyncBeanMethodLevel,1,0,0,0,0,0,0,0,1
javaee-samples_javaee7-samples.org.javaee7.RemoteEJBContextProvider,0,0,0,0,0,0,0,0,0
javaee-samples_javaee7-samples.org.javaee7.ejb.stateful.remote.Cart,0,0,0,0,0,0,0,0,0
javaee-samples_javaee7-samples.org.javaee7.ejb.stateful.CartBean,0,0,0,0,0,0,0,0,0
javaee-samples_javaee7-samples.org.javaee7.ejb.stateful.ReentrantStatefulBean,0,0,0,0,0,0,0,1,1
javaee-samples_javaee7-samples.org.javaee7.jaspic.common.ArquillianBase,34,0,0,0,0,0,0,3,37
javaee-samples_javaee7-samples.org.javaee7.jpa.defaultdatasource.EmployeeService,2,0,0,1,0,0,0,0,3
javaee-samples_javaee7-samples.org.javaee7.jpa.nativesql.EmployeeBean,1,0,0,0,0,0,0,0,1
javaee-samples_javaee7-samples.org.javaee7.jpa.listeners.MovieBean,0,0,0,0,0,0,0,0,0
javaee-samples_javaee7-samples.org.javaee7.jpa.listeners.Movie,1,0,0,0,0,0,0,0,1
javaee-samples_javaee7-samples.org.javaee7.jpa.dynamicnamedquery.service.TestService,1,0,0,1,0,0,0,0,2
javaee-samples_javaee7-samples.org.javaee7.jpa.locking.optimistic.MovieBean,3,0,0,3,0,0,0,0,6
javaee-samples_javaee7-samples.org.javaee7.jpa.ordercolumn.entity.unidirectional.Parent,0,0,0,0,0,0,0,0,0
javaee-samples_javaee7-samples.org.javaee7.jpa.ordercolumn.service.unidirectional.OrderColumnTesterService,0,0,0,0,0,0,0,0,0
javaee-samples_javaee7-samples.org.javaee7.jpa.ordercolumn.entity.bidirectionaljoin.Child,1,0,0,1,0,0,0,0,2
javaee-samples_javaee7-samples.org.javaee7.jpa.ordercolumn.service.bidirectionaljoin.OrderColumnTesterService,0,0,0,0,0,0,0,0,0
javaee-samples_javaee7-samples.org.javaee7.jpa.ordercolumn.entity.bidirectionalmappedby.Child,0,0,0,0,0,0,0,0,0
javaee-samples_javaee7-samples.org.javaee7.jpa.ordercolumn.service.bidirectionalmappedby.OrderColumnTesterService,0,0,0,0,0,0,0,0,0
javaee-samples_javaee7-samples.org.javaee7.jpa.nativesql.resultset.mapping.EmployeeBean,1,0,0,0,0,0,0,0,1
javaee-samples_javaee7-samples.org.javaee7.jpa.jndi.context.EmployeeBean,1,0,0,0,0,0,0,0,1
javaee-samples_javaee7-samples.org.javaee7.jpasamples.schema.gen.scripts.external.EmployeeBean,0,0,0,0,0,0,0,0,0
javaee-samples_javaee7-samples.org.javaee7.jpa.schemagen.scripts.EmployeeBean,1,0,0,0,0,0,0,0,1
javaee-samples_javaee7-samples.org.javaee7.jpa.converter.EmployeeRepository,1,0,0,0,0,0,0,0,1
javaee-samples_javaee7-samples.org.javaee7.jpa.datasourcedefinition_webxml_pu.service.TestService,1,0,0,1,0,0,0,0,2
javaee-samples_javaee7-samples.org.javaee7.jpa.aggregate_function_in_select.service.TestService,1,0,0,1,0,0,0,0,2
javaee-samples_javaee7-samples.org.javaee7.jpa.datasourcedefinition_annotation_pu.service.TestService,1,0,0,1,0,0,0,0,2
javaee-samples_javaee7-samples.org.javaee7.jpa.datasourcedefinition_applicationxml_pu.service.TestService,2,0,0,2,0,0,0,0,4
javaee-samples_javaee7-samples.org.javaee7.jpa.criteria.MovieBean,1,0,0,1,0,0,0,0,2
javaee-samples_javaee7-samples.org.javaee7.jpa.extended.pc.Character,1,0,0,0,0,0,0,0,1
javaee-samples_javaee7-samples.org.javaee7.jpa.extended.pc.CharactersBean,1,0,0,1,0,0,0,0,2
javaee-samples_javaee7-samples.org.javaee7.jpa.multiple.pu.MultiplePuBean,1,0,0,1,0,0,0,0,2
javaee-samples_javaee7-samples.org.javaee7.jpa.schemagen.metadata.EmployeeBean,1,0,0,0,0,0,0,0,1
javaee-samples_javaee7-samples.org.javaee7.jpa.storedprocedure.MovieBean,0,0,0,0,0,0,0,0,0
javaee-samples_javaee7-samples.org.javaee7.jpa.pu.typesafe.MySessionBean,1,0,0,0,0,0,0,0,1
javaee-samples_javaee7-samples.org.javaee7.jpa.entitygraph.MovieBean,6,0,0,4,0,0,0,0,10
javaee-samples_javaee7-samples.org.javaee7.util.BatchTestHelper,13,11,0,11,0,0,0,0,35
javaee-samples_javaee7-samples.org.javaee7.batch.samples.scheduling.MyManagedScheduledBatch,1,0,0,0,0,0,0,0,1
javaee-samples_javaee7-samples.org.javaee7.validation.methods.MyParameter,0,0,0,0,0,0,0,0,0
javaee-samples_javaee7-samples.org.javaee7.validation.methods.MyBean,0,0,0,0,0,0,0,6,6
javaee-samples_javaee7-samples.org.javaee7.validation.methods.MyBean2,0,0,0,0,0,0,0,1,1
javaee-samples_javaee7-samples.org.javaee7.validation.custom.constraint.MyBean,0,0,0,0,0,0,0,2,2
javaee-samples_javaee7-samples.org.javaee7.jta.tx.exception.EmployeeBean,0,0,0,0,0,0,0,0,0
javaee-samples_javaee7-samples.org.javaee7.jta.transaction.scope.MyTransactionalBean,0,0,0,0,0,1,0,0,1
javaee-samples_javaee7-samples.org.javaee7.jta.transactional.MyTransactionalTxTypeBean,0,0,0,0,0,0,0,5,5
javaee-samples_javaee7-samples.org.javaee7.jms.batch.ResultCollector,2,0,0,2,0,0,0,0,4
javaee-samples_javaee7-samples.org.javaee7.jms.send.receive.simple.MessageSenderAsync,0,0,0,0,0,0,0,1,1
javaee-samples_javaee7-samples.org.javaee7.jms.send.receive.classic.ClassicMessageSender,0,0,0,0,0,0,0,0,0
javaee-samples_javaee7-samples.org.javaee7.jms.send.receive.simple.MessageSenderSync,1,0,0,1,0,0,0,0,2
javaee-samples_javaee7-samples.org.javaee7.jms.send.receive.simple.appmanaged.MessageSenderAppManaged,0,0,0,0,0,0,0,0,0
javaee-samples_javaee7-samples.org.javaee7.jms.temp.destination.JmsClient,0,0,0,0,0,0,0,0,0
javaee-samples_javaee7-samples.org.javaee7.jaxws.client.gen.EBookStoreImplService,0,0,0,0,0,0,0,0,0
javaee-samples_javaee7-samples.org.javaee7.jaxws.client.gen.EBook,1,0,0,1,0,0,0,0,2
javaee-samples_javaee7-samples.org.javaee7.jaxws.endpoint.EBookStore,1,0,0,0,0,0,0,0,1
javaee-samples_javaee7-samples.org.javaee7.cdi.events.conditional.EventSender,1,0,0,1,0,0,0,0,2
javaee-samples_javaee7-samples.org.javaee7.cdi.decorators.priority.Greeting,0,0,0,0,0,0,0,0,0
javaee-samples_javaee7-samples.org.javaee7.cdi.interceptors.Greeting,1,0,0,1,0,0,0,0,2
javaee-samples_javaee7-samples.org.javaee7.cdi.dynamic.interceptor.MyBean,0,0,0,0,0,0,0,0,0
javaee-samples_javaee7-samples.org.javaee7.cdi.events.EventSender,1,0,0,1,0,0,0,0,2
javaee-samples_javaee7-samples.org.javaee7.cdi.decorators.Greeting,0,0,0,0,0,0,0,0,0
javaee-samples_javaee7-samples.org.javaee7.cdi.interceptors.priority.Greeting,1,0,0,1,0,0,0,0,2
javaee-samples_javaee7-samples.org.javaee7.concurrency.managedexecutor.Product,8,0,0,0,0,0,0,0,8
javaee-samples_javaee7-samples.org.javaee7.concurrency.managedexecutor.TestBean,0,0,0,0,0,0,0,0,0
javaee-samples_javaee7-samples.org.javaee7.jca.filewatch.event.FileEvent,3,0,0,3,0,0,0,0,6
awslabs_aws-sdk-java-resources.com.amazonaws.resources.sns.Subscription,1,0,0,0,0,1,1,0,3
awslabs_aws-sdk-java-resources.com.amazonaws.resources.sns.Topic,1,0,0,1,0,1,1,0,4
awslabs_aws-sdk-java-resources.com.amazonaws.resources.sns.PlatformEndpoint,0,0,0,0,0,0,1,0,1
awslabs_aws-sdk-java-resources.com.amazonaws.resources.sns.PlatformApplication,1,0,0,1,0,0,1,0,3
awslabs_aws-sdk-java-resources.com.amazonaws.resources.ec2.EC2,0,0,0,0,0,0,1,1,2
awslabs_aws-sdk-java-resources.com.amazonaws.resources.glacier.Glacier,0,0,0,0,0,0,1,1,2
awslabs_aws-sdk-java-resources.com.amazonaws.resources.identitymanagement.IdentityManagement,0,0,0,0,0,0,2,2,4
awslabs_aws-sdk-java-resources.com.amazonaws.resources.sqs.SQS,1,0,0,1,0,0,1,0,3
awslabs_aws-sdk-java-resources.com.amazonaws.resources.sqs.Queue,3,0,0,3,0,0,3,0,9
awslabs_aws-sdk-java-resources.com.amazonaws.resources.ServiceBuilder,1,0,0,0,0,0,0,0,1
whois-server-list_public-suffix-list.de.malkusch.whoisServerList.publicSuffixList.PublicSuffixListFactory,1,0,0,1,0,0,0,0,2
whois-server-list_public-suffix-list.de.malkusch.whoisServerList.publicSuffixList.PublicSuffixList,4,0,0,0,0,0,0,0,4
whois-server-list_public-suffix-list.de.malkusch.whoisServerList.publicSuffixList.parser.Parser,1,0,0,1,0,0,0,0,2
whois-server-list_public-suffix-list.de.malkusch.whoisServerList.publicSuffixList.util.DomainUtil,1,0,0,0,0,0,0,0,1
whois-server-list_public-suffix-list.de.malkusch.whoisServerList.publicSuffixList.util.PunycodeAutoDecoder,2,0,0,1,0,0,0,0,3
whois-server-list_public-suffix-list.de.malkusch.whoisServerList.publicSuffixList.rule.LabelMatcher,0,0,0,0,0,0,0,0,0
whois-server-list_public-suffix-list.de.malkusch.whoisServerList.publicSuffixList.rule.RuleFactory,1,0,0,0,0,0,0,0,1
whois-server-list_public-suffix-list.de.malkusch.whoisServerList.publicSuffixList.rule.RuleMatcher,0,0,0,0,0,0,0,0,0
whois-server-list_public-suffix-list.de.malkusch.whoisServerList.publicSuffixList.rule.Rule,1,0,0,1,0,0,0,0,2
whois-server-list_public-suffix-list.de.malkusch.whoisServerList.publicSuffixList.index.IndexFactory,0,0,0,0,0,0,0,0,0
whois-server-list_public-suffix-list.de.malkusch.whoisServerList.publicSuffixList.index.Index,2,0,0,2,0,0,0,1,5
jindrapetrik_jpexs-decompiler.com.jpexs.decompiler.flash.gui.AppStrings,0,0,0,0,0,0,0,1,1
jindrapetrik_jpexs-decompiler.com.jpexs.decompiler.flash.action.parser.pcode.ASMParser,3,0,0,3,0,4,0,0,10
jindrapetrik_jpexs-decompiler.com.jpexs.decompiler.flash.abc.avm2.AVM2Code,0,0,0,0,0,0,0,4,4
jindrapetrik_jpexs-decompiler.com.jpexs.decompiler.flash.abc.avm2.parser.pcode.ASM3Parser,1,0,0,1,0,0,0,0,2
jindrapetrik_jpexs-decompiler.com.jpexs.decompiler.flash.abc.types.Multiname,1,1,0,0,0,0,0,0,2
jindrapetrik_jpexs-decompiler.com.jpexs.helpers.FileHashMap,1,0,0,1,0,0,0,0,2
jindrapetrik_jpexs-decompiler.com.jpexs.decompiler.flash.tags.DoABC2Tag,1,0,0,1,0,0,0,0,2
jindrapetrik_jpexs-decompiler.com.jpexs.decompiler.flash.abc.ABCOutputStream,3,0,0,3,0,3,0,0,9
jindrapetrik_jpexs-decompiler.com.jpexs.decompiler.flash.SWFOutputStream,5,0,0,5,0,0,0,0,10
jindrapetrik_jpexs-decompiler.com.jpexs.decompiler.flash.SWFInputStream,1,0,0,1,0,0,0,0,2
jindrapetrik_jpexs-decompiler.com.jpexs.decompiler.flash.action.Action,0,0,0,0,0,0,0,1,1
jindrapetrik_jpexs-decompiler.com.jpexs.decompiler.flash.amf.amf3.Amf3InputStream,0,0,0,0,0,7,0,2,9
vert-x3_vertx-reactive-streams.io.vertx.ext.reactivestreams.ReactiveReadStream,8,0,0,0,0,0,0,1,9
vert-x3_vertx-reactive-streams.io.vertx.ext.reactivestreams.ReactiveWriteStream,5,1,0,0,0,2,0,1,9
sarl_sarl.io.sarl.lang.services.SARLGrammarKeywordAccess,0,0,0,0,0,0,0,0,0
sarl_sarl.io.sarl.eclipse.natures.SARLProjectNature,0,0,0,0,0,0,0,0,0
sarl_sarl.io.sarl.eclipse.explorer.HiddenFileFilter,0,0,0,0,0,0,0,0,0
sarl_sarl.io.sarl.eclipse.buildpath.SARLClasspathContainer,0,0,0,0,0,0,0,0,0
sarl_sarl.io.sarl.eclipse.buildpath.AbstractSARLBasedClasspathContainer,4,0,0,0,0,0,0,0,4
sarl_sarl.io.sarl.lang.codebuilder.CodeBuilderFactory,0,0,0,0,0,0,0,0,0
sarl_sarl.io.sarl.eclipse.runtime.AbstractSREInstall,6,0,0,4,0,0,0,0,10
sarl_sarl.io.sarl.lang.sarl.SarlPackage,0,0,0,0,0,0,0,0,0
sarl_sarl.io.sarl.lang.sarl.actionprototype.ActionPrototype,9,0,0,3,0,0,0,0,12
sarl_sarl.io.sarl.lang.sarl.actionprototype.ActionParameterTypes,17,0,0,7,0,0,0,0,24
sarl_sarl.io.sarl.lang.sarl.impl.SarlEventImplCustom,1,0,0,0,0,0,0,0,1
sarl_sarl.io.sarl.lang.sarl.impl.SarlAgentImplCustom,2,0,0,0,0,0,0,0,2
sarl_sarl.io.sarl.lang.sarl.impl.SarlSkillImplCustom,2,0,0,0,0,0,0,0,2
sarl_sarl.io.sarl.lang.sarl.impl.SarlBehaviorImplCustom,2,0,0,0,0,0,0,0,2
sarl_sarl.io.sarl.lang.util.Utils,14,0,0,2,0,0,0,0,16
sarl_sarl.io.sarl.lang.validation.IConfigurableIssueSeveritiesProvider,6,0,0,4,0,0,0,0,10
sarl_sarl.io.sarl.lang.formatting2.FormatterFacade,0,0,0,0,0,0,0,0,0
sarl_sarl.io.sarl.lang.sarl.SarlAgent,23,0,0,10,0,0,0,0,33
sarl_sarl.io.sarl.lang.ui.outline.SARLOutlineNodeComparator,13,0,0,0,0,0,0,0,13
sarl_sarl.io.sarl.lang.ui.labeling.SARLDescriptionLabelProvider,0,0,0,0,0,0,0,0,0
sarl_sarl.io.sarl.lang.ui.tasks.SarlTaskTagProvider,1,0,0,0,0,0,0,0,1
sarl_sarl.io.sarl.bootstrap.SRE,3,0,0,2,0,0,0,0,5
sarl_sarl.io.sarl.lang.util.SarlUtils,1,0,0,0,0,0,0,0,1
sarl_sarl.io.sarl.lang.scoping.extensions.numbers.cast.AtomicIntegerCastExtensions,2,0,0,0,0,0,0,0,2
sarl_sarl.io.sarl.lang.scoping.extensions.numbers.cast.PrimitiveLongCastExtensions,5,0,0,0,0,0,0,0,5
sarl_sarl.io.sarl.lang.scoping.extensions.numbers.cast.PrimitiveDoubleCastExtensions,5,0,0,0,0,0,0,0,5
sarl_sarl.io.sarl.lang.scoping.extensions.numbers.cast.NumberCastExtensions,11,0,0,0,0,0,0,0,11
sarl_sarl.io.sarl.lang.scoping.extensions.numbers.cast.AtomicLongCastExtensions,2,0,0,0,0,0,0,0,2
sarl_sarl.io.sarl.lang.scoping.extensions.numbers.cast.PrimitiveByteCastExtensions,5,0,0,0,0,0,0,0,5
sarl_sarl.io.sarl.lang.scoping.extensions.numbers.cast.BigDecimalCastExtensions,0,0,0,0,0,0,0,0,0
sarl_sarl.io.sarl.lang.scoping.extensions.numbers.cast.PrimitiveFloatCastExtensions,5,0,0,0,0,0,0,0,5
sarl_sarl.io.sarl.lang.scoping.extensions.numbers.cast.AtomicDoubleCastExtensions,2,0,0,0,0,0,0,0,2
sarl_sarl.io.sarl.lang.scoping.extensions.numbers.cast.PrimitiveShortCastExtensions,5,0,0,0,0,0,0,0,5
sarl_sarl.io.sarl.lang.scoping.extensions.numbers.cast.BigIntegerCastExtensions,1,0,0,0,0,0,0,0,1
sarl_sarl.io.sarl.lang.scoping.extensions.numbers.cast.PrimitiveIntCastExtensions,5,0,0,0,0,0,0,0,5
sarl_sarl.io.sarl.lang.scoping.extensions.numbers.comparison.PrimitiveLongComparisonExtensions,7,0,0,0,0,0,0,0,7
sarl_sarl.io.sarl.lang.scoping.extensions.numbers.comparison.PrimitiveDoubleComparisonExtensions,7,0,0,0,0,0,0,0,7
sarl_sarl.io.sarl.lang.scoping.extensions.numbers.comparison.NumberComparisonExtensions,1,0,0,0,0,0,0,0,1
sarl_sarl.io.sarl.lang.scoping.extensions.numbers.comparison.IntegerComparisonExtensions,1,0,0,0,0,0,0,0,1
sarl_sarl.io.sarl.lang.scoping.extensions.numbers.comparison.PrimitiveByteComparisonExtensions,7,0,0,0,0,0,0,0,7
sarl_sarl.io.sarl.lang.scoping.extensions.numbers.comparison.ByteComparisonExtensions,1,0,0,0,0,0,0,0,1
sarl_sarl.io.sarl.lang.scoping.extensions.numbers.comparison.LongComparisonExtensions,1,0,0,0,0,0,0,0,1
sarl_sarl.io.sarl.lang.scoping.extensions.numbers.comparison.ShortComparisonExtensions,1,0,0,0,0,0,0,0,1
sarl_sarl.io.sarl.lang.scoping.extensions.numbers.comparison.FloatComparisonExtensions,1,0,0,0,0,0,0,0,1
sarl_sarl.io.sarl.lang.scoping.extensions.numbers.comparison.PrimitiveFloatComparisonExtensions,7,0,0,0,0,0,0,0,7
sarl_sarl.io.sarl.lang.scoping.extensions.numbers.comparison.DoubleComparisonExtensions,1,0,0,0,0,0,0,0,1
sarl_sarl.io.sarl.lang.scoping.extensions.numbers.comparison.PrimitiveShortComparisonExtensions,7,0,0,0,0,0,0,0,7
sarl_sarl.io.sarl.lang.scoping.extensions.numbers.comparison.PrimitiveIntComparisonExtensions,7,0,0,0,0,0,0,0,7
sarl_sarl.io.sarl.lang.scoping.extensions.numbers.arithmetic.AtomicIntegerArithmeticExtensions,0,0,0,0,0,0,0,0,0
sarl_sarl.io.sarl.lang.scoping.extensions.numbers.arithmetic.PrimitiveLongArithmeticExtensions,0,0,0,0,0,0,0,0,0
sarl_sarl.io.sarl.lang.scoping.extensions.numbers.arithmetic.PrimitiveDoubleArithmeticExtensions,0,0,0,0,0,0,0,0,0
sarl_sarl.io.sarl.lang.scoping.extensions.numbers.arithmetic.NumberArithmeticExtensions,0,0,0,0,0,0,0,0,0
sarl_sarl.io.sarl.lang.scoping.extensions.numbers.arithmetic.AtomicLongArithmeticExtensions,0,0,0,0,0,0,0,0,0
sarl_sarl.io.sarl.lang.scoping.extensions.numbers.arithmetic.IntegerArithmeticExtensions,0,0,0,0,0,0,0,0,0
sarl_sarl.io.sarl.lang.scoping.extensions.numbers.arithmetic.PrimitiveByteArithmeticExtensions,0,0,0,0,0,0,0,0,0
sarl_sarl.io.sarl.lang.scoping.extensions.numbers.arithmetic.ByteArithmeticExtensions,0,0,0,0,0,0,0,0,0
sarl_sarl.io.sarl.lang.scoping.extensions.numbers.arithmetic.LongArithmeticExtensions,0,0,0,0,0,0,0,0,0
sarl_sarl.io.sarl.lang.scoping.extensions.numbers.arithmetic.ShortArithmeticExtensions,0,0,0,0,0,0,0,0,0
sarl_sarl.io.sarl.lang.scoping.extensions.numbers.arithmetic.FloatArithmeticExtensions,0,0,0,0,0,0,0,0,0
sarl_sarl.io.sarl.lang.scoping.extensions.numbers.arithmetic.PrimitiveFloatArithmeticExtensions,0,0,0,0,0,0,0,0,0
sarl_sarl.io.sarl.lang.scoping.extensions.numbers.arithmetic.DoubleArithmeticExtensions,0,0,0,0,0,0,0,0,0
sarl_sarl.io.sarl.lang.scoping.extensions.numbers.arithmetic.PrimitiveShortArithmeticExtensions,0,0,0,0,0,0,0,0,0
sarl_sarl.io.sarl.lang.scoping.extensions.numbers.arithmetic.PrimitiveIntArithmeticExtensions,0,0,0,0,0,0,0,0,0
sarl_sarl.io.sarl.lang.scoping.extensions.cast.PrimitiveCastExtensions,23,0,0,0,0,0,0,0,23
sarl_sarl.io.sarl.lang.scoping.extensions.time.TimeExtensions,3,0,0,0,0,0,0,0,3
sarl_sarl.io.sarl.lang.core.Address,2,0,0,0,0,0,0,0,2
sarl_sarl.io.sarl.lang.core.AtomicSkillReference,7,0,0,5,0,0,0,0,12
sarl_sarl.io.sarl.lang.core.SREutils,2,0,0,2,0,0,0,0,4
sarl_sarl.io.sarl.lang.core.UnimplementedCapacityException,0,0,0,0,0,0,0,0,0
sarl_sarl.io.sarl.lang.core.SpaceID,6,0,0,0,0,0,0,0,6
sarl_sarl.io.sarl.lang.core.Agent,7,0,0,0,0,0,0,0,7
sarl_sarl.io.sarl.lang.core.Event,6,0,0,5,0,0,0,0,11
abel533_Mapper.tk.mybatis.mapper.mapperhelper.FieldHelper,4,0,0,4,0,0,0,4,12
abel533_Mapper.tk.mybatis.mapper.util.StringUtil,2,0,0,0,0,0,0,6,8
abel533_Mapper.tk.mybatis.mapper.entity.EntityField,0,0,0,0,0,0,0,2,2
abel533_Mapper.tk.mybatis.mapper.entity.Example,36,0,0,20,0,0,0,8,64
abel533_Mapper.tk.mybatis.mapper.additional.aggregation.AggregateCondition,8,0,0,8,0,0,0,0,16
abel533_Mapper.tk.mybatis.mapper.mapperhelper.MapperHelper,0,0,0,0,0,0,0,0,0
abel533_Mapper.tk.mybatis.mapper.mapperhelper.EntityHelper,44,0,0,44,0,0,0,0,88
abel533_Mapper.tk.mybatis.mapper.mapperhelper.SqlHelper,2,0,0,2,0,0,0,0,4
abel533_Mapper.tk.mybatis.mapper.weekend.WeekendSqls,0,0,0,0,0,0,0,0,0
OpenHFT_Chronicle-Queue.net.openhft.chronicle.queue.impl.single.SingleChronicleQueueBuilder,76,1,0,66,0,10,4,29,186
OpenHFT_Chronicle-Queue.net.openhft.chronicle.queue.impl.single.SingleChronicleQueue,4,0,0,4,0,0,1,1,10
OpenHFT_Chronicle-Queue.net.openhft.chronicle.queue.impl.single.InternalAppender,2,1,0,0,0,0,0,1,4
OpenHFT_Chronicle-Queue.net.openhft.chronicle.queue.RollCycle,0,0,0,0,0,0,0,2,2
OpenHFT_Chronicle-Queue.net.openhft.chronicle.queue.ChronicleQueue,7,2,0,2,0,1,1,3,16
OpenHFT_Chronicle-Queue.net.openhft.chronicle.queue.ExcerptAppender,14,3,0,10,0,0,0,3,30
OpenHFT_Chronicle-Queue.net.openhft.chronicle.queue.reader.ChronicleReader,14,0,0,11,0,0,2,0,27
OpenHFT_Chronicle-Queue.net.openhft.chronicle.queue.util.FileUtil,2,0,0,1,0,0,1,0,4
OpenHFT_Chronicle-Queue.net.openhft.chronicle.queue.impl.table.SingleTableBuilder,1,0,0,0,0,0,0,0,1
OpenHFT_Chronicle-Queue.net.openhft.chronicle.queue.impl.single.Pretoucher,0,0,0,0,0,0,0,2,2
OpenHFT_Chronicle-Queue.net.openhft.chronicle.queue.ExcerptTailer,18,1,0,9,0,0,1,0,29
OpenHFT_Chronicle-Queue.net.openhft.chronicle.queue.impl.single.TableDirectoryListing,2,0,0,2,0,0,0,0,4
OpenHFT_Chronicle-Queue.net.openhft.chronicle.queue.impl.single.RollCycleEncodeSequence,0,0,0,0,0,0,0,0,0
OpenHFT_Chronicle-Queue.net.openhft.chronicle.queue.util.QueueUtil,1,0,0,1,0,1,0,2,5
OpenHFT_Chronicle-Queue.net.openhft.chronicle.queue.main.DumpMain,0,1,0,0,0,0,0,0,1
OpenHFT_Chronicle-Queue.net.openhft.chronicle.queue.impl.single.SCQIndexing,2,0,0,0,0,0,0,0,2
OpenHFT_Chronicle-Queue.net.openhft.chronicle.queue.impl.single.PretoucherState,3,3,0,0,0,0,0,0,6
OpenHFT_Chronicle-Queue.net.openhft.chronicle.queue.channel.PipeHandler,0,0,0,0,0,0,0,1,1
kairosdb_kairosdb-client.org.kairosdb.client.HttpClient,1,0,0,1,0,0,0,2,4
kairosdb_kairosdb-client.org.kairosdb.client.builder.MetricBuilder,7,0,0,7,0,0,0,4,18
kairosdb_kairosdb-client.org.kairosdb.client.builder.RollupBuilder,1,0,0,1,0,1,0,3,6
kairosdb_kairosdb-client.org.kairosdb.client.response.GroupResult,5,0,0,5,0,0,0,0,10
kairosdb_kairosdb-client.org.kairosdb.client.response.DefaultJsonResponseHandler,6,0,0,6,0,6,0,0,18
kairosdb_kairosdb-client.org.kairosdb.client.response.grouping.BinGroupResult,0,0,0,0,0,0,0,0,0
kairosdb_kairosdb-client.org.kairosdb.client.builder.AggregatorFactory,17,0,0,17,0,0,0,0,34
kairosdb_kairosdb-client.org.kairosdb.client.builder.DataPoint,5,0,0,5,0,0,0,0,10
kairosdb_kairosdb-client.org.kairosdb.client.builder.QueryBuilder,0,0,0,0,0,0,0,0,0
kairosdb_kairosdb-client.org.kairosdb.client.builder.aggregator.CustomAggregator,0,0,0,0,0,0,0,0,0
kairosdb_kairosdb-client.org.kairosdb.client.builder.aggregator.SamplingAggregator,5,0,0,5,0,0,0,0,10
kairosdb_kairosdb-client.org.kairosdb.client.builder.TimeValidator,0,0,0,0,0,0,0,2,2
kairosdb_kairosdb-client.org.kairosdb.client.builder.RelativeTime,0,0,0,0,0,0,0,2,2
kairosdb_kairosdb-client.org.kairosdb.client.builder.QueryTagBuilder,0,0,0,0,0,0,0,0,0
kairosdb_kairosdb-client.org.kairosdb.client.builder.Grouper,0,0,0,0,0,0,0,0,0
kairosdb_kairosdb-client.org.kairosdb.client.builder.grouper.BinGrouper,0,0,0,0,0,0,0,0,0
kairosdb_kairosdb-client.org.kairosdb.client.builder.grouper.CustomGrouper,0,0,0,0,0,0,0,0,0
kairosdb_kairosdb-client.org.kairosdb.client.builder.grouper.TagGrouper,0,0,0,0,0,0,0,0,0
kairosdb_kairosdb-client.org.kairosdb.client.builder.aggregator.RateAggregator,0,0,0,0,0,0,0,0,0
nguyenq_tess4j.net.sourceforge.tess4j.TessAPI,1,0,0,1,0,0,0,0,2
nguyenq_tess4j.net.sourceforge.tess4j.ITesseract,4,0,0,3,0,1,0,0,8
nguyenq_tess4j.com.recognition.software.jdeskew.ImageDeskew,0,0,0,0,0,0,0,0,0
nguyenq_tess4j.net.sourceforge.tess4j.util.Utils,0,0,0,0,0,0,0,0,0
nguyenq_tess4j.net.sourceforge.tess4j.util.LoadLibs,0,0,0,0,0,0,0,0,0
nguyenq_tess4j.net.sourceforge.tess4j.TessAPI1,1,0,0,1,0,0,0,0,2
nguyenq_tess4j.net.sourceforge.tess4j.util.ImageIOHelper,1,0,0,1,0,0,0,0,2
nguyenq_tess4j.net.sourceforge.tess4j.util.PdfUtilities,0,0,0,0,0,0,0,0,0
HPI-Information-Systems_Metanome.de.metanome.backend.resources.ResultStoreResource,1,0,0,1,0,0,0,0,2
HPI-Information-Systems_Metanome.de.metanome.backend.resources.AlgorithmResource,3,0,0,3,0,0,0,0,6
HPI-Information-Systems_Metanome.de.metanome.backend.resources.AlgorithmExecutionResource,1,0,0,1,0,0,0,0,2
HPI-Information-Systems_Metanome.de.metanome.backend.resources.FileInputResource,3,0,0,3,0,0,0,0,6
HPI-Information-Systems_Metanome.de.metanome.backend.resources.ParameterResource,1,0,0,0,0,0,0,0,1
HPI-Information-Systems_Metanome.de.metanome.backend.resources.ExecutionResource,4,0,0,4,0,0,0,0,8
HPI-Information-Systems_Metanome.de.metanome.backend.resources.TableInputResource,3,0,0,3,0,0,0,0,6
HPI-Information-Systems_Metanome.de.metanome.backend.resources.DatabaseConnectionResource,2,0,0,2,0,0,0,0,4
HPI-Information-Systems_Metanome.de.metanome.backend.result_receiver.ResultCache,2,0,0,2,0,0,0,0,4
HPI-Information-Systems_Metanome.de.metanome.backend.result_receiver.ResultPrinter,9,0,0,9,0,0,0,6,24
HPI-Information-Systems_Metanome.de.metanome.backend.result_receiver.ResultCounter,2,0,0,2,0,0,0,0,4
HPI-Information-Systems_Metanome.de.metanome.backend.input.file.FileIterator,11,0,0,8,0,2,0,0,21
HPI-Information-Systems_Metanome.de.metanome.algorithm_integration.input.RelationalInputGenerator,1,0,0,1,0,0,0,0,2
HPI-Information-Systems_Metanome.de.metanome.backend.input.file.DefaultFileInputGenerator,3,0,0,2,0,0,0,0,5
HPI-Information-Systems_Metanome.de.metanome.backend.input.DefaultRelationalInputGeneratorInitializer,1,0,0,1,0,0,0,0,2
HPI-Information-Systems_Metanome.de.metanome.backend.input.database.ResultSetIterator,2,0,0,2,0,0,0,2,6
HPI-Information-Systems_Metanome.de.metanome.backend.input.database.DefaultDatabaseConnectionGenerator,4,0,0,4,0,0,0,3,11
HPI-Information-Systems_Metanome.de.metanome.backend.input.database.DefaultTableInputGenerator,0,0,0,0,0,0,0,4,4
HPI-Information-Systems_Metanome.de.metanome.backend.configuration.DefaultConfigurationFactory,1,0,0,0,0,0,0,0,1
HPI-Information-Systems_Metanome.de.metanome.algorithm_integration.input.RelationalInput,2,0,0,2,0,0,0,0,4
HPI-Information-Systems_Metanome.de.metanome.backend.configuration.ConfigurationValueTableInputGenerator,0,0,0,0,0,0,0,1,1
HPI-Information-Systems_Metanome.de.metanome.backend.configuration.ConfigurationValueRelationalInputGenerator,0,0,0,0,0,0,0,1,1
HPI-Information-Systems_Metanome.de.metanome.backend.configuration.ConfigurationValueFileInputGenerator,0,0,0,0,0,0,0,1,1
HPI-Information-Systems_Metanome.de.metanome.algorithm_integration.input.FileInputGenerator,1,0,0,0,0,0,0,0,1
HPI-Information-Systems_Metanome.de.metanome.backend.configuration.ConfigurationValueInteger,0,0,0,0,0,0,0,1,1
HPI-Information-Systems_Metanome.de.metanome.backend.configuration.ConfigurationValueListBox,0,0,0,0,0,0,0,1,1
HPI-Information-Systems_Metanome.de.metanome.backend.configuration.ConfigurationValueCheckBox,0,0,0,0,0,0,0,1,1
HPI-Information-Systems_Metanome.de.metanome.backend.configuration.ConfigurationValueBoolean,0,0,0,0,0,0,0,1,1
HPI-Information-Systems_Metanome.de.metanome.backend.configuration.ConfigurationValueString,0,0,0,0,0,0,0,1,1
HPI-Information-Systems_Metanome.de.metanome.backend.configuration.ConfigurationValueDatabaseConnectionGenerator,0,0,0,0,0,0,0,1,1
HPI-Information-Systems_Metanome.de.metanome.backend.algorithm_loading.AlgorithmJarLoader,1,0,0,1,0,0,0,0,2
HPI-Information-Systems_Metanome.de.metanome.backend.algorithm_loading.InputDataFinder,2,0,0,0,0,0,0,0,2
HPI-Information-Systems_Metanome.de.metanome.backend.algorithm_loading.AlgorithmFinder,1,0,0,0,0,0,0,0,1
HPI-Information-Systems_Metanome.de.metanome.backend.result_postprocessing.result_ranking.OrderDependencyRanking,3,0,0,3,0,0,0,0,6
HPI-Information-Systems_Metanome.de.metanome.backend.result_postprocessing.result_ranking.BasicStatisticRanking,0,0,0,0,0,0,0,0,0
HPI-Information-Systems_Metanome.de.metanome.backend.result_postprocessing.result_ranking.ConditionalUniqueColumnCombinationRanking,0,0,0,0,0,0,0,0,0
HPI-Information-Systems_Metanome.de.metanome.backend.result_postprocessing.result_ranking.UniqueColumnCombinationRanking,1,0,0,1,0,0,0,0,2
HPI-Information-Systems_Metanome.de.metanome.backend.result_postprocessing.result_ranking.InclusionDependencyRanking,3,0,0,3,0,0,0,0,6
HPI-Information-Systems_Metanome.de.metanome.backend.result_postprocessing.result_ranking.FunctionalDependencyRanking,6,0,0,6,0,0,0,0,12
HPI-Information-Systems_Metanome.de.metanome.backend.result_postprocessing.result_store.ResultsStoreHolder,2,0,0,2,0,0,0,0,4
HPI-Information-Systems_Metanome.de.metanome.backend.result_postprocessing.result_store.ResultsStore,3,0,0,1,0,0,0,0,4
HPI-Information-Systems_Metanome.de.metanome.backend.result_postprocessing.visualization.FunctionalDependency.FunctionalDependencyVisualization,3,0,0,1,0,0,0,0,4
HPI-Information-Systems_Metanome.de.metanome.backend.result_postprocessing.visualization.UniqueColumnCombination.UniqueColumnCombinationVisualization,1,0,0,1,0,0,0,0,2
HPI-Information-Systems_Metanome.de.metanome.backend.result_postprocessing.results.DenialConstraintResult,0,0,0,0,0,0,0,0,0
HPI-Information-Systems_Metanome.de.metanome.backend.result_postprocessing.results.OrderDependencyResult,1,0,0,1,0,0,0,0,2
HPI-Information-Systems_Metanome.de.metanome.backend.result_postprocessing.results.InclusionDependencyResult,1,0,0,1,0,0,0,0,2
HPI-Information-Systems_Metanome.de.metanome.backend.result_postprocessing.results.BasicStatisticResult,1,0,0,1,0,0,0,0,2
HPI-Information-Systems_Metanome.de.metanome.algorithm_integration.results.BasicStatistic,4,0,0,1,0,0,0,1,6
HPI-Information-Systems_Metanome.de.metanome.backend.result_postprocessing.results.ConditionalUniqueColumnCombinationResult,1,0,0,1,0,0,0,0,2
HPI-Information-Systems_Metanome.de.metanome.backend.result_postprocessing.results.FunctionalDependencyResult,1,0,0,1,0,0,0,0,2
HPI-Information-Systems_Metanome.de.metanome.backend.result_postprocessing.results.UniqueColumnCombinationResult,1,0,0,1,0,0,0,0,2
HPI-Information-Systems_Metanome.de.metanome.backend.result_postprocessing.helper.Histogram,1,0,0,1,0,0,0,0,2
HPI-Information-Systems_Metanome.de.metanome.backend.helper.InputToGeneratorConverter,2,0,0,2,0,0,0,0,4
HPI-Information-Systems_Metanome.de.metanome.backend.results_db.DatabaseConnection,2,0,0,2,0,0,0,1,5
HPI-Information-Systems_Metanome.de.metanome.backend.result_postprocessing.helper.ColumnInformation,9,0,0,3,0,0,0,0,12
HPI-Information-Systems_Metanome.de.metanome.backend.result_postprocessing.helper.StringHelper,0,0,0,0,0,0,0,0,0
HPI-Information-Systems_Metanome.de.metanome.backend.result_postprocessing.helper.TableInformation,3,0,0,2,0,0,0,0,5
HPI-Information-Systems_Metanome.de.metanome.backend.result_postprocessing.result_analyzer.FunctionalDependencyResultAnalyzer,3,0,0,1,0,0,0,0,4
HPI-Information-Systems_Metanome.de.metanome.backend.results_db.Input,1,0,0,1,0,0,0,1,3
HPI-Information-Systems_Metanome.de.metanome.backend.results_db.Result,0,0,0,0,0,0,0,0,0
HPI-Information-Systems_Metanome.de.metanome.backend.results_db.ExecutionSetting,0,0,0,0,0,0,0,1,1
HPI-Information-Systems_Metanome.de.metanome.backend.results_db.HibernateUtil,5,0,0,4,0,1,0,1,11
HPI-Information-Systems_Metanome.de.metanome.backend.results_db.Algorithm,2,1,0,2,0,1,0,0,6
HPI-Information-Systems_Metanome.de.metanome.backend.results_db.AlgorithmContentEquals,1,0,0,1,0,0,0,0,2
HPI-Information-Systems_Metanome.de.metanome.backend.results_db.Execution,4,0,0,4,0,0,0,0,8
HPI-Information-Systems_Metanome.de.metanome.backend.results_db.FileInput,0,0,0,0,0,0,0,1,1
HPI-Information-Systems_Metanome.de.metanome.backend.results_db.TableInput,0,0,0,0,0,0,0,1,1
HPI-Information-Systems_Metanome.de.metanome.backend.algorithm_execution.TempFileGenerator,4,0,0,3,0,0,0,0,7
HPI-Information-Systems_Metanome.de.metanome.backend.algorithm_execution.AlgorithmExecution,3,0,0,3,0,0,0,0,6
HPI-Information-Systems_Metanome.de.metanome.backend.algorithm_execution.AlgorithmExecutor,1,0,0,1,0,0,0,5,7
HPI-Information-Systems_Metanome.de.metanome.algorithms.testing.example_relational_input_algorithm.ExampleAlgorithm,0,0,0,0,0,0,0,0,0
HPI-Information-Systems_Metanome.de.metanome.algorithms.testing.example_ucc_algorithm.ExampleAlgorithm,1,0,0,0,0,0,0,1,2
HPI-Information-Systems_Metanome.de.metanome.algorithms.testing.example_basic_stat_algorithm.BasicStatAlgorithm,0,0,0,0,0,0,0,1,1
HPI-Information-Systems_Metanome.de.metanome.algorithms.testing.example_fd_algorithm.ExampleAlgorithm,1,0,0,0,0,0,0,1,2
HPI-Information-Systems_Metanome.de.metanome.algorithms.testing.example_holistic_algorithm.ExampleAlgorithm,1,0,0,0,0,0,0,1,2
HPI-Information-Systems_Metanome.de.metanome.algorithms.testing.example_dc_algorithm.ExampleAlgorithm,1,0,0,0,0,0,0,1,2
HPI-Information-Systems_Metanome.de.metanome.algorithms.testing.example_mvd_algorithm.ExampleAlgorithm,1,0,0,0,0,0,0,1,2
HPI-Information-Systems_Metanome.de.metanome.algorithms.testing.example_sql_profiling_algorithm.SqlProfilingAlgorithm,0,0,0,0,0,0,0,1,1
HPI-Information-Systems_Metanome.de.metanome.algorithms.testing.example_cucc_algorithm.ExampleAlgorithm,1,0,0,0,0,0,0,1,2
HPI-Information-Systems_Metanome.de.metanome.algorithms.testing.example_cid_algorithm.ExampleAlgorithm,1,0,0,1,0,0,0,1,3
HPI-Information-Systems_Metanome.de.metanome.algorithms.testing.example_indirect_interfaces_algorithm.IndirectInterfacesAlgorithm,0,0,0,0,0,0,0,1,1
HPI-Information-Systems_Metanome.de.metanome.algorithms.testing.example_ind_algorithm.ExampleAlgorithm,1,0,0,1,0,0,0,1,3
HPI-Information-Systems_Metanome.de.metanome.algorithms.testing.example_od_algorithm.ExampleAlgorithm,1,0,0,0,0,0,0,1,2
HPI-Information-Systems_Metanome.de.metanome.algorithm_helper.data_structures.PLIBuilder,0,0,0,0,0,0,0,0,0
HPI-Information-Systems_Metanome.de.metanome.algorithm_helper.data_structures.PositionListIndex,5,0,0,3,0,0,0,0,8
HPI-Information-Systems_Metanome.de.metanome.algorithm_helper.data_structures.LongPair,2,0,0,2,0,0,0,0,4
HPI-Information-Systems_Metanome.de.metanome.algorithm_helper.data_structures.SubSetGraph,4,0,0,2,0,0,0,1,7
HPI-Information-Systems_Metanome.de.metanome.algorithm_helper.data_structures.SuperSetGraph,4,0,0,2,0,0,0,1,7
HPI-Information-Systems_Metanome.de.metanome.algorithm_helper.data_structures.ColumnCombinationBitset,28,0,0,11,0,0,0,2,41
HPI-Information-Systems_Metanome.de.metanome.algorithm_integration.ColumnIdentifier,5,0,0,1,0,0,0,0,6
HPI-Information-Systems_Metanome.de.metanome.algorithm_integration.ColumnPermutation,2,0,0,2,0,0,0,0,4
HPI-Information-Systems_Metanome.de.metanome.algorithm_integration.ColumnCondition,0,0,0,0,0,0,0,0,0
HPI-Information-Systems_Metanome.de.metanome.algorithm_integration.ColumnCombination,4,0,0,1,0,0,0,0,5
HPI-Information-Systems_Metanome.de.metanome.algorithm_integration.configuration.ConfigurationSettingPrimitive,0,0,0,0,0,0,0,0,0
HPI-Information-Systems_Metanome.de.metanome.algorithm_integration.configuration.ConfigurationSettingTableInput,1,0,0,1,0,0,0,0,2
HPI-Information-Systems_Metanome.de.metanome.algorithm_integration.configuration.ConfigurationSettingFileInput,2,0,0,1,0,0,0,0,3
HPI-Information-Systems_Metanome.de.metanome.algorithm_integration.configuration.ConfigurationRequirementDefaultValue,3,0,0,2,0,1,0,0,6
HPI-Information-Systems_Metanome.de.metanome.algorithm_integration.configuration.ConfigurationSettingDatabaseConnection,1,0,0,1,0,0,0,0,2
HPI-Information-Systems_Metanome.de.metanome.algorithm_integration.configuration.ConfigurationRequirement,3,0,0,3,0,0,0,0,6
HPI-Information-Systems_Metanome.de.metanome.algorithm_integration.results.basic_statistic_values.BasicStatisticValueString,3,0,0,3,0,0,0,0,6
HPI-Information-Systems_Metanome.de.metanome.algorithm_integration.results.ConditionalUniqueColumnCombination,0,0,0,0,0,0,0,1,1
HPI-Information-Systems_Metanome.de.metanome.algorithm_integration.results.FunctionalDependency,3,0,0,2,0,0,0,1,6
HPI-Information-Systems_Metanome.de.metanome.algorithm_integration.results.MatchingDependency,2,0,0,1,0,0,0,1,4
HPI-Information-Systems_Metanome.de.metanome.algorithm_integration.results.OrderDependency,2,0,0,2,0,0,0,1,5
HPI-Information-Systems_Metanome.de.metanome.algorithm_integration.results.DenialConstraint,2,0,0,0,0,0,0,1,3
HPI-Information-Systems_Metanome.de.metanome.algorithm_integration.results.InclusionDependency,3,0,0,2,0,0,0,1,6
HPI-Information-Systems_Metanome.de.metanome.algorithm_integration.ColumnConditionOr,0,0,0,0,0,0,0,0,0
HPI-Information-Systems_Metanome.de.metanome.algorithm_integration.results.UniqueColumnCombination,2,0,0,1,0,0,0,1,4
Stratio_stratio-streaming.com.stratio.decision.commons.kafka.service.KafkaTopicService,0,0,0,0,0,0,0,0,0
Stratio_stratio-streaming.com.stratio.decision.commons.messages.StratioStreamingMessage,6,1,0,5,0,0,0,0,12
Stratio_stratio-streaming.com.stratio.decision.commons.dto.ActionCallbackDto,0,0,0,0,0,0,0,0,0
Stratio_stratio-streaming.com.stratio.decision.commons.messages.ColumnNameTypeValue,1,0,0,1,0,0,0,0,2
radcortez_wow-auctions.com.radcortez.wow.auctions.batch.process.purge.PurgeRawAuctionDataBatchlet,0,0,0,0,0,0,0,0,0
radcortez_wow-auctions.com.radcortez.wow.auctions.batch.process.data.AuctionDataItemReader,2,0,0,1,0,0,0,0,3
radcortez_wow-auctions.com.radcortez.wow.auctions.batch.process.AbstractAuctionFileProcess,1,0,0,1,0,0,0,1,3
radcortez_wow-auctions.com.radcortez.wow.auctions.mapper.ConnectedRealmMapper,1,0,0,0,0,0,0,0,1
radcortez_wow-auctions.com.radcortez.wow.auctions.entity.AuctionFile,1,0,0,0,0,0,0,0,1
radcortez_wow-auctions.com.radcortez.wow.auctions.entity.ConnectedRealm,2,0,0,0,0,0,0,0,2
irobertson_pojomatic.org.pojomatic.diff.NoDifferences,0,0,0,0,0,0,0,0,0
irobertson_pojomatic.org.pojomatic.Pojomatic,1,0,0,0,0,0,0,0,1
irobertson_pojomatic.org.pojomatic.diff.Differences,2,0,0,0,0,0,0,0,2
irobertson_pojomatic.org.pojomatic.Pojomator,1,0,0,0,0,0,0,0,1
irobertson_pojomatic.org.pojomatic.internal.PropertyClassVisitor,3,0,0,1,0,1,0,0,5
irobertson_pojomatic.org.pojomatic.internal.ClassProperties,17,1,0,14,0,3,0,0,35
irobertson_pojomatic.org.pojomatic.formatter.EnhancedPojoFormatter,0,0,0,0,0,0,0,0,0
irobertson_pojomatic.org.pojomatic.formatter.PojoFormatter,0,0,0,0,0,0,0,0,0
irobertson_pojomatic.org.pojomatic.internal.PropertyFilter,0,0,0,0,0,0,0,0,0
irobertson_pojomatic.org.pojomatic.internal.AbstractPropertyElement,3,1,0,0,0,0,0,0,4
irobertson_pojomatic.org.pojomatic.internal.OverridableMethods,5,0,0,0,0,1,0,0,6
irobertson_pojomatic.org.pojomatic.internal.EnhancedPropertyFormatterWrapper,0,0,0,0,0,0,0,1,1
irobertson_pojomatic.org.pojomatic.formatter.PropertyFormatter,0,0,0,0,0,0,0,0,0
irobertson_pojomatic.org.pojomatic.formatter.AccountNumberFormatter,0,0,0,0,0,0,0,0,0
irobertson_pojomatic.org.pojomatic.formatter.DefaultPojoFormatter,2,0,0,0,0,0,0,0,2
irobertson_pojomatic.org.pojomatic.formatter.DefaultEnhancedPojoFormatter,0,0,0,0,0,0,0,4,4
irobertson_pojomatic.org.pojomatic.diff.ValueDifference,0,0,0,0,0,0,0,0,0
irobertson_pojomatic.org.pojomatic.diff.PropertyDifferences,1,0,0,0,0,0,0,0,1
ESAPI_esapi-java-legacy.org.owasp.esapi.codecs.Codec,3,0,0,0,0,0,0,0,3
ESAPI_esapi-java-legacy.org.owasp.esapi.codecs.CSSCodec,4,0,0,0,0,0,0,0,4
ESAPI_esapi-java-legacy.org.owasp.esapi.codecs.PushbackSequence,2,0,0,2,0,0,0,0,4
ESAPI_esapi-java-legacy.org.owasp.esapi.codecs.AbstractCodec,0,0,0,0,0,0,0,5,5
ESAPI_esapi-java-legacy.org.owasp.esapi.codecs.MySQLCodec,0,0,0,0,0,0,0,0,0
ESAPI_esapi-java-legacy.org.owasp.esapi.codecs.ref.EncodingPatternPreservation,3,0,0,3,0,0,0,0,6
ESAPI_esapi-java-legacy.org.owasp.esapi.ValidationErrorList,4,0,0,4,0,0,0,2,10
ESAPI_esapi-java-legacy.org.owasp.esapi.ESAPI,11,2,0,9,0,2,0,8,32
ESAPI_esapi-java-legacy.org.owasp.esapi.crypto.CipherTextSerializer,2,0,0,2,0,2,0,0,6
ESAPI_esapi-java-legacy.org.owasp.esapi.crypto.CipherSpec,7,0,0,6,0,4,0,0,17
ESAPI_esapi-java-legacy.org.owasp.esapi.crypto.CipherText,8,0,0,6,0,6,0,0,20
ESAPI_esapi-java-legacy.org.owasp.esapi.SecurityConfiguration,3,0,0,2,0,1,0,1,7
ESAPI_esapi-java-legacy.org.owasp.esapi.crypto.PlainText,3,0,0,3,0,2,0,0,8
ESAPI_esapi-java-legacy.org.owasp.esapi.crypto.KeyDerivationFunction,3,0,0,1,0,3,0,0,7
ESAPI_esapi-java-legacy.org.owasp.esapi.crypto.CryptoToken,6,0,0,4,0,6,0,0,16
ESAPI_esapi-java-legacy.org.owasp.esapi.crypto.CryptoHelper,5,0,0,0,0,2,0,0,7
ESAPI_esapi-java-legacy.org.owasp.esapi.crypto.SecurityProviderLoader,3,0,0,1,0,3,0,0,7
ESAPI_esapi-java-legacy.org.owasp.esapi.Logger,6,0,0,6,0,0,0,56,68
ESAPI_esapi-java-legacy.org.owasp.esapi.logging.slf4j.Slf4JLogFactory,3,0,0,0,0,0,0,0,3
ESAPI_esapi-java-legacy.org.owasp.esapi.logging.slf4j.Slf4JLogBridgeImpl,0,0,0,0,0,0,0,2,2
ESAPI_esapi-java-legacy.org.owasp.esapi.logging.appender.LogAppender,0,0,0,0,0,0,0,2,2
ESAPI_esapi-java-legacy.org.owasp.esapi.logging.slf4j.Slf4JLogLevelHandler,0,0,0,0,0,0,0,2,2
ESAPI_esapi-java-legacy.org.owasp.esapi.logging.java.JavaLogBridgeImpl,0,0,0,0,0,0,0,2,2
ESAPI_esapi-java-legacy.org.owasp.esapi.logging.java.JavaLogLevelHandler,0,0,0,0,0,0,0,2,2
ESAPI_esapi-java-legacy.org.owasp.esapi.logging.java.JavaLogFactory,3,0,0,0,0,1,0,1,5
ESAPI_esapi-java-legacy.org.owasp.esapi.logging.appender.ClientInfoSupplier,0,0,0,0,0,0,0,0,0
ESAPI_esapi-java-legacy.org.owasp.esapi.logging.appender.EventTypeLogSupplier,0,0,0,0,0,0,0,0,0
ESAPI_esapi-java-legacy.org.owasp.esapi.logging.appender.UserInfoSupplier,0,0,0,0,0,0,0,0,0
ESAPI_esapi-java-legacy.org.owasp.esapi.logging.appender.ServerInfoSupplier,0,0,0,0,0,0,0,0,0
ESAPI_esapi-java-legacy.org.owasp.esapi.logging.appender.LogPrefixAppender,1,0,0,0,0,0,0,2,3
ESAPI_esapi-java-legacy.org.owasp.esapi.logging.cleaning.NewlineLogScrubber,0,0,0,0,0,0,0,0,0
ESAPI_esapi-java-legacy.org.owasp.esapi.logging.cleaning.CodecLogScrubber,0,0,0,0,0,0,0,1,1
ESAPI_esapi-java-legacy.org.owasp.esapi.logging.cleaning.CompositeLogScrubber,0,0,0,0,0,0,0,0,0
ESAPI_esapi-java-legacy.org.owasp.esapi.configuration.AbstractPrioritizedPropertyLoader,8,0,0,0,0,8,0,0,16
ESAPI_esapi-java-legacy.org.owasp.esapi.configuration.XmlEsapiPropertyLoader,6,0,0,0,0,6,0,0,12
ESAPI_esapi-java-legacy.org.owasp.esapi.configuration.StandardEsapiPropertyLoader,6,0,0,0,0,6,0,0,12
ESAPI_esapi-java-legacy.org.owasp.esapi.configuration.EsapiPropertyManager,13,0,0,0,0,13,0,0,26
ESAPI_esapi-java-legacy.org.owasp.esapi.util.ByteConversionUtil,0,0,0,0,0,0,0,0,0
ESAPI_esapi-java-legacy.org.owasp.esapi.filters.SecurityWrapperRequest,10,0,0,6,0,0,0,0,16
ESAPI_esapi-java-legacy.org.owasp.esapi.filters.SecurityWrapperResponse,0,0,0,0,0,0,0,31,31
ESAPI_esapi-java-legacy.org.owasp.esapi.reference.AbstractAccessReferenceMap,1,0,0,1,0,0,0,1,3
ESAPI_esapi-java-legacy.org.owasp.esapi.reference.DefaultSecurityConfiguration,26,0,0,3,0,2,0,0,31
ESAPI_esapi-java-legacy.org.owasp.esapi.reference.DefaultValidator,1,0,0,1,0,0,0,2,4
ESAPI_esapi-java-legacy.org.owasp.esapi.Validator,22,1,0,21,0,5,0,0,49
ESAPI_esapi-java-legacy.org.owasp.esapi.Authenticator,10,0,0,10,0,1,0,0,21
ESAPI_esapi-java-legacy.org.owasp.esapi.reference.crypto.ReferenceEncryptedProperties,7,4,0,5,0,2,0,0,18
ESAPI_esapi-java-legacy.org.owasp.esapi.reference.crypto.EncryptedPropertiesUtils,3,0,0,3,0,0,0,0,6
ESAPI_esapi-java-legacy.org.owasp.esapi.AccessController,2,0,0,0,0,0,0,2,4
ESAPI_esapi-java-legacy.org.owasp.esapi.reference.accesscontrol.policyloader.ACRPolicyFileLoader,1,0,0,1,0,0,0,0,2
ESAPI_esapi-java-legacy.org.owasp.esapi.reference.validation.StringValidationRule,6,0,0,4,0,4,0,0,14
ESAPI_esapi-java-legacy.org.owasp.esapi.reference.validation.BaseValidationRule,6,0,0,6,0,0,0,5,17
ESAPI_esapi-java-legacy.org.owasp.esapi.reference.validation.DateValidationRule,2,0,0,2,0,0,0,4,8
ESAPI_esapi-java-legacy.org.owasp.esapi.codecs.AbstractCharacterCodec,1,0,0,1,0,0,0,0,2
psidnell_ofexport2.org.psidnell.omnifocus.ApplicationContextFactory,1,0,0,0,0,0,0,0,1
psidnell_ofexport2.org.psidnell.omnifocus.OFExport,0,0,0,0,0,0,0,27,27
psidnell_ofexport2.org.psidnell.omnifocus.model.NodeImpl,5,0,0,5,0,0,0,0,10
psidnell_ofexport2.org.psidnell.omnifocus.model.Project,7,0,0,7,0,0,0,0,14
psidnell_ofexport2.org.psidnell.omnifocus.model.DataCache,10,0,0,10,0,0,0,0,20
psidnell_ofexport2.org.psidnell.omnifocus.model.Folder,5,0,0,5,0,0,0,0,10
psidnell_ofexport2.org.psidnell.omnifocus.model.Task,11,0,0,11,0,0,0,0,22
psidnell_ofexport2.org.psidnell.omnifocus.model.Context,8,0,0,8,0,0,0,0,16
psidnell_ofexport2.org.psidnell.omnifocus.visitor.Traverser,0,0,0,0,0,1,0,18,19
psidnell_ofexport2.org.psidnell.omnifocus.model.NodeFactory,6,0,0,6,0,0,0,0,12
psidnell_ofexport2.org.psidnell.omnifocus.expr.ExpressionFunctions,14,0,0,2,0,0,0,0,16
psidnell_ofexport2.org.psidnell.omnifocus.sqlite.SQLiteDAO,0,0,0,0,0,0,0,1,1
psidnell_ofexport2.org.psidnell.omnifocus.model.ProjectInfo,1,0,0,1,0,0,0,0,2
mraad_Shapefile.com.esri.mapreduce.DBFRecordReader,1,0,0,1,0,0,0,0,2
mraad_Shapefile.com.esri.mapreduce.PointInputFormat,1,0,0,0,0,0,0,0,1
mraad_Shapefile.com.esri.mapreduce.PointFeatureInputFormat,1,0,0,0,0,0,0,0,1
mraad_Shapefile.com.esri.mapreduce.PolygonFeatureInputFormat,1,0,0,0,0,0,0,0,1
mraad_Shapefile.com.esri.mapreduce.PolygonInputFormat,1,0,0,0,0,0,0,0,1
mraad_Shapefile.com.esri.shp.ShpReader,5,0,0,5,0,0,0,0,10
mraad_Shapefile.com.esri.io.PointWritable,1,0,0,0,0,0,0,0,1
mraad_Shapefile.com.esri.io.PolylineMWritable,1,0,0,0,0,0,0,0,1
mraad_Shapefile.com.esri.io.PointFeatureWritable,1,0,0,0,0,0,0,0,1
mraad_Shapefile.com.esri.io.PolygonFeatureWritable,1,0,0,0,0,0,0,0,1
mraad_Shapefile.com.esri.io.PolygonWritable,1,0,0,0,0,0,0,0,1
mraad_Shapefile.com.esri.dbf.DBFReader,2,0,0,2,0,0,0,0,4
mraad_Shapefile.com.esri.mapred.DBFRecordReader,1,0,0,1,0,0,0,0,2
mraad_Shapefile.com.esri.mapred.PointInputFormat,1,0,0,0,0,0,0,0,1
mraad_Shapefile.com.esri.mapred.PointFeatureInputFormat,1,0,0,0,0,0,0,0,1
mraad_Shapefile.com.esri.mapred.PolygonFeatureInputFormat,1,0,0,0,0,0,0,0,1
mraad_Shapefile.com.esri.mapred.PolygonInputFormat,1,0,0,0,0,0,0,0,1
jherico_jovr.com.oculusvr.capi.Hmd,0,0,0,0,0,0,0,1,1
englishtown_vertx-when.com.englishtown.vertx.promises.RequestOptions,1,0,0,0,0,0,0,0,1
englishtown_vertx-when.com.englishtown.vertx.promises.impl.VertxExecutor,0,0,0,0,0,0,0,1,1
englishtown_vertx-when.com.englishtown.vertx.promises.impl.DefaultWhenEventBus,1,0,0,0,0,0,0,0,1
englishtown_vertx-when.com.englishtown.vertx.promises.impl.DefaultWhenHttpClient,0,0,0,0,0,0,0,17,17
englishtown_vertx-when.com.englishtown.vertx.promises.impl.DefaultWhenVertx,0,0,0,0,0,0,0,0,0
englishtown_vertx-when.com.englishtown.vertx.promises.WhenFileSystem,1,0,0,0,0,0,0,0,1
project-ncl_pnc.org.jboss.pnc.coordinator.notifications.buildTask.MessageSenderProvider,1,0,0,1,0,0,0,0,2
project-ncl_pnc.org.jboss.pnc.common.json.moduleconfig.SystemConfig,1,0,0,1,0,0,0,0,2
project-ncl_pnc.org.jboss.pnc.mock.repour.RepourResultMock,1,0,0,1,0,0,0,0,2
project-ncl_pnc.org.jboss.pnc.model.BuildConfigSetRecord,0,0,0,0,0,0,0,0,0
project-ncl_pnc.org.jboss.pnc.spi.datastore.Datastore,2,0,0,2,0,0,0,0,4
project-ncl_pnc.org.jboss.pnc.spi.coordinator.BuildCoordinator,1,0,0,1,0,0,0,0,2
project-ncl_pnc.org.jboss.pnc.model.BuildConfigurationAudited,4,0,0,4,0,0,0,0,8
project-ncl_pnc.org.jboss.pnc.test.util.Wait,1,0,0,1,0,3,0,0,5
project-ncl_pnc.org.jboss.pnc.model.BuildRecord,7,0,0,5,0,1,0,1,14
project-ncl_pnc.org.jboss.pnc.mock.model.builders.TestEntitiesFactory,3,0,0,3,0,0,0,1,7
project-ncl_pnc.org.jboss.pnc.mock.model.builders.TestProjectConfigurationBuilder,5,0,0,5,0,0,0,3,13
project-ncl_pnc.org.jboss.pnc.mock.datastore.DatastoreMock,2,0,0,2,0,0,0,0,4
project-ncl_pnc.org.jboss.pnc.coordinator.builder.datastore.DatastoreAdapter,2,0,0,2,0,0,0,0,4
project-ncl_pnc.org.jboss.pnc.model.BuildConfiguration,11,0,0,9,0,0,1,2,23
project-ncl_pnc.org.jboss.pnc.model.BuildConfigurationSet,0,0,0,0,0,0,0,0,0
project-ncl_pnc.org.jboss.pnc.spi.coordinator.BuildSetTask,2,0,0,2,0,1,0,0,5
project-ncl_pnc.org.jboss.pnc.common.json.moduleconfig.EnvironmentDriverModuleConfigBase,0,0,0,0,0,0,0,0,0
project-ncl_pnc.org.jboss.pnc.causewayclient.CausewayClient,0,0,0,0,0,0,0,0,0
project-ncl_pnc.org.jboss.pnc.causewayclient.DefaultCausewayClient,0,0,0,0,0,0,0,0,0
project-ncl_pnc.org.jboss.pnc.environment.openshift.OpenshiftStartedEnvironment,0,0,0,0,0,0,0,0,0
project-ncl_pnc.org.jboss.pnc.spi.environment.EnvironmentDriver,1,1,0,0,0,0,0,0,2
project-ncl_pnc.org.jboss.pnc.client.patch.PatchBase,0,0,0,0,0,0,0,0,0
project-ncl_pnc.org.jboss.pnc.termdbuilddriver.TermdBuildDriver,2,0,0,1,0,2,0,0,5
project-ncl_pnc.org.jboss.pnc.model.ProductMilestoneRelease,1,0,0,1,0,0,0,0,2
project-ncl_pnc.org.jboss.pnc.model.ProductMilestone,6,0,0,3,0,1,0,0,10
project-ncl_pnc.org.jboss.pnc.model.ProductVersion,3,0,0,3,0,0,0,0,6
project-ncl_pnc.org.jboss.pnc.spi.datastore.predicates.BuildConfigurationPredicates,1,0,0,1,0,0,0,0,2
project-ncl_pnc.org.jboss.pnc.model.Product,3,0,0,2,0,0,0,0,5
project-ncl_pnc.org.jboss.pnc.spi.datastore.repositories.BuildRecordRepository,1,0,0,1,0,0,0,0,2
project-ncl_pnc.org.jboss.pnc.spi.datastore.predicates.BuildRecordPredicates,0,0,0,0,0,0,0,0,0
project-ncl_pnc.org.jboss.pnc.spi.datastore.repositories.SequenceHandlerRepository,1,0,0,1,0,0,0,0,2
project-ncl_pnc.org.jboss.pnc.spi.datastore.repositories.api.ReadOnlyRepository,2,0,0,2,0,0,0,0,4
project-ncl_pnc.org.jboss.pnc.spi.datastore.predicates.RepositoryConfigurationPredicates,1,0,0,1,0,0,0,0,2
project-ncl_pnc.org.jboss.pnc.spi.datastore.repositories.api.SortInfo,5,0,0,5,0,0,0,0,10
project-ncl_pnc.org.jboss.pnc.spi.datastore.repositories.api.PageInfo,1,0,0,1,0,0,0,0,2
project-ncl_pnc.org.jboss.pnc.common.util.HttpUtils,1,0,0,0,0,0,0,0,1
project-ncl_pnc.org.jboss.pnc.common.util.StreamCollectors,0,0,0,0,0,0,0,0,0
project-ncl_pnc.org.jboss.pnc.common.gerrit.Gerrit,1,0,0,0,0,0,0,0,1
project-ncl_pnc.org.jboss.pnc.common.net.GitSCPUrl,9,0,0,9,0,0,0,0,18
project-ncl_pnc.org.jboss.pnc.common.json.JsonOutputConverterMapper,1,0,0,0,0,2,0,0,3
project-ncl_pnc.org.jboss.pnc.common.json.ModuleConfigJson,1,0,0,1,0,0,0,0,2
project-ncl_pnc.org.jboss.pnc.common.monitor.PollingMonitor,1,0,0,0,0,2,0,0,3
project-ncl_pnc.org.jboss.pnc.common.security.Md5,3,0,0,1,0,0,0,0,4
project-ncl_pnc.org.jboss.pnc.common.security.Sha256,3,0,0,1,0,0,0,0,4
project-ncl_pnc.org.jboss.pnc.common.util.StringUtils,7,0,0,0,0,0,0,0,7
project-ncl_pnc.org.jboss.pnc.common.util.TimeUtils,0,0,0,0,0,0,0,0,0
project-ncl_pnc.org.jboss.pnc.common.util.UrlUtils,3,0,0,0,0,0,0,0,3
project-ncl_pnc.org.jboss.pnc.spi.notifications.Notifier,1,0,0,0,0,0,0,0,1
project-ncl_pnc.org.jboss.pnc.notification.DefaultNotifier,0,0,0,0,0,0,0,0,0
project-ncl_pnc.org.jboss.pnc.notification.RequestParser,1,1,0,1,0,0,0,0,3
project-ncl_pnc.org.jboss.pnc.auth.KeycloakServiceClient,0,0,0,0,0,0,0,0,0
project-ncl_pnc.org.jboss.pnc.executor.servicefactories.BuildDriverFactory,0,0,0,0,0,0,0,0,0
project-ncl_pnc.org.jboss.pnc.model.utils.HibernateStatsUtils,0,0,0,0,0,0,0,0,0
project-ncl_pnc.org.jboss.pnc.model.Artifact,4,0,0,2,0,1,0,0,7
project-ncl_pnc.org.jboss.pnc.model.RepositoryConfiguration,2,0,0,2,0,0,0,0,4
project-ncl_pnc.org.jboss.pnc.common.json.moduleconfig.IndyRepoDriverModuleConfig,1,0,0,0,0,0,0,0,1
project-ncl_pnc.org.jboss.pnc.common.json.moduleconfig.JenkinsBuildDriverModuleConfig,1,0,0,1,0,0,0,0,2
project-ncl_pnc.org.jboss.pnc.common.Configuration,1,0,0,1,0,0,0,0,2
project-ncl_pnc.org.jboss.pnc.facade.providers.ArtifactProviderImpl,1,0,0,0,0,0,0,0,1
project-ncl_pnc.org.jboss.pnc.facade.providers.AbstractProvider,11,0,0,11,0,0,0,0,22
project-ncl_pnc.org.jboss.pnc.model.ArtifactAudited,2,0,0,2,0,0,0,0,4
project-ncl_pnc.org.jboss.pnc.facade.util.RepourClient,1,0,0,1,0,0,0,0,2
project-ncl_pnc.org.jboss.pnc.common.json.moduleconfig.ScmModuleConfig,1,1,0,0,0,0,0,0,2
project-ncl_pnc.org.jboss.pnc.facade.providers.SCMRepositoryProviderImpl,1,0,0,1,0,0,0,0,2
project-ncl_pnc.org.jboss.pnc.facade.providers.BuildProviderImpl,11,0,0,11,0,0,0,0,22
project-ncl_pnc.org.jboss.pnc.spi.coordinator.BuildTask,0,0,0,0,0,0,0,1,1
project-ncl_pnc.org.jboss.pnc.model.Project,1,0,0,1,0,0,0,0,2
project-ncl_pnc.org.jboss.pnc.facade.providers.UserProviderImpl,1,0,0,1,0,0,0,0,2
project-ncl_pnc.org.jboss.pnc.facade.providers.BuildConfigurationSupportedGenericParametersProviderImpl,1,0,0,0,0,0,0,0,1
project-ncl_pnc.org.jboss.pnc.facade.providers.EnvironmentProviderImpl,1,0,0,0,0,0,0,0,1
project-ncl_pnc.org.jboss.pnc.model.BuildEnvironment,1,0,0,1,0,0,0,0,2
project-ncl_pnc.org.jboss.pnc.facade.providers.GroupConfigurationProviderImpl,3,0,0,2,0,0,0,0,5
project-ncl_pnc.org.jboss.pnc.bpm.causeway.ProductMilestoneReleaseManager,0,0,0,0,0,0,0,2,2
project-ncl_pnc.org.jboss.pnc.model.ProductRelease,2,0,0,2,0,0,0,0,4
project-ncl_pnc.org.jboss.pnc.facade.providers.ProductReleaseProviderImpl,0,0,0,0,0,0,0,0,0
project-ncl_pnc.org.jboss.pnc.facade.providers.BuildConfigurationProviderImpl,4,0,0,3,0,0,0,0,7
project-ncl_pnc.org.jboss.pnc.facade.providers.GroupBuildProviderImpl,0,0,0,0,0,0,0,1,1
project-ncl_pnc.org.jboss.pnc.coordinator.maintenance.TemporaryBuildsCleanerAsyncInvoker,0,0,0,0,0,0,0,0,0
project-ncl_pnc.org.jboss.pnc.facade.providers.TargetRepositoryProviderImpl,1,0,0,0,0,0,0,0,1
project-ncl_pnc.org.jboss.pnc.model.TargetRepository,0,0,0,0,0,0,0,0,0
project-ncl_pnc.org.jboss.pnc.facade.util.MergeIterator,0,0,0,0,0,0,0,0,0
project-ncl_pnc.org.jboss.pnc.facade.deliverables.DeliverableAnalyzerManagerImpl,0,0,0,0,0,0,0,1,1
project-ncl_pnc.org.jboss.pnc.model.Base32LongID,0,0,0,0,0,0,0,1,1
project-ncl_pnc.org.jboss.pnc.facade.rsql.RSQLProducerImpl,11,0,0,0,0,0,0,0,11
project-ncl_pnc.org.jboss.pnc.bpm.model.BuildResultRest,0,0,0,0,0,0,0,2,2
project-ncl_pnc.org.jboss.pnc.bpm.RestConnector,1,0,0,1,0,0,0,0,2
project-ncl_pnc.org.jboss.pnc.mock.repositorymanager.RepositoryManagerResultMock,1,0,0,1,0,0,0,0,2
project-ncl_pnc.org.jboss.pnc.mock.spi.BuildExecutionConfigurationMock,0,0,0,0,0,0,0,0,0
project-ncl_pnc.org.jboss.pnc.mock.spi.BuildResultMock,1,0,0,1,0,0,0,0,2
project-ncl_pnc.org.jboss.pnc.spi.executor.BuildExecutionConfiguration,2,0,0,1,0,1,0,0,4
project-ncl_pnc.org.jboss.pnc.bpm.BpmManager,1,0,0,1,0,0,0,0,2
project-ncl_pnc.org.jboss.pnc.messaging.spi.BuildStatusChanged,0,0,0,0,0,0,0,0,0
project-ncl_pnc.org.jboss.pnc.messaging.spi.Message,0,0,0,0,0,0,0,0,0
project-ncl_pnc.org.jboss.pnc.spi.repositorymanager.model.RepositorySession,11,0,0,10,0,0,0,0,21
project-ncl_pnc.org.jboss.pnc.spi.repositorymanager.model.RepositoryConnectionInfo,7,0,0,7,0,0,0,0,14
project-ncl_pnc.org.jboss.pnc.spi.repositorymanager.ArtifactRepository,1,0,0,1,0,0,0,0,2
project-ncl_pnc.org.jboss.pnc.spi.repositorymanager.RepositoryManager,1,1,0,0,0,0,0,0,2
project-ncl_pnc.org.jboss.pnc.rest.jackson.JacksonProvider,0,0,0,0,0,0,0,4,4
project-ncl_pnc.org.jboss.pnc.client.ProjectClient,6,0,0,3,0,0,0,1,10
project-ncl_pnc.org.jboss.pnc.client.BuildClient,14,0,0,8,0,1,0,0,23
project-ncl_pnc.org.jboss.pnc.client.BuildConfigurationClient,26,2,0,20,0,0,0,2,50
project-ncl_pnc.org.jboss.pnc.client.GroupConfigurationClient,5,0,0,5,0,0,0,0,10
project-ncl_pnc.org.jboss.pnc.restclient.AdvancedBuildConfigurationClient,0,0,0,0,0,0,0,0,0
project-ncl_pnc.org.jboss.pnc.client.patch.ObjectMapperProvider,1,0,0,1,0,0,0,0,2
project-ncl_pnc.org.jboss.pnc.coordinator.maintenance.TemporaryBuildsCleaner,4,0,0,4,0,0,0,0,8
project-ncl_pnc.org.jboss.pnc.facade.providers.api.BuildProvider,0,0,0,0,0,0,0,0,0
project-ncl_pnc.org.jboss.pnc.client.EnvironmentClient,3,0,0,2,0,0,0,1,6
project-ncl_pnc.org.jboss.pnc.client.ArtifactClient,23,0,0,11,0,0,0,0,34
project-ncl_pnc.org.jboss.pnc.common.util.IoUtils,0,0,0,0,0,0,0,3,3
project-ncl_pnc.org.jboss.pnc.common.json.JsonUtils,2,0,0,0,0,0,0,0,2
project-ncl_pnc.org.jboss.pnc.client.RemoteCollection,8,0,0,8,0,0,0,0,16
project-ncl_pnc.org.jboss.pnc.common.concurrent.MDCExecutors,0,0,0,0,0,1,0,0,1
project-ncl_pnc.org.jboss.pnc.client.ProductReleaseClient,3,0,0,2,0,0,0,0,5
project-ncl_pnc.org.jboss.pnc.client.GroupBuildClient,1,0,0,0,0,0,0,0,1
project-ncl_pnc.org.jboss.pnc.client.OperationClient,3,0,0,3,0,0,0,0,6
project-ncl_pnc.org.jboss.pnc.client.UserClient,1,0,0,0,0,0,0,0,1
project-ncl_pnc.org.jboss.pnc.client.ProductVersionClient,10,0,0,6,0,0,0,0,16
project-ncl_pnc.org.jboss.pnc.client.ProductMilestoneClient,6,0,0,3,0,0,0,0,9
project-ncl_pnc.org.jboss.pnc.client.ProductClient,6,0,0,4,0,0,0,0,10
project-ncl_pnc.org.jboss.pnc.client.SCMRepositoryClient,3,0,0,2,0,0,0,0,5
project-ncl_pnc.org.jboss.pnc.mock.dto.BuildMock,0,0,0,0,0,0,0,1,1
project-ncl_pnc.org.jboss.pnc.restclient.websocket.WebSocketClient,3,0,0,3,0,0,0,0,6
Cloudslab_cloudsim.org.cloudbus.cloudsim.Pe,6,0,0,4,0,0,0,0,10
Cloudslab_cloudsim.org.cloudbus.cloudsim.Cloudlet,4,0,0,4,0,0,0,0,8
Cloudslab_cloudsim.org.cloudbus.cloudsim.VmScheduler,3,0,0,3,0,0,0,0,6
Cloudslab_cloudsim.org.cloudbus.cloudsim.VmSchedulerTimeShared,4,0,0,4,0,0,0,0,8
Cloudslab_cloudsim.org.cloudbus.cloudsim.Vm,8,0,0,8,0,0,0,0,16
Cloudslab_cloudsim.org.cloudbus.cloudsim.UtilizationModelStochastic,1,0,0,0,0,0,0,0,1
Cloudslab_cloudsim.org.cloudbus.cloudsim.UtilizationModelPlanetLabInMemory,1,0,0,0,0,0,0,0,1
Cloudslab_cloudsim.org.cloudbus.cloudsim.HostDynamicWorkload,2,0,0,2,0,0,0,0,4
Cloudslab_cloudsim.org.cloudbus.cloudsim.Host,4,0,0,2,0,0,0,0,6
Cloudslab_cloudsim.org.cloudbus.cloudsim.CloudletSchedulerDynamicWorkload,1,0,0,1,0,0,0,0,2
Cloudslab_cloudsim.org.cloudbus.cloudsim.CloudletScheduler,0,0,0,0,0,0,0,0,0
Cloudslab_cloudsim.org.cloudbus.cloudsim.UtilizationModel,0,0,0,0,0,0,0,7,7
Cloudslab_cloudsim.org.cloudbus.cloudsim.Log,3,0,0,1,0,0,0,0,4
Cloudslab_cloudsim.org.cloudbus.cloudsim.util.MathUtil,2,0,0,0,0,0,0,0,2
Cloudslab_cloudsim.org.cloudbus.cloudsim.util.WorkloadModel,1,0,0,1,0,0,0,0,2
Cloudslab_cloudsim.org.cloudbus.cloudsim.power.PowerVmSelectionPolicyMaximumCorrelation,0,0,0,0,0,0,0,0,0
Cloudslab_cloudsim.org.cloudbus.cloudsim.power.PowerHost,1,0,0,1,0,1,0,0,3
Cloudslab_cloudsim.org.cloudbus.cloudsim.power.models.PowerModelLinear,1,0,0,0,0,0,1,1,3
Cloudslab_cloudsim.org.cloudbus.cloudsim.power.models.PowerModel,1,0,0,0,0,0,0,0,1
Cloudslab_cloudsim.org.cloudbus.cloudsim.power.models.PowerModelSquare,1,0,0,0,0,0,1,1,3
Cloudslab_cloudsim.org.cloudbus.cloudsim.power.models.PowerModelCubic,1,0,0,0,0,0,1,1,3
Cloudslab_cloudsim.org.cloudbus.cloudsim.power.models.PowerModelSqrt,1,0,0,0,0,0,1,1,3
Cloudslab_cloudsim.org.cloudbus.cloudsim.provisioners.PeProvisioner,2,0,0,2,0,0,0,0,4
Cloudslab_cloudsim.org.cloudbus.cloudsim.provisioners.BwProvisioner,0,0,0,0,0,0,0,0,0
Cloudslab_cloudsim.org.cloudbus.cloudsim.provisioners.BwProvisionerSimple,3,0,0,3,0,0,0,0,6
Cloudslab_cloudsim.org.cloudbus.cloudsim.provisioners.RamProvisioner,0,0,0,0,0,0,0,0,0
Cloudslab_cloudsim.org.cloudbus.cloudsim.provisioners.RamProvisionerSimple,3,0,0,3,0,0,0,0,6
Cloudslab_cloudsim.org.cloudbus.cloudsim.provisioners.PeProvisionerSimple,3,0,0,3,0,0,0,0,6
edwardcapriolo_nibiru.io.teknek.nibiru.coordinator.MajorityValueResultMerger,1,0,0,1,0,0,0,0,2
edwardcapriolo_nibiru.io.teknek.nibiru.client.KeyValueClient,0,0,0,0,0,0,0,0,0
edwardcapriolo_nibiru.io.teknek.nibiru.Server,3,0,0,3,0,0,0,2,8
edwardcapriolo_nibiru.io.teknek.nibiru.client.MetaDataClient,1,0,0,1,0,0,0,0,2
edwardcapriolo_nibiru.io.teknek.nibiru.Configuration,4,0,0,4,0,0,0,1,9
edwardcapriolo_nibiru.io.teknek.nibiru.Token,0,0,0,0,0,0,0,0,0
edwardcapriolo_nibiru.io.teknek.nibiru.Keyspace,0,0,0,0,0,0,0,0,0
edwardcapriolo_nibiru.io.teknek.nibiru.engine.AbstractMemtable,3,0,0,3,0,0,1,0,7
edwardcapriolo_nibiru.io.teknek.nibiru.engine.SsTable,3,0,0,3,0,0,0,0,6
edwardcapriolo_nibiru.io.teknek.nibiru.engine.atom.ColumnKey,1,0,0,0,0,0,0,0,1
edwardcapriolo_nibiru.io.teknek.nibiru.io.CountingBufferedOutputStream,1,0,0,1,0,0,0,0,2
edwardcapriolo_nibiru.io.teknek.nibiru.engine.atom.ColumnValue,2,0,0,2,0,0,0,0,4
edwardcapriolo_nibiru.io.teknek.nibiru.MetaDataManager,1,0,0,1,0,0,0,0,2
edwardcapriolo_nibiru.io.teknek.nibiru.coordinator.RpcCoordinator,0,0,0,0,0,0,0,0,0
edwardcapriolo_nibiru.io.teknek.nibiru.client.RpcClient,1,0,0,0,0,0,0,0,1
edwardcapriolo_nibiru.io.teknek.nibiru.client.InternodeClient,1,0,0,1,0,0,0,0,2
.com.mscharhag.oleaster.runner.suite.Suite,0,0,0,0,0,0,0,0,0
calrissian_flowmix.org.calrissian.flowmix.core.support.Utils,0,0,0,0,0,0,0,0,0
calrissian_flowmix.org.calrissian.flowmix.api.builder.FlowBuilder,12,0,0,12,0,0,2,0,26
calrissian_flowmix.org.calrissian.flowmix.api.aggregator.AvgAggregator,0,0,0,0,0,0,0,0,0
calrissian_flowmix.org.calrissian.flowmix.api.aggregator.SumAggregator,0,0,0,0,0,0,0,0,0
calrissian_flowmix.org.calrissian.flowmix.api.aggregator.CountAggregator,0,0,0,0,0,0,0,0,0
google_google-oauth-java-client.com.google.api.client.extensions.jetty.auth.oauth2.LocalServerReceiver,2,0,0,2,0,0,0,12,16
google_google-oauth-java-client.com.google.api.client.auth.oauth.OAuthHmacSha256Signer,0,0,0,0,0,0,0,0,0
spotify_docker-maven-plugin.com.spotify.docker.CompositeImageName,6,0,0,5,0,0,0,0,11
spotify_docker-maven-plugin.com.spotify.docker.Utils,0,0,0,0,0,0,0,2,2
spotify_docker-maven-plugin.com.spotify.docker.Git,0,0,0,0,0,0,0,0,0
spotify_docker-maven-plugin.com.spotify.docker.AbstractDockerMojo,2,0,0,0,0,0,0,1,3
cecom_pomutils.de.oppermann.pomutils.select.PersistentVersionSelector,4,0,0,3,0,0,0,0,7
cecom_pomutils.de.oppermann.pomutils.select.StreamVersionSelector,0,0,0,0,0,0,0,0,0
HolmesNL_kafka-spout.nl.minvenj.nfi.storm.kafka.fail.FailHandler,0,0,0,0,0,0,0,3,3
HolmesNL_kafka-spout.nl.minvenj.nfi.storm.kafka.util.KafkaMessageId,2,0,0,0,0,0,0,0,2
HolmesNL_kafka-spout.nl.minvenj.nfi.storm.kafka.fail.ReliableFailHandler,1,0,0,1,0,0,0,0,2
HolmesNL_kafka-spout.nl.minvenj.nfi.storm.kafka.util.ConfigUtils,12,0,0,1,0,2,0,3,18
HolmesNL_kafka-spout.nl.minvenj.nfi.storm.kafka.KafkaSpout,7,0,0,2,0,1,0,4,14
flaxsearch_luwak.uk.co.flax.luwak.InputDocument,10,0,0,6,0,2,0,2,20
flaxsearch_luwak.uk.co.flax.luwak.benchmark.BenchmarkResults,1,0,0,1,0,0,0,0,2
flaxsearch_luwak.uk.co.flax.luwak.Monitor,8,0,0,8,0,0,0,0,16
flaxsearch_luwak.uk.co.flax.luwak.presearcher.PresearcherComponent,1,0,0,0,0,0,0,0,1
flaxsearch_luwak.uk.co.flax.luwak.termextractor.QueryAnalyzer,12,0,0,6,0,0,0,0,18
flaxsearch_luwak.uk.co.flax.luwak.DocumentBatch,2,0,0,2,0,0,0,0,4
flaxsearch_luwak.uk.co.flax.luwak.QueryIndex,2,0,0,2,0,0,0,0,4
flaxsearch_luwak.uk.co.flax.luwak.QueryIndexConfiguration,2,0,0,2,0,1,0,0,5
flaxsearch_luwak.uk.co.flax.luwak.ConcurrentQueryLoader,2,0,0,2,0,0,0,0,4
flaxsearch_luwak.uk.co.flax.luwak.queryparsers.FlexibleLuceneQueryParser,2,0,0,2,0,0,0,0,4
flaxsearch_luwak.uk.co.flax.luwak.MonitorQuery,1,0,0,0,0,0,0,0,1
flaxsearch_luwak.uk.co.flax.luwak.Presearcher,1,0,0,1,0,1,0,0,3
flaxsearch_luwak.uk.co.flax.luwak.QueryDecomposer,1,0,0,0,0,0,0,0,1
flaxsearch_luwak.uk.co.flax.luwak.termextractor.querytree.QueryTree,0,0,0,0,0,0,0,0,0
flaxsearch_luwak.uk.co.flax.luwak.termextractor.weights.TermWeightor,3,0,0,0,0,0,0,0,3
flaxsearch_luwak.uk.co.flax.luwak.util.ForceNoBulkScoringQuery,2,0,0,1,0,0,0,0,3
flaxsearch_luwak.uk.co.flax.luwak.util.SpanRewriter,1,0,0,1,0,0,0,0,2
flaxsearch_luwak.uk.co.flax.luwak.matchers.HighlightsMatch,2,0,0,2,0,0,0,0,4
flaxsearch_luwak.uk.co.flax.luwak.queryparsers.LuceneQueryParser,0,0,0,0,0,1,0,0,1
flaxsearch_luwak.uk.co.flax.luwak.matchers.ExplainingMatch,1,0,0,0,0,0,0,0,1
edwardcapriolo_farsandra.io.teknek.farsandra.Farsandra,5,0,0,5,0,0,1,0,11
edwardcapriolo_farsandra.io.teknek.farsandra.config.ConfigHolder,2,0,0,0,0,0,0,0,2
scratches_spring-boot-legacy.org.springframework.boot.legacy.context.web.SpringBootContextLoaderListener,0,0,0,0,0,0,0,0,0
mrniko_redisson.org.redisson.mybatis.RedissonCache,1,0,0,1,0,0,0,0,2
mrniko_redisson.org.redisson.Redisson,12,0,0,12,0,2,0,4,30
mrniko_redisson.org.redisson.spring.data.connection.RedissonConnectionFactory,2,0,0,0,0,0,0,21,23
mrniko_redisson.org.redisson.spring.data.connection.RedissonConnection,96,0,0,96,0,0,0,22,214
mrniko_redisson.org.redisson.spring.data.connection.RedissonReactiveRedisClusterConnection,24,24,0,24,0,0,0,0,72
mrniko_redisson.org.redisson.spring.data.connection.RedissonClusterConnection,30,20,0,0,0,0,0,30,80
mrniko_redisson.org.redisson.config.SingleServerConfig,19,0,0,19,0,0,0,3,41
mrniko_redisson.org.redisson.spring.data.connection.PropertiesDecoder,1,0,0,0,0,0,0,0,1
mrniko_redisson.org.redisson.api.RedissonClient,31,1,0,31,0,7,0,1,71
mrniko_redisson.org.redisson.api.RSetCache,8,0,0,7,0,0,0,0,15
mrniko_redisson.org.redisson.api.RDestroyable,19,0,0,0,0,0,0,5,24
mrniko_redisson.org.redisson.api.RObject,26,0,0,19,0,1,0,0,46
mrniko_redisson.org.redisson.api.RExpirable,2,0,0,2,0,0,0,0,4
mrniko_redisson.org.redisson.api.RDoubleAdder,2,0,0,2,0,0,0,0,4
mrniko_redisson.org.redisson.api.RAtomicDouble,7,0,0,7,0,0,0,0,14
mrniko_redisson.org.redisson.api.RRemoteService,1,0,0,0,0,0,0,0,1
mrniko_redisson.org.redisson.api.RKeys,1,0,0,1,0,0,0,0,2
mrniko_redisson.org.redisson.api.RBlockingQueueReactive,6,0,0,0,0,0,0,0,6
mrniko_redisson.org.redisson.api.RCollectionReactive,28,0,0,9,0,0,0,0,37
mrniko_redisson.org.redisson.api.RScoredSortedSetReactive,10,0,0,6,0,0,0,0,16
mrniko_redisson.org.redisson.api.RLexSortedSetReactive,6,0,0,0,0,0,0,0,6
mrniko_redisson.org.redisson.api.RAtomicLongReactive,5,0,0,5,0,0,0,0,10
mrniko_redisson.org.redisson.api.BatchOptions,2,0,0,2,0,0,0,0,4
mrniko_redisson.org.redisson.api.RRateLimiter,10,2,0,10,0,0,0,0,22
mrniko_redisson.org.redisson.config.Config,3,0,0,3,0,0,0,10,16
mrniko_redisson.org.redisson.config.SentinelServersConfig,0,0,0,0,0,0,0,0,0
mrniko_redisson.org.redisson.config.MasterSlaveServersConfig,0,0,0,0,0,0,0,0,0
mrniko_redisson.org.redisson.api.RLexSortedSet,12,0,0,6,0,0,0,0,18
mrniko_redisson.org.redisson.config.BaseMasterSlaveServersConfig,10,1,0,10,0,1,0,1,23
mrniko_redisson.org.redisson.api.RPatternTopic,1,0,0,0,0,0,0,0,1
mrniko_redisson.org.redisson.api.RSortable,39,0,0,0,0,0,0,0,39
mrniko_redisson.org.redisson.api.RSet,5,0,0,0,0,0,0,0,5
mrniko_redisson.org.redisson.api.RCollectionAsync,1,0,0,0,0,0,0,0,1
mrniko_redisson.org.redisson.api.RList,5,0,0,2,0,0,0,0,7
mrniko_redisson.org.redisson.api.RQueueReactive,4,0,0,4,0,0,0,0,8
mrniko_redisson.org.redisson.config.BaseConfig,1,0,0,1,0,0,0,1,3
mrniko_redisson.org.redisson.api.RLock,27,3,0,4,0,0,0,0,34
mrniko_redisson.org.redisson.RedissonFairLock,3,0,0,3,0,0,0,0,6
mrniko_redisson.org.redisson.api.RObjectReactive,3,0,0,3,0,0,0,0,6
mrniko_redisson.org.redisson.api.RListReactive,4,0,0,0,0,0,0,0,4
mrniko_redisson.org.redisson.api.RLongAdder,2,0,0,2,0,0,0,0,4
mrniko_redisson.org.redisson.api.RCountDownLatch,4,0,0,3,0,2,0,0,9
mrniko_redisson.org.redisson.api.RBucketReactive,6,0,0,4,0,0,0,0,10
mrniko_redisson.org.redisson.api.RBucket,22,0,0,15,0,0,0,0,37
mrniko_redisson.org.redisson.api.RReliableTopic,4,0,0,2,0,0,0,0,6
mrniko_redisson.org.redisson.api.RTimeSeries,9,0,0,6,0,0,0,0,15
mrniko_redisson.org.redisson.api.LocalCachedMapOptions,34,0,0,24,0,0,0,1,59
mrniko_redisson.org.redisson.codec.JsonJacksonCodec,2,0,0,1,0,0,0,0,3
mrniko_redisson.org.redisson.api.RMap,61,2,0,13,0,1,0,1,78
mrniko_redisson.org.redisson.api.RAtomicLong,7,0,0,7,0,0,0,0,14
mrniko_redisson.org.redisson.api.RDeque,1,0,0,1,0,0,0,0,2
mrniko_redisson.org.redisson.api.RQueue,4,0,0,3,0,0,0,0,7
mrniko_redisson.org.redisson.RedissonRedLock,1,0,0,1,0,0,0,0,2
mrniko_redisson.org.redisson.api.RFunction,5,0,0,5,0,0,0,0,10
mrniko_redisson.org.redisson.api.RMultimap,28,0,0,9,0,0,0,0,37
mrniko_redisson.org.redisson.api.RListMultimap,1,0,0,1,0,0,0,0,2
mrniko_redisson.org.redisson.api.RHyperLogLog,1,0,0,0,0,0,0,0,1
mrniko_redisson.org.redisson.api.RDequeReactive,3,0,0,1,0,0,0,0,4
mrniko_redisson.org.redisson.api.RRingBuffer,3,0,0,3,0,0,0,0,6
mrniko_redisson.org.redisson.api.RBinaryStream,6,0,0,1,0,0,0,0,7
mrniko_redisson.org.redisson.api.RMapCache,1,0,0,1,0,0,0,1,3
mrniko_redisson.org.redisson.api.MapOptions,1,0,0,1,0,0,0,0,2
mrniko_redisson.org.redisson.api.RReadWriteLock,13,0,0,10,0,0,0,3,26
mrniko_redisson.org.redisson.api.RBlockingDequeReactive,6,0,0,2,0,0,0,0,8
mrniko_redisson.org.redisson.api.RBinaryStreamReactive,0,0,0,0,0,0,0,0,0
mrniko_redisson.org.redisson.api.RBatch,2,0,0,2,0,0,0,0,4
mrniko_redisson.org.redisson.api.RScript,3,0,0,1,0,0,0,0,4
mrniko_redisson.org.redisson.api.RLockRx,1,0,0,1,0,0,0,0,2
mrniko_redisson.org.redisson.api.RBlockingQueue,2,0,0,2,0,0,0,0,4
mrniko_redisson.org.redisson.api.RScriptReactive,2,0,0,1,0,0,0,0,3
mrniko_redisson.org.redisson.api.redisnode.RedisSingle,2,0,0,1,0,0,0,0,3
mrniko_redisson.org.redisson.api.redisnode.RedisNode,2,0,0,2,0,0,0,0,4
mrniko_redisson.org.redisson.api.RTopicReactive,0,0,0,0,0,0,0,0,0
mrniko_redisson.org.redisson.api.RStream,23,0,0,22,0,0,0,1,46
mrniko_redisson.org.redisson.api.stream.StreamTrimLimitArgs,4,0,0,4,0,0,0,0,8
mrniko_redisson.org.redisson.api.stream.StreamReadArgs,0,0,0,0,0,0,0,0,0
mrniko_redisson.org.redisson.api.StreamMessageId,1,0,0,1,0,0,0,0,2
mrniko_redisson.org.redisson.api.RBoundedBlockingQueue,24,0,0,4,0,5,0,0,33
mrniko_redisson.org.redisson.api.RTransferQueue,0,0,0,0,0,0,0,0,0
mrniko_redisson.org.redisson.api.RKeysReactive,0,0,0,0,0,0,0,0,0
mrniko_redisson.org.redisson.api.HostPortNatMapper,1,0,0,1,0,0,0,0,2
mrniko_redisson.org.redisson.api.RSortedSet,2,0,0,0,0,0,0,0,2
mrniko_redisson.org.redisson.api.RLockReactive,2,0,0,2,0,0,0,0,4
mrniko_redisson.org.redisson.api.RMapReactive,15,4,0,2,0,0,0,0,21
mrniko_redisson.org.redisson.api.RExpirableReactive,0,0,0,0,0,0,0,0,0
mrniko_redisson.org.redisson.api.RMapCacheReactive,3,0,0,0,0,0,0,0,3
mrniko_redisson.org.redisson.api.RBuckets,1,0,0,0,0,0,0,0,1
mrniko_redisson.org.redisson.api.RTimeSeriesReactive,0,0,0,0,0,0,0,0,0
mrniko_redisson.org.redisson.client.RedisClient,4,0,0,2,0,0,0,1,7
mrniko_redisson.org.redisson.api.RHyperLogLogReactive,1,0,0,0,0,0,0,0,1
mrniko_redisson.org.redisson.api.RSetReactive,2,0,0,0,0,0,0,0,2
mrniko_redisson.org.redisson.RedissonMultiLock,2,0,0,2,0,0,0,0,4
mrniko_redisson.org.redisson.api.RIdGenerator,1,0,0,1,0,0,0,0,2
mrniko_redisson.org.redisson.api.RScoredSortedSet,41,0,0,10,0,0,0,0,51
mrniko_redisson.org.redisson.client.protocol.Encoder,0,0,0,0,0,0,0,0,0
mrniko_redisson.org.redisson.api.RPermitExpirableSemaphore,8,0,0,8,0,0,0,0,16
mrniko_redisson.org.redisson.api.condition.Conditions,8,0,0,4,0,0,0,0,12
mrniko_redisson.org.redisson.api.RLiveObjectService,4,0,0,3,0,0,0,0,7
mrniko_redisson.org.redisson.liveobject.resolver.DefaultNamingScheme,2,0,0,0,0,0,0,0,2
mrniko_redisson.org.redisson.api.RLiveObject,1,0,0,0,0,1,0,0,2
mrniko_redisson.org.redisson.api.RSetCacheReactive,3,0,0,0,0,0,0,0,3
mrniko_redisson.org.redisson.api.RJsonBucket,13,0,0,11,0,0,0,0,24
mrniko_redisson.org.redisson.api.RSetMultimap,2,0,0,1,0,0,0,0,3
mrniko_redisson.org.redisson.api.RSemaphore,10,0,0,10,0,0,0,1,21
mrniko_redisson.org.redisson.api.RPriorityQueue,0,0,0,0,0,0,0,0,0
mrniko_redisson.org.redisson.api.RLockAsync,3,3,0,2,0,0,0,0,8
mrniko_redisson.org.redisson.api.GeoPosition,3,0,0,3,0,0,0,0,6
mrniko_redisson.org.redisson.api.RGeo,28,0,0,28,0,0,0,0,56
mrniko_redisson.org.redisson.api.RBitSetReactive,5,0,0,4,0,0,0,0,9
mrniko_redisson.org.redisson.api.RBloomFilter,6,0,0,6,0,0,0,0,12
mrniko_redisson.org.redisson.api.RBitSet,11,0,0,9,0,0,0,0,20
mrniko_redisson.org.redisson.api.RTimeSeriesRx,0,0,0,0,0,0,0,0,0
mrniko_redisson.org.redisson.api.RBlockingDequeRx,6,0,0,2,0,0,0,0,8
mrniko_redisson.org.redisson.api.RBlockingQueueRx,4,0,0,0,0,0,0,0,4
mrniko_redisson.org.redisson.api.RCollectionRx,25,0,0,9,0,0,0,0,34
mrniko_redisson.org.redisson.api.RSetRx,2,0,0,0,0,0,0,0,2
mrniko_redisson.org.redisson.api.RScoredSortedSetRx,10,0,0,6,0,0,0,0,16
mrniko_redisson.org.redisson.api.RLexSortedSetRx,6,0,0,0,0,0,0,0,6
mrniko_redisson.org.redisson.api.RListRx,4,0,0,0,0,0,0,0,4
mrniko_redisson.org.redisson.api.RSetCacheRx,3,0,0,0,0,0,0,0,3
mrniko_redisson.org.redisson.api.RExpirableRx,0,0,0,0,0,0,0,0,0
mrniko_redisson.org.redisson.api.RDequeRx,3,0,0,1,0,0,0,0,4
mrniko_redisson.org.redisson.api.RQueueRx,2,0,0,2,0,0,0,0,4
mrniko_redisson.org.redisson.api.RTopicRx,0,0,0,0,0,0,0,1,1
mrniko_redisson.org.redisson.api.RScriptRx,2,0,0,1,0,0,0,0,3
mrniko_redisson.org.redisson.api.RMapRx,15,4,0,2,0,0,0,0,21
mrniko_redisson.org.redisson.api.RMapCacheRx,3,0,0,0,0,0,0,0,3
mrniko_redisson.org.redisson.api.RKeysRx,0,0,0,0,0,0,0,0,0
mrniko_redisson.org.redisson.misc.LogHelper,5,0,0,0,0,0,0,0,5
mrniko_redisson.org.redisson.misc.CompositeIterable,5,0,0,0,0,0,0,0,5
mrniko_redisson.org.redisson.cache.ReferenceCacheMap,4,0,0,0,0,0,0,0,4
mrniko_redisson.org.redisson.jcache.configuration.RedissonConfiguration,2,0,0,0,0,0,0,0,2
mrniko_redisson.org.redisson.codec.TypedJsonJacksonCodec,0,0,0,0,0,0,0,0,0
mrniko_redisson.org.redisson.codec.MarshallingCodec,2,0,0,1,0,0,0,0,3
mrniko_redisson.org.redisson.codec.SnappyCodecV2,0,0,0,0,0,0,0,1,1
mrniko_redisson.org.redisson.client.protocol.decoder.ClusterNodesDecoder,1,0,0,1,0,0,0,0,2
mrniko_redisson.org.redisson.api.RedissonReactiveClient,1,0,0,0,0,0,0,0,1
mrniko_redisson.org.redisson.api.RScheduledExecutorService,15,0,0,13,0,0,0,0,28
mrniko_redisson.org.redisson.config.RedissonNodeFileConfig,2,0,0,2,0,1,0,0,5
mrniko_redisson.org.redisson.api.ExecutorOptions,4,0,0,4,0,0,0,0,8
mrniko_redisson.org.redisson.api.RExecutorFuture,0,0,0,0,0,0,0,0,0
mrniko_redisson.org.redisson.api.RExecutorService,4,0,0,1,0,0,0,0,5
mrniko_redisson.org.redisson.api.RExecutorBatchFuture,1,0,0,0,0,0,0,0,1
mrniko_redisson.org.redisson.api.WorkerOptions,0,0,0,0,0,0,0,0,0
mrniko_redisson.org.redisson.api.TransactionOptions,40,0,0,40,0,0,0,0,80
mrniko_redisson.org.redisson.micronaut.cache.RedissonSyncCache,2,0,0,0,0,0,0,0,2
mrniko_redisson.org.redisson.micronaut.session.RedissonSession,6,0,0,6,0,0,0,0,12
webdriverextensions_webdriverextensions.com.github.webdriverextensions.Bot,1,0,0,1,0,0,22,78,102
webdriverextensions_webdriverextensions.com.github.webdriverextensions.junitrunner.WebDriverRunner,1,0,0,0,0,0,0,0,1
webdriverextensions_webdriverextensions.com.github.webdriverextensions.internal.junitrunner.ScreenshotsPathLoader,0,0,0,0,0,1,0,0,1
webdriverextensions_webdriverextensions.com.github.webdriverextensions.internal.utils.WebDriverUtils,0,0,0,0,0,0,0,0,0
couchbase_couchbase-jvm-core.com.couchbase.client.core.logging.RedactableArgument,3,0,0,3,0,0,0,0,6
couchbase_couchbase-jvm-core.com.couchbase.client.core.state.Stateful,6,0,0,6,0,2,0,0,14
couchbase_couchbase-jvm-core.com.couchbase.client.core.service.AbstractOnDemandService,1,0,0,1,0,0,0,0,2
couchbase_couchbase-jvm-core.com.couchbase.client.core.service.AbstractLazyService,2,0,0,2,0,0,0,0,4
couchbase_couchbase-jvm-core.com.couchbase.client.core.service.PooledService,21,0,0,16,0,0,0,1,38
couchbase_couchbase-jvm-core.com.couchbase.client.core.state.AbstractStateMachine,10,0,0,2,0,0,0,0,12
couchbase_couchbase-jvm-core.com.couchbase.client.core.endpoint.Endpoint,4,0,0,4,0,0,0,0,8
couchbase_couchbase-jvm-core.com.couchbase.client.core.service.strategies.SelectionStrategy,0,0,0,0,0,0,0,0,0
couchbase_couchbase-jvm-core.com.couchbase.client.core.service.strategies.RoundRobinSelectionStrategy,1,0,0,1,0,0,0,0,2
couchbase_couchbase-jvm-core.com.couchbase.client.core.event.EventBus,2,0,0,2,0,0,0,0,4
couchbase_couchbase-jvm-core.com.couchbase.client.core.CouchbaseCore,0,0,0,0,0,0,0,0,0
couchbase_couchbase-jvm-core.com.couchbase.client.core.tracing.RingBufferMonitor,0,0,0,0,0,0,0,0,0
couchbase_couchbase-jvm-core.com.couchbase.client.core.logging.CouchbaseLogger,1,0,0,1,0,3,0,4,9
couchbase_couchbase-jvm-core.com.couchbase.client.core.RequestHandler,5,0,0,4,0,1,0,1,11
couchbase_couchbase-jvm-core.com.couchbase.client.core.ResponseHandler,2,0,0,2,0,0,0,0,4
couchbase_couchbase-jvm-core.com.couchbase.client.core.state.AbstractStateZipper,1,0,0,1,0,0,0,0,2
couchbase_couchbase-jvm-core.com.couchbase.client.core.utils.Base64,2,0,0,0,0,0,0,0,2
couchbase_couchbase-jvm-core.com.couchbase.client.core.utils.NetworkAddress,5,0,0,5,0,0,0,0,10
couchbase_couchbase-jvm-core.com.couchbase.client.core.utils.ConnectionString,7,0,0,7,0,0,0,0,14
couchbase_couchbase-jvm-core.com.couchbase.client.core.utils.UnicastAutoReleaseSubject,4,0,0,0,0,2,0,0,6
couchbase_couchbase-jvm-core.com.couchbase.client.core.utils.yasjl.JsonPointerTree,2,0,0,1,0,0,0,0,3
couchbase_couchbase-jvm-core.com.couchbase.client.core.utils.yasjl.JsonPointer,6,0,0,4,0,0,0,0,10
couchbase_couchbase-jvm-core.com.couchbase.client.core.tracing.ThresholdLogTracer,7,0,0,7,0,0,0,0,14
couchbase_couchbase-jvm-core.com.couchbase.client.core.tracing.ThresholdLogReporter,1,0,0,1,0,0,0,0,2
couchbase_couchbase-jvm-core.com.couchbase.client.core.env.DefaultCoreEnvironment,11,0,0,11,0,0,1,0,23
couchbase_couchbase-jvm-core.com.couchbase.client.core.config.BucketConfig,7,0,0,6,0,0,0,0,13
couchbase_couchbase-jvm-core.com.couchbase.client.core.config.refresher.Refresher,3,0,0,3,0,1,0,0,7
couchbase_couchbase-jvm-core.com.couchbase.client.core.config.loader.Loader,1,0,0,1,0,1,0,0,3
couchbase_couchbase-jvm-core.com.couchbase.client.core.config.DefaultConfigurationProvider,5,0,0,5,0,0,0,4,14
couchbase_couchbase-jvm-core.com.couchbase.client.core.env.CoreEnvironment,4,0,0,4,0,0,0,0,8
couchbase_couchbase-jvm-core.com.couchbase.client.core.config.DefaultNodeInfo,4,0,0,1,0,0,0,0,5
couchbase_couchbase-jvm-core.com.couchbase.client.core.config.MemcachedBucketConfig,1,0,0,1,0,0,0,0,2
couchbase_couchbase-jvm-core.com.couchbase.client.core.config.parser.BucketConfigParser,9,0,0,9,0,0,0,0,18
couchbase_couchbase-jvm-core.com.couchbase.client.core.config.loader.CarrierLoader,1,0,0,0,0,2,0,0,3
couchbase_couchbase-jvm-core.com.couchbase.client.core.config.loader.HttpLoader,0,0,0,0,0,3,0,0,3
couchbase_couchbase-jvm-core.com.couchbase.client.core.config.loader.AbstractLoader,1,0,0,1,0,3,0,0,5
couchbase_couchbase-jvm-core.com.couchbase.client.core.config.refresher.HttpRefresher,4,0,0,4,0,0,0,0,8
couchbase_couchbase-jvm-core.com.couchbase.client.core.config.refresher.CarrierRefresher,4,1,0,4,0,0,0,1,10
couchbase_couchbase-jvm-core.com.couchbase.client.core.time.Delay,16,0,0,3,0,0,0,0,19
couchbase_couchbase-jvm-core.com.couchbase.client.core.time.ExponentialDelay,0,0,0,0,0,0,0,0,0
couchbase_couchbase-jvm-core.com.couchbase.client.core.retry.BestEffortRetryStrategy,0,0,0,0,0,0,0,0,0
couchbase_couchbase-jvm-core.com.couchbase.client.core.config.NodeInfo,1,0,0,1,0,0,0,0,2
couchbase_couchbase-jvm-core.com.couchbase.client.core.node.CouchbaseNode,2,0,0,1,0,0,4,3,10
couchbase_couchbase-jvm-core.com.couchbase.client.core.node.DefaultServiceRegistry,7,0,0,7,0,0,0,0,14
couchbase_couchbase-jvm-core.com.couchbase.client.core.message.AbstractCouchbaseRequest,7,1,0,9,0,1,0,13,31
couchbase_couchbase-jvm-core.com.couchbase.client.core.config.ClusterConfig,1,0,0,1,0,0,0,0,2
couchbase_couchbase-jvm-core.com.couchbase.client.core.node.Node,0,0,0,0,0,0,0,7,7
couchbase_couchbase-jvm-core.com.couchbase.client.core.node.locate.Locator,0,0,0,0,0,0,0,5,5
couchbase_couchbase-jvm-core.com.couchbase.client.core.lang.Tuple2,1,0,0,1,0,0,0,0,2
couchbase_couchbase-jvm-core.com.couchbase.client.core.lang.Tuple3,1,0,0,1,0,0,0,0,2
couchbase_couchbase-jvm-core.com.couchbase.client.core.lang.Tuple4,1,0,0,1,0,0,0,0,2
couchbase_couchbase-jvm-core.com.couchbase.client.core.lang.Tuple5,1,0,0,1,0,0,0,0,2
couchbase_couchbase-jvm-core.com.couchbase.client.core.endpoint.SSLEngineFactory,0,0,0,0,0,0,0,0,0
couchbase_couchbase-jvm-core.com.couchbase.client.core.endpoint.ResponseStatusConverter,3,0,0,0,0,0,0,0,3
couchbase_couchbase-jvm-core.com.couchbase.client.core.endpoint.BootstrapAdapter,7,0,0,7,0,0,0,0,14
couchbase_couchbase-jvm-core.com.couchbase.client.core.message.search.SearchQueryRequest,0,0,0,1,0,0,0,0,1
couchbase_couchbase-jvm-core.com.couchbase.client.core.message.AbstractCouchbaseResponse,33,0,0,33,0,4,0,0,70
couchbase_couchbase-jvm-core.com.couchbase.client.core.message.config.GetDesignDocumentsRequest,0,0,0,1,0,0,0,0,1
couchbase_couchbase-jvm-core.com.couchbase.client.core.endpoint.util.ByteBufJsonHelper,5,0,0,0,0,0,0,0,5
couchbase_couchbase-jvm-core.com.couchbase.client.core.message.query.GenericQueryRequest,1,0,0,2,0,0,0,2,5
couchbase_couchbase-jvm-core.com.couchbase.client.core.utils.DefaultObjectMapper,11,1,0,0,0,11,0,0,23
couchbase_couchbase-jvm-core.com.couchbase.client.core.endpoint.AbstractGenericHandler,0,0,0,0,0,0,0,0,0
couchbase_couchbase-jvm-core.com.couchbase.client.core.message.query.GenericQueryResponse,1,0,0,0,0,0,0,0,1
couchbase_couchbase-jvm-core.com.couchbase.client.core.endpoint.query.QueryHandlerV2,1,1,0,1,0,0,0,0,3
couchbase_couchbase-jvm-core.com.couchbase.client.core.message.view.GetDesignDocumentRequest,1,0,0,1,0,0,0,0,2
couchbase_couchbase-jvm-core.com.couchbase.client.core.message.view.ViewQueryRequest,0,0,0,1,0,0,0,0,1
couchbase_couchbase-jvm-core.com.couchbase.client.deps.io.netty.handler.codec.memcache.binary.BinaryMemcacheMessage,7,0,0,7,0,0,0,0,14
couchbase_couchbase-jvm-core.com.couchbase.client.core.endpoint.kv.KeyValueFeatureHandler,1,0,0,0,0,0,0,0,1
couchbase_couchbase-jvm-core.com.couchbase.client.core.message.kv.AbstractKeyValueRequest,21,0,0,19,0,1,0,0,41
couchbase_couchbase-jvm-core.com.couchbase.client.deps.io.netty.handler.codec.memcache.binary.BinaryMemcacheResponse,9,0,0,9,0,0,0,0,18
couchbase_couchbase-jvm-core.com.couchbase.client.deps.io.netty.handler.codec.memcache.binary.BinaryMemcacheRequest,1,0,0,1,0,0,0,0,2
couchbase_couchbase-jvm-core.com.couchbase.client.core.endpoint.kv.KeyValueHandler,6,0,0,1,0,0,0,0,7
couchbase_couchbase-jvm-core.com.couchbase.client.core.message.ResponseStatusDetails,1,0,0,1,0,0,0,0,2
couchbase_couchbase-jvm-core.com.couchbase.client.core.message.internal.EndpointHealth,1,0,0,1,0,0,0,0,2
couchbase_couchbase-jvm-core.com.couchbase.client.core.message.cluster.SeedNodesRequest,2,0,0,0,0,0,0,0,2
couchbase_couchbase-jvm-core.com.couchbase.client.core.message.config.GetUsersRequest,0,0,0,0,0,0,0,0,0
couchbase_couchbase-jvm-core.com.couchbase.client.core.message.observe.Observe,7,0,0,5,0,2,0,1,15
couchbase_couchbase-jvm-core.com.couchbase.client.core.message.internal.DiagnosticsReport,1,1,0,1,0,0,0,0,3
couchbase_couchbase-jvm-core.com.couchbase.client.core.message.kv.AbstractKeyValueResponse,22,0,0,20,0,0,3,4,49
couchbase_couchbase-jvm-core.com.couchbase.client.core.message.kv.CounterResponse,2,0,0,2,0,0,0,0,4
couchbase_couchbase-jvm-core.com.couchbase.client.core.event.metrics.LatencyMetricsEvent,2,1,0,2,0,0,0,0,5
couchbase_couchbase-jvm-core.com.couchbase.client.core.message.kv.subdoc.simple.AbstractSubdocMutationRequest,10,0,0,10,0,0,0,0,20
couchbase_couchbase-jvm-core.com.couchbase.client.core.message.kv.subdoc.multi.MutationCommandBuilder,4,0,0,4,0,0,0,0,8
couchbase_couchbase-jvm-core.com.couchbase.client.core.message.internal.PingReport,1,1,0,1,0,0,0,0,3
couchbase_couchbase-jvm-core.com.couchbase.client.core.message.kv.subdoc.multi.LookupCommandBuilder,2,0,0,2,0,0,0,0,4
brettwooldridge_HikariJSON.com.zaxxer.hikari.json.JsonFactory,1,0,0,0,0,0,0,0,1
JetBrains_teamcity-deployer-plugin.jetbrains.buildServer.deployer.agent.ssh.SSHExecProcessAdapter,0,0,0,0,0,0,0,0,0
viritin_viritin.org.vaadin.viritin.fields.LabelField,0,0,0,0,0,0,0,0,0
viritin_viritin.org.vaadin.viritin.fields.HeaderField,0,0,0,0,0,0,0,0,0
viritin_viritin.org.vaadin.viritin.fluency.ui.FluentHasValueChangeMode,1,0,0,0,0,0,0,0,1
viritin_viritin.org.vaadin.viritin.fields.DoubleField,0,0,0,0,0,0,0,0,0
viritin_viritin.org.vaadin.viritin.fields.IntegerField,0,0,0,0,0,0,0,0,0
Alexey1Gavrilov_expectit.net.sf.expectit.Expect,6,0,0,5,0,0,0,3,14
Alexey1Gavrilov_expectit.net.sf.expectit.Result,2,0,0,2,0,0,0,0,4
Alexey1Gavrilov_expectit.net.sf.expectit.ExpectBuilder,4,0,0,4,0,3,0,1,12
Alexey1Gavrilov_expectit.net.sf.expectit.matcher.Matchers,13,0,0,13,0,0,0,0,26
Alexey1Gavrilov_expectit.net.sf.expectit.matcher.Matcher,1,0,0,1,0,0,0,0,2
Alexey1Gavrilov_expectit.net.sf.expectit.Utils,1,0,0,1,0,0,0,0,2
Alexey1Gavrilov_expectit.net.sf.expectit.filter.Filters,0,0,0,0,0,0,0,0,0
Alexey1Gavrilov_expectit.net.sf.expectit.filter.Filter,3,0,0,3,0,0,0,0,6
Vincentyification_JavaBot.com.gmail.inverseconduit.BotConfig,2,0,0,2,0,0,0,0,4
Vincentyification_JavaBot.com.gmail.inverseconduit.utils.PrintUtils,12,0,0,0,0,0,0,0,12
Vincentyification_JavaBot.com.gmail.inverseconduit.commands.providers.javadoc.LibraryZipFile,4,0,0,4,0,0,0,0,8
Vincentyification_JavaBot.com.gmail.inverseconduit.commands.providers.javadoc.JavadocDao,4,0,0,0,0,1,0,0,5
caelum_mamute.org.mamute.input.InputManager,0,0,0,0,0,0,0,0,0
caelum_mamute.org.mamute.converters.BrutalDateTimeConverter,1,0,0,0,0,0,0,2,3
caelum_mamute.org.mamute.search.QuestionIndexProvider,0,0,0,0,0,0,0,0,0
caelum_mamute.org.mamute.search.QuestionIndex,5,0,0,5,0,0,0,1,11
caelum_mamute.org.mamute.filesystem.AttachmentRepository,1,0,0,1,0,0,0,0,2
caelum_mamute.org.mamute.sanitizer.HtmlSanitizer,0,0,0,0,0,0,0,0,0
caelum_mamute.org.mamute.sanitizer.QuotesSanitizer,0,0,0,0,0,0,0,0,0
caelum_mamute.org.mamute.auth.Access,0,0,0,0,0,0,0,0,0
caelum_mamute.org.mamute.auth.SignupInfo,1,0,0,1,0,0,0,0,2
caelum_mamute.org.mamute.brutauth.auth.rules.EditQuestionRule,0,0,0,0,0,0,0,0,0
caelum_mamute.org.mamute.auth.rules.AuthorRule,1,0,0,0,0,0,0,0,1
caelum_mamute.org.mamute.brutauth.auth.rules.EditAnswerRule,0,0,0,0,0,0,0,0,0
caelum_mamute.org.mamute.util.TagsSplitter,0,0,0,0,0,0,0,0,0
caelum_mamute.org.mamute.model.News,0,0,0,0,0,0,0,1,1
caelum_mamute.org.mamute.model.vote.VotingMachine,1,0,0,1,0,0,0,0,2
caelum_mamute.org.mamute.model.MarkDown,0,0,0,0,0,0,0,0,0
caelum_mamute.org.mamute.model.AnswerAndVotes,1,0,0,0,0,0,0,0,1
caelum_mamute.org.mamute.model.CommentsAndVotes,1,0,0,0,0,0,0,0,1
caelum_mamute.org.mamute.model.Question,11,0,0,7,0,0,0,3,21
caelum_mamute.org.mamute.model.QuestionInformation,0,0,0,0,0,0,0,0,0
caelum_mamute.org.mamute.model.Answer,4,0,0,4,0,0,0,0,8
caelum_mamute.org.mamute.model.Updater,3,0,0,3,0,0,0,0,6
caelum_mamute.org.mamute.model.AnswerInformation,0,0,0,0,0,0,0,0,0
caelum_mamute.org.mamute.model.post.PostViewCounter,2,0,0,2,0,0,0,0,4
caelum_mamute.org.mamute.model.User,11,0,0,8,0,0,0,0,19
caelum_mamute.org.mamute.model.Flag,0,0,0,0,0,0,0,0,0
caelum_mamute.org.mamute.model.Comment,1,0,0,1,0,0,0,0,2
caelum_mamute.org.mamute.model.QuestionInformationBuilder,1,0,0,1,0,0,0,0,2
caelum_mamute.org.mamute.model.VisibleCommentList,0,0,0,0,0,0,0,0,0
caelum_mamute.org.mamute.model.vote.MassiveVote,1,0,0,1,0,0,0,0,2
caelum_mamute.org.mamute.model.ban.IpMatcher,2,0,0,0,0,0,0,0,2
caelum_mamute.org.mamute.model.flag.RetrieveKarma,0,0,0,0,0,0,0,0,0
caelum_mamute.org.mamute.model.flag.FlagTrigger,0,0,0,0,0,0,0,1,1
caelum_mamute.org.mamute.model.flag.RemoveAnythingFlaggedByModerator,2,0,0,2,0,0,0,0,4
caelum_mamute.org.mamute.model.flag.RemoveSolutionFlaggedByModerator,2,0,0,1,0,0,0,0,3
caelum_mamute.org.mamute.ads.BrutalAds,0,0,0,0,0,0,0,0,0
caelum_mamute.org.mamute.dao.ReputationEventDAO,6,0,0,5,0,0,0,0,11
caelum_mamute.org.mamute.dao.TagPageDAO,0,0,0,0,0,0,0,0,0
caelum_mamute.org.mamute.dao.FlaggableDAO,2,0,0,2,0,0,0,0,4
caelum_mamute.org.mamute.dao.WatcherDAO,0,0,0,0,0,0,0,0,0
caelum_mamute.org.mamute.dao.NewsDAO,2,0,0,2,0,0,0,0,4
caelum_mamute.org.mamute.dao.QuestionDAO,5,0,0,1,0,0,0,0,6
caelum_mamute.org.mamute.dao.WithUserPaginatedDAO,3,0,0,2,0,0,0,0,5
caelum_mamute.org.mamute.dao.TagDAO,7,0,0,6,0,0,0,0,13
caelum_mamute.org.mamute.dao.VoteDAO,3,0,0,2,0,0,0,0,5
caelum_mamute.org.mamute.dao.InformationDAO,1,0,0,1,0,0,0,0,2
caelum_mamute.org.mamute.dao.InvisibleForUsersRule,0,0,0,0,0,0,0,3,3
caelum_mamute.org.mamute.dao.ModeratorOrVisibleNewsFilter,0,0,0,0,0,0,0,1,1
caelum_mamute.org.mamute.dao.UserDAO,6,0,0,4,0,0,0,0,10
caelum_mamute.org.mamute.dao.NewsletterSentLogDAO,0,0,0,0,0,0,0,0,0
caelum_mamute.org.mamute.dao.FlagDao,1,0,0,1,0,0,0,0,2
caelum_mamute.org.mamute.infra.ModelUrlMapping,0,0,0,0,0,0,0,0,0
caelum_mamute.org.mamute.infra.NormalizerBrutal,0,0,0,0,0,0,0,0,0
caelum_mamute.org.mamute.infra.rss.write.RssFeedFactory,1,0,0,1,0,0,0,0,2
caelum_mamute.org.mamute.infra.rss.write.QuestionRssEntryFactory,1,0,0,0,0,0,0,0,1
caelum_mamute.org.mamute.reputation.rules.KarmaCalculator,1,0,0,1,0,0,0,0,2
caelum_mamute.org.mamute.reputation.rules.VotedAtSomethingEvent,0,0,0,0,0,0,0,0,0
caelum_mamute.org.mamute.validators.EmailValidator,0,0,0,0,0,0,0,0,0
caelum_mamute.org.mamute.validators.UserPersonalInfoValidator,0,0,0,0,0,0,0,0,0
caelum_mamute.org.mamute.validators.TagsValidator,1,0,0,0,0,0,0,0,1
caelum_mamute.org.mamute.validators.SignupValidator,0,0,0,0,0,0,0,0,0
caelum_mamute.org.mamute.validators.UrlValidator,1,0,0,0,0,0,0,0,1
caelum_mamute.org.mamute.mail.NewQuestionMailer,0,0,0,0,0,0,0,2,2
caelum_mamute.org.mamute.migration.NumberExtractor,0,0,0,0,0,0,0,0,0
caelum_mamute.org.mamute.migration.MigrationRunner,0,0,0,0,0,0,0,3,3
caelum_mamute.org.mamute.model.Tag,1,0,0,1,0,0,0,0,2
caelum_mamute.org.mamute.model.LoggedUser,0,0,0,0,0,0,0,0,0
caelum_mamute.org.mamute.infra.rss.read.FeedConverter,4,0,0,4,0,0,0,0,8
usc-isi-i2_Web-Karma.edu.isi.karma.util.JSONLDUtilSimple,0,0,0,0,0,0,0,1,1
usc-isi-i2_Web-Karma.edu.isi.karma.webserver.KarmaServlet,0,0,0,0,0,0,0,2,2
usc-isi-i2_Web-Karma.edu.isi.karma.transformation.tokenizer.PythonTransformationAsURIValidator,0,0,0,0,0,0,0,0,0
usc-isi-i2_Web-Karma.edu.isi.karma.rdf.RDFGeneratorRequest,6,0,0,4,0,6,0,0,16
usc-isi-i2_Web-Karma.edu.isi.karma.rep.Entity,2,1,0,2,0,0,0,0,5
usc-isi-i2_Web-Karma.edu.isi.karma.kr2rml.writer.JSONKR2RMLRDFWriter,1,0,0,1,0,1,0,0,3
usc-isi-i2_Web-Karma.edu.isi.karma.kr2rml.writer.KR2RMLBloomFilterManager,1,0,0,1,0,1,0,0,3
.consumer.kafka.PIDController,0,0,0,0,0,0,0,0,0
google_jimfs.com.google.common.jimfs.UserLookupService,7,0,0,2,0,0,0,0,9
google_jimfs.com.google.common.jimfs.PathType,15,0,0,10,0,2,0,3,30
google_jimfs.com.google.common.jimfs.JimfsFileSystem,4,0,0,2,0,1,0,0,7
google_jimfs.com.google.common.jimfs.File,8,0,0,8,0,0,0,0,16
google_jimfs.com.google.common.jimfs.AttributeService,12,0,0,11,0,2,0,0,25
google_jimfs.com.google.common.jimfs.Directory,13,0,0,13,0,0,0,0,26
google_jimfs.com.google.common.jimfs.BasicAttributeProvider,1,0,0,0,0,0,0,0,1
google_jimfs.com.google.common.jimfs.JimfsOutputStream,0,0,0,0,0,0,0,7,7
google_jimfs.com.google.common.jimfs.RegularFile,11,0,0,7,0,2,0,0,20
google_jimfs.com.google.common.jimfs.JimfsPath,1,0,0,0,0,0,0,1,2
google_jimfs.com.google.common.jimfs.PathService,8,0,0,6,0,0,0,2,16
google_jimfs.com.google.common.jimfs.Name,1,0,0,1,0,0,0,1,3
google_jimfs.com.google.common.jimfs.WatchServiceConfiguration,2,0,0,2,0,0,0,0,4
google_jimfs.com.google.common.jimfs.OwnerAttributeProvider,1,0,0,0,0,0,0,0,1
google_jimfs.com.google.common.jimfs.JimfsInputStream,8,0,0,2,0,0,0,0,10
google_jimfs.com.google.common.jimfs.FileSystemState,7,0,0,2,0,1,0,0,10
google_jimfs.com.google.common.jimfs.PollingWatchService,4,0,0,2,0,0,0,0,6
google_jimfs.com.google.common.jimfs.Configuration,13,0,0,8,0,0,0,0,21
google_jimfs.com.google.common.jimfs.JimfsAsynchronousFileChannel,1,0,0,1,0,0,0,3,5
google_jimfs.com.google.common.jimfs.HeapDisk,8,0,0,8,0,0,0,0,16
google_jimfs.com.google.common.jimfs.AbstractWatchService,5,0,0,5,0,0,0,0,10
google_jimfs.com.google.common.jimfs.FileFactory,2,0,0,2,0,0,0,0,4
searchisko_elasticsearch-river-remote.org.jboss.elasticsearch.river.remote.IRemoteSystemClient,11,0,0,8,0,1,0,0,20
searchisko_elasticsearch-river-remote.org.jboss.elasticsearch.river.remote.DocumentWithCommentsIndexStructureBuilder,8,0,0,5,0,0,0,1,14
searchisko_elasticsearch-river-remote.org.jboss.elasticsearch.river.remote.DateTimeUtils,11,0,0,10,0,0,0,2,23
searchisko_elasticsearch-river-remote.org.jboss.elasticsearch.river.remote.CronExpression,2,0,0,0,0,0,0,0,2
searchisko_elasticsearch-river-remote.org.jboss.elasticsearch.river.remote.Utils,10,0,0,0,0,0,0,0,10
searchisko_elasticsearch-river-remote.org.jboss.elasticsearch.river.remote.GetSitemapHtmlClient,8,0,0,2,0,2,0,0,12
searchisko_elasticsearch-river-remote.org.jboss.elasticsearch.river.remote.SpaceIndexerBase,3,0,0,2,0,1,0,0,6
searchisko_elasticsearch-river-remote.org.jboss.elasticsearch.river.remote.SpaceIndexerCoordinator,12,0,0,9,0,0,0,0,21
searchisko_elasticsearch-river-remote.org.jboss.elasticsearch.river.remote.SpaceByLastUpdateTimestampIndexer,8,0,0,8,0,1,0,0,17
searchisko_elasticsearch-river-remote.org.jboss.elasticsearch.river.remote.SpaceSimpleIndexer,2,0,0,2,0,0,0,0,4
searchisko_elasticsearch-river-remote.org.jboss.elasticsearch.river.remote.HttpRemoteSystemClientBase,6,0,0,0,0,2,0,0,8
searchisko_elasticsearch-river-remote.org.jboss.elasticsearch.river.remote.SpacePaginatingIndexer,5,0,0,5,0,0,0,0,10
searchisko_elasticsearch-river-remote.org.jboss.elasticsearch.river.remote.GetJSONClient,3,0,0,1,0,0,0,0,4
searchisko_elasticsearch-river-remote.org.jboss.elasticsearch.river.remote.SpaceIndexingInfo,2,0,0,2,0,0,0,0,4
searchisko_elasticsearch-river-remote.org.jboss.elasticsearch.river.remote.RemoteRiver,16,0,0,10,0,0,0,2,28
searchisko_elasticsearch-river-remote.org.jboss.elasticsearch.river.remote.IESIntegration,1,0,0,0,0,0,0,0,1
searchisko_elasticsearch-river-remote.org.jboss.elasticsearch.river.remote.ChangedDocumentsResults,1,0,0,1,0,0,0,0,2
searchisko_elasticsearch-river-remote.org.jboss.elasticsearch.river.remote.sitemap.SiteMapParser,10,0,0,9,0,0,0,0,19
searchisko_elasticsearch-river-remote.org.jboss.elasticsearch.river.remote.mgm.TransportJRMgmBaseAction,0,0,0,0,0,0,0,0,0
searchisko_elasticsearch-river-remote.org.jboss.elasticsearch.river.remote.IRiverMgm,1,0,0,1,0,0,0,0,2
searchisko_elasticsearch-river-remote.org.jboss.elasticsearch.river.remote.mgm.riverslist.TransportListRiversAction,2,0,0,1,0,0,0,0,3
searchisko_elasticsearch-river-remote.org.jboss.elasticsearch.river.remote.mgm.riverslist.NodeListRiversResponse,1,0,0,1,0,0,0,0,2
searchisko_elasticsearch-river-remote.org.jboss.elasticsearch.river.remote.mgm.riverslist.ListRiversAction,0,0,0,0,0,0,0,0,0
searchisko_elasticsearch-river-remote.org.jboss.elasticsearch.river.remote.mgm.NodeJRMgmBaseResponse,4,0,0,0,0,0,0,0,4
searchisko_elasticsearch-river-remote.org.jboss.elasticsearch.river.remote.mgm.state.JRStateRequestBuilder,1,0,0,1,0,0,0,0,2
searchisko_elasticsearch-river-remote.org.jboss.elasticsearch.river.remote.mgm.state.TransportJRStateAction,5,0,0,2,0,0,0,0,7
searchisko_elasticsearch-river-remote.org.jboss.elasticsearch.river.remote.mgm.state.JRStateAction,0,0,0,0,0,0,0,0,0
searchisko_elasticsearch-river-remote.org.jboss.elasticsearch.river.remote.mgm.NodeJRMgmBaseRequest,4,0,0,0,0,0,0,0,4
searchisko_elasticsearch-river-remote.org.jboss.elasticsearch.river.remote.mgm.JRMgmBaseRequest,1,0,0,0,0,0,0,0,1
searchisko_elasticsearch-river-remote.org.jboss.elasticsearch.river.remote.mgm.lifecycle.JRLifecycleAction,0,0,0,0,0,0,0,0,0
searchisko_elasticsearch-river-remote.org.jboss.elasticsearch.river.remote.mgm.lifecycle.JRLifecycleRequest,3,0,0,3,0,0,0,0,6
searchisko_elasticsearch-river-remote.org.jboss.elasticsearch.river.remote.mgm.lifecycle.TransportJRLifecycleAction,5,0,0,2,0,0,0,0,7
searchisko_elasticsearch-river-remote.org.jboss.elasticsearch.river.remote.mgm.lifecycle.JRLifecycleRequestBuilder,1,0,0,1,0,0,0,0,2
searchisko_elasticsearch-river-remote.org.jboss.elasticsearch.river.remote.mgm.JRMgmBaseResponse,5,0,0,2,0,0,0,0,7
searchisko_elasticsearch-river-remote.org.jboss.elasticsearch.river.remote.mgm.fullupdate.FullUpdateRequestBuilder,1,0,0,1,0,0,0,0,2
searchisko_elasticsearch-river-remote.org.jboss.elasticsearch.river.remote.mgm.fullupdate.TransportFullUpdateAction,5,0,0,2,0,0,0,0,7
searchisko_elasticsearch-river-remote.org.jboss.elasticsearch.river.remote.mgm.fullupdate.FullUpdateRequest,3,0,0,3,0,0,0,0,6
searchisko_elasticsearch-river-remote.org.jboss.elasticsearch.river.remote.mgm.fullupdate.FullUpdateAction,0,0,0,0,0,0,0,0,0
searchisko_elasticsearch-river-remote.org.jboss.elasticsearch.river.remote.mgm.incrementalupdate.IncrementalUpdateAction,0,0,0,0,0,0,0,0,0
searchisko_elasticsearch-river-remote.org.jboss.elasticsearch.river.remote.mgm.incrementalupdate.IncrementalUpdateRequest,3,0,0,3,0,0,0,0,6
searchisko_elasticsearch-river-remote.org.jboss.elasticsearch.river.remote.mgm.incrementalupdate.TransportIncrementalUpdateAction,5,0,0,2,0,0,0,0,7
searchisko_elasticsearch-river-remote.org.jboss.elasticsearch.river.remote.mgm.incrementalupdate.IncrementalUpdateRequestBuilder,1,0,0,1,0,0,0,0,2
apache_olingo-odata4.org.apache.olingo.server.api.ODataLibraryException,6,1,0,1,0,1,0,0,9
apache_olingo-odata4.org.apache.olingo.server.api.ODataResponse,24,0,0,19,0,1,0,0,44
apache_olingo-odata4.org.apache.olingo.server.api.ODataServerError,8,0,0,8,0,0,0,0,16
apache_olingo-odata4.org.apache.olingo.server.api.ODataRequest,7,0,0,5,0,0,0,0,12
apache_olingo-odata4.org.apache.olingo.server.api.prefer.PreferencesApplied,0,0,0,0,0,0,0,0,0
apache_olingo-odata4.org.apache.olingo.server.api.uri.UriHelper,0,0,0,0,0,0,0,0,0
apache_olingo-odata4.org.apache.olingo.server.core.uri.UriParameterImpl,1,0,0,1,0,0,0,0,2
apache_olingo-odata4.org.apache.olingo.server.core.uri.UriResourceImpl,16,0,0,16,0,0,0,0,32
apache_olingo-odata4.org.apache.olingo.commons.api.edm.Edm,76,1,0,62,0,1,0,2,142
apache_olingo-odata4.org.apache.olingo.server.core.uri.UriInfoImpl,8,0,0,8,0,0,0,0,16
apache_olingo-odata4.org.apache.olingo.server.api.uri.UriInfo,1,0,0,1,0,0,0,0,2
apache_olingo-odata4.org.apache.olingo.server.core.uri.queryoption.AliasQueryOptionImpl,0,0,0,0,0,0,0,0,0
apache_olingo-odata4.org.apache.olingo.server.core.uri.queryoption.ExpandItemImpl,1,0,0,1,0,0,0,0,2
apache_olingo-odata4.org.apache.olingo.server.core.uri.queryoption.SystemQueryOptionImpl,13,0,0,13,0,0,0,0,26
apache_olingo-odata4.org.apache.olingo.server.core.uri.queryoption.OrderByItemImpl,1,0,0,1,0,0,0,0,2
apache_olingo-odata4.org.apache.olingo.server.core.uri.queryoption.QueryOptionImpl,1,0,0,1,0,0,0,0,2
apache_olingo-odata4.org.apache.olingo.server.core.uri.queryoption.SelectItemImpl,1,0,0,1,0,0,0,0,2
apache_olingo-odata4.org.apache.olingo.server.core.uri.queryoption.expression.AliasImpl,1,0,0,0,0,0,0,0,1
apache_olingo-odata4.org.apache.olingo.server.api.OData,15,0,0,11,0,0,0,3,29
apache_olingo-odata4.org.apache.olingo.server.core.uri.queryoption.expression.LambdaRefImpl,1,0,0,0,0,0,0,0,1
apache_olingo-odata4.org.apache.olingo.server.core.uri.parser.UriDecoder,2,0,0,0,0,0,0,1,3
apache_olingo-odata4.org.apache.olingo.commons.api.format.ContentType,53,0,0,17,0,0,0,3,73
apache_olingo-odata4.org.apache.olingo.server.core.uri.parser.Parser,1,0,0,1,0,0,0,0,2
apache_olingo-odata4.org.apache.olingo.commons.api.edm.EdmTyped,1,0,0,1,0,0,0,3,5
apache_olingo-odata4.org.apache.olingo.server.core.uri.parser.ExpressionParser,5,0,0,5,0,1,0,0,11
apache_olingo-odata4.org.apache.olingo.server.core.uri.parser.UriTokenizer,32,1,0,5,0,0,0,0,38
apache_olingo-odata4.org.apache.olingo.server.core.etag.PreconditionsValidator,0,0,0,0,0,0,0,0,0
apache_olingo-odata4.org.apache.olingo.server.core.ODataHandlerImpl,2,0,0,2,0,2,0,0,6
apache_olingo-odata4.org.apache.olingo.server.core.RequestURLHierarchyVisitor,0,0,0,0,0,0,0,0,0
apache_olingo-odata4.org.apache.olingo.server.core.ErrorHandler,0,0,0,0,0,0,0,0,0
apache_olingo-odata4.org.apache.olingo.server.api.uri.UriResourceEntitySet,1,0,0,1,0,0,0,0,2
apache_olingo-odata4.org.apache.olingo.server.core.requests.DataRequest,4,0,0,4,0,0,0,0,8
apache_olingo-odata4.org.apache.olingo.commons.core.Encoder,4,0,0,0,0,0,0,0,4
apache_olingo-odata4.org.apache.olingo.commons.api.edm.provider.CsdlAnnotation,12,0,0,11,0,0,0,0,23
apache_olingo-odata4.org.apache.olingo.commons.api.edm.provider.CsdlEdmProvider,17,0,0,15,0,1,0,3,36
apache_olingo-odata4.org.apache.olingo.server.core.MetadataParser,2,0,0,2,0,0,0,2,6
apache_olingo-odata4.org.apache.olingo.server.core.ODataHttpHandlerImpl,2,0,0,2,0,0,0,0,4
apache_olingo-odata4.org.apache.olingo.server.core.ODataExceptionHelper,0,0,0,0,0,0,0,1,1
apache_olingo-odata4.org.apache.olingo.server.core.ContentNegotiator,2,0,0,2,0,1,0,0,5
apache_olingo-odata4.org.apache.olingo.commons.api.edm.EdmEntityContainer,89,2,0,85,0,5,0,33,214
apache_olingo-odata4.org.apache.olingo.server.api.deserializer.DeserializerResult,10,0,0,10,0,0,0,0,20
apache_olingo-odata4.org.apache.olingo.commons.api.data.Valuable,33,0,0,26,0,0,0,0,59
apache_olingo-odata4.org.apache.olingo.commons.api.data.Linked,10,0,0,10,0,0,0,0,20
apache_olingo-odata4.org.apache.olingo.commons.api.data.Annotatable,3,0,0,3,0,0,0,0,6
apache_olingo-odata4.org.apache.olingo.commons.api.data.Entity,28,4,0,23,0,0,0,0,55
apache_olingo-odata4.org.apache.olingo.commons.api.edm.EdmStructuredType,16,0,0,14,0,0,0,0,30
apache_olingo-odata4.org.apache.olingo.commons.api.edm.EdmType,2,0,0,2,0,0,0,0,4
apache_olingo-odata4.org.apache.olingo.commons.api.data.Property,1,0,0,1,0,0,0,0,2
apache_olingo-odata4.org.apache.olingo.commons.api.data.Parameter,10,0,0,10,0,1,0,0,21
apache_olingo-odata4.org.apache.olingo.commons.api.data.EntityCollection,9,0,0,6,0,0,0,0,15
apache_olingo-odata4.org.apache.olingo.server.api.deserializer.FixedFormatDeserializer,0,0,0,0,0,0,0,0,0
apache_olingo-odata4.org.apache.olingo.server.core.serializer.utils.ContextURLHelper,0,0,0,0,0,0,0,0,0
apache_olingo-odata4.org.apache.olingo.server.core.serializer.utils.ContextURLBuilder,4,0,0,4,0,0,0,0,8
apache_olingo-odata4.org.apache.olingo.server.core.serializer.utils.CircleStreamBuffer,10,0,0,10,0,0,0,0,20
apache_olingo-odata4.org.apache.olingo.server.core.serializer.AsyncResponseSerializer,0,0,0,0,0,0,0,0,0
apache_olingo-odata4.org.apache.olingo.server.core.serializer.BatchResponseSerializer,13,0,0,13,0,0,0,0,26
apache_olingo-odata4.org.apache.olingo.server.api.serializer.FixedFormatSerializer,0,0,0,0,0,0,0,0,0
apache_olingo-odata4.org.apache.olingo.commons.api.data.EntityMediaObject,0,0,0,0,0,0,0,0,0
apache_olingo-odata4.org.apache.olingo.server.api.ServiceMetadata,0,0,0,0,0,0,0,0,0
apache_olingo-odata4.org.apache.olingo.commons.api.edm.EdmSchema,15,0,0,15,0,0,0,0,30
apache_olingo-odata4.org.apache.olingo.commons.api.edmx.EdmxReference,2,0,0,2,0,0,0,0,4
apache_olingo-odata4.org.apache.olingo.server.api.serializer.SerializerResult,1,0,0,1,0,0,0,0,2
apache_olingo-odata4.org.apache.olingo.commons.api.data.AbstractODataObject,0,0,0,0,0,0,0,0,0
apache_olingo-odata4.org.apache.olingo.netty.server.api.ODataNetty,1,0,0,1,0,0,0,0,2
apache_olingo-odata4.org.apache.olingo.netty.server.core.ODataNettyHandlerImpl,1,0,0,1,0,0,0,0,2
apache_olingo-odata4.org.apache.olingo.commons.api.format.AcceptCharset,4,0,0,4,0,0,0,0,8
apache_olingo-odata4.org.apache.olingo.commons.api.format.AcceptType,11,0,0,11,0,0,0,0,22
apache_olingo-odata4.org.apache.olingo.client.api.domain.ClientEntitySet,70,6,0,70,0,0,0,0,146
apache_olingo-odata4.org.apache.olingo.client.api.serialization.ODataBinder,5,0,0,5,0,0,0,0,10
apache_olingo-odata4.org.apache.olingo.client.api.EdmEnabledODataClient,1,0,0,1,0,0,0,0,2
apache_olingo-odata4.org.apache.olingo.client.api.serialization.ODataMetadataValidation,16,0,0,0,0,17,0,0,33
apache_olingo-odata4.org.apache.olingo.client.api.domain.ClientPrimitiveValue,2,0,0,2,0,0,0,0,4
apache_olingo-odata4.org.apache.olingo.client.api.ODataClient,28,5,0,28,0,5,0,0,66
apache_olingo-odata4.org.apache.olingo.client.core.ODataClientFactory,26,0,0,26,0,0,0,1,53
apache_olingo-odata4.org.apache.olingo.client.api.ODataClientBuilder,3,0,0,3,0,0,0,0,6
apache_olingo-odata4.org.apache.olingo.client.api.domain.ClientComplexValue,6,0,0,6,0,0,0,0,12
apache_olingo-odata4.org.apache.olingo.client.api.domain.ClientEntity,19,2,0,19,0,1,0,0,41
apache_olingo-odata4.org.apache.olingo.client.core.serialization.JsonDeserializer,1,0,0,1,0,0,0,0,2
apache_olingo-odata4.org.apache.olingo.commons.api.ex.ODataError,1,0,0,0,0,0,0,0,1
apache_olingo-odata4.org.apache.olingo.commons.api.edm.provider.CsdlSchema,6,0,0,6,0,0,0,0,12
apache_olingo-odata4.org.apache.olingo.client.api.edm.xml.XMLMetadata,1,0,0,1,0,0,0,0,2
apache_olingo-odata4.org.apache.olingo.commons.api.edm.provider.CsdlAnnotations,2,0,0,2,0,0,0,0,4
apache_olingo-odata4.org.apache.olingo.client.core.serialization.AtomDeserializer,5,0,0,5,0,0,0,0,10
apache_olingo-odata4.org.apache.olingo.client.api.uri.FilterArgFactory,1,0,0,1,0,0,0,0,2
apache_olingo-odata4.org.apache.olingo.client.api.uri.FilterFactory,1,0,0,1,0,0,0,0,2
apache_olingo-odata4.org.apache.olingo.client.api.uri.URIBuilder,26,1,0,24,0,0,0,0,51
apache_olingo-odata4.org.apache.olingo.client.core.uri.URIUtils,0,0,0,0,0,0,0,0,0
apache_olingo-odata4.org.apache.olingo.commons.api.edm.geo.Point,0,0,0,0,0,0,0,0,0
apache_olingo-odata4.org.apache.olingo.client.core.data.ServiceDocumentImpl,1,0,0,1,0,0,0,0,2
apache_olingo-odata4.org.apache.olingo.client.core.data.ServiceDocumentItemImpl,1,0,0,1,0,0,0,0,2
apache_olingo-odata4.org.apache.olingo.client.api.domain.ClientEntitySetIterator,5,0,0,5,0,0,0,0,10
apache_olingo-odata4.org.apache.olingo.client.core.domain.ClientAnnotationImpl,1,0,0,1,0,0,0,0,2
apache_olingo-odata4.org.apache.olingo.client.core.domain.ClientCollectionValueImpl,1,0,0,1,0,0,0,0,2
apache_olingo-odata4.org.apache.olingo.client.core.domain.ClientComplexValueImpl,1,0,0,1,0,0,0,0,2
apache_olingo-odata4.org.apache.olingo.client.core.domain.ClientDeletedEntityImpl,1,0,0,1,0,0,0,0,2
apache_olingo-odata4.org.apache.olingo.client.core.domain.ClientDeltaImpl,1,0,0,1,0,0,0,0,2
apache_olingo-odata4.org.apache.olingo.client.core.domain.ClientDeltaLinkImpl,1,0,0,1,0,0,0,0,2
apache_olingo-odata4.org.apache.olingo.client.core.domain.ClientEntityImpl,1,0,0,1,0,0,0,0,2
apache_olingo-odata4.org.apache.olingo.client.core.domain.ClientEntitySetImpl,1,0,0,1,0,0,0,0,2
apache_olingo-odata4.org.apache.olingo.client.core.domain.ClientEnumValueImpl,1,0,0,1,0,0,0,0,2
apache_olingo-odata4.org.apache.olingo.client.core.domain.ClientPrimitiveValueImpl,1,0,0,1,0,0,0,0,2
apache_olingo-odata4.org.apache.olingo.client.core.domain.ClientPropertyImpl,1,0,0,1,0,0,0,0,2
apache_olingo-odata4.org.apache.olingo.client.core.domain.ClientValuableImpl,1,0,0,1,0,0,0,0,2
apache_olingo-odata4.org.apache.olingo.client.core.communication.response.batch.ODataBatchResponseManager,1,0,0,1,0,0,0,0,2
apache_olingo-odata4.org.apache.olingo.client.api.communication.request.batch.ODataBatchLineIterator,1,0,0,1,0,0,0,0,2
apache_olingo-odata4.org.apache.olingo.client.core.communication.request.AsyncRequestWrapperImpl,4,0,0,0,0,0,0,0,4
apache_olingo-odata4.org.apache.olingo.client.core.communication.request.Wrapper,0,0,0,0,0,0,0,0,0
apache_olingo-odata4.org.apache.olingo.client.core.communication.request.batch.ODataBatchUtilities,0,0,0,0,0,0,0,1,1
apache_olingo-odata4.org.apache.olingo.client.core.communication.request.batch.ODataChangesetResponseItem,0,0,0,0,0,0,0,0,0
apache_olingo-odata4.org.apache.olingo.client.core.communication.request.batch.ODataBatchController,1,0,0,1,0,0,0,0,2
apache_olingo-odata4.org.apache.olingo.client.core.serialization.ContextURLParser,13,0,0,13,0,0,0,0,26
apache_olingo-odata4.org.apache.olingo.server.api.uri.queryoption.search.SearchExpression,6,0,0,6,0,0,0,0,12
apache_olingo-odata4.org.apache.olingo.server.core.uri.parser.search.SearchTokenizer,1,0,0,1,0,0,0,0,2
apache_olingo-odata4.org.apache.olingo.server.api.prefer.Preferences,9,0,0,9,0,0,0,0,18
apache_olingo-odata4.org.apache.olingo.server.core.batchhandler.BatchHandler,4,3,0,4,0,0,0,0,11
apache_olingo-odata4.org.apache.olingo.commons.api.edm.EdmOperation,5,0,0,5,0,0,0,0,10
apache_olingo-odata4.org.apache.olingo.commons.api.edm.EdmNamed,9,0,0,9,0,0,0,0,18
apache_olingo-odata4.org.apache.olingo.server.core.debug.ServerCoreDebugger,2,0,0,2,0,0,0,0,4
apache_olingo-odata4.org.apache.olingo.server.api.etag.ETagHelper,1,0,0,0,0,0,0,1,2
apache_olingo-odata4.org.apache.olingo.server.core.etag.ETagHelperImpl,8,0,0,8,0,0,0,0,16
apache_olingo-odata4.org.apache.olingo.server.core.etag.ETagInformation,1,0,0,1,0,0,0,0,2
apache_olingo-odata4.org.apache.olingo.server.core.deserializer.batch.Header,10,0,0,9,0,0,0,0,19
apache_olingo-odata4.org.apache.olingo.server.core.deserializer.batch.HeaderField,1,0,0,1,0,0,0,0,2
apache_olingo-odata4.org.apache.olingo.server.api.deserializer.batch.BatchRequestPart,15,3,0,15,0,0,0,0,33
apache_olingo-odata4.org.apache.olingo.server.core.deserializer.batch.BatchParser,1,0,0,1,0,0,0,0,2
apache_olingo-odata4.org.apache.olingo.server.core.deserializer.batch.BatchParserCommon,9,0,0,9,0,0,0,0,18
apache_olingo-odata4.org.apache.olingo.server.core.deserializer.batch.HttpRequestStatusLine,6,0,0,6,0,0,0,0,12
apache_olingo-odata4.org.apache.olingo.server.core.deserializer.batch.BatchLineReader,15,0,0,15,0,0,0,0,30
apache_olingo-odata4.org.apache.olingo.server.core.deserializer.batch.Line,1,0,0,1,0,0,0,0,2
apache_olingo-odata4.org.apache.olingo.commons.core.Decoder,3,0,0,0,0,0,0,0,3
apache_olingo-odata4.org.apache.olingo.commons.core.edm.ActionMapKey,1,0,0,0,0,0,0,0,1
apache_olingo-odata4.org.apache.olingo.commons.core.edm.TargetQualifierMapKey,1,0,0,0,0,0,0,0,1
apache_olingo-odata4.org.apache.olingo.commons.core.edm.FunctionMapKey,2,0,0,0,0,0,0,0,2
apache_olingo-odata4.org.apache.olingo.commons.core.edm.AbstractEdm,2,0,0,2,0,0,0,0,4
apache_olingo-odata4.org.apache.olingo.commons.api.edm.FullQualifiedName,0,0,0,0,0,0,0,0,0
apache_olingo-odata4.org.apache.olingo.commons.core.edm.primitivetype.EdmPrimitiveTypeFactory,6,1,0,6,0,0,0,0,13
apache_olingo-odata4.org.apache.olingo.commons.api.edm.EdmPrimitiveType,51,1,0,13,0,0,0,1,66
apache_olingo-odata4.org.apache.olingo.commons.core.edm.primitivetype.EdmGeographyPoint,3,0,0,3,0,0,0,0,6
apache_olingo-odata4.org.apache.olingo.commons.core.edm.primitivetype.EdmGeometryMultiPoint,1,0,0,1,0,0,0,0,2
apache_olingo-odata4.org.apache.olingo.commons.core.edm.primitivetype.EdmGeometryPolygon,2,0,0,2,0,0,0,0,4
apache_olingo-odata4.org.apache.olingo.commons.core.edm.primitivetype.EdmGeographyPolygon,1,0,0,1,0,0,0,0,2
apache_olingo-odata4.org.apache.olingo.commons.core.edm.primitivetype.EdmGeometryCollection,1,0,0,1,0,0,0,0,2
apache_olingo-odata4.org.apache.olingo.commons.core.edm.annotation.AbstractEdmExpression,28,1,0,28,0,8,0,0,65
apache_olingo-odata4.org.apache.olingo.commons.api.edm.provider.annotation.CsdlUrlRef,2,0,0,2,0,0,0,0,4
apache_olingo-odata4.org.apache.olingo.commons.api.edm.provider.annotation.CsdlRecord,2,0,0,2,0,0,0,0,4
apache_olingo-odata4.org.apache.olingo.commons.api.edm.provider.annotation.CsdlIf,1,0,0,1,0,0,0,0,2
apache_olingo-odata4.org.apache.olingo.commons.api.edm.provider.annotation.CsdlIsOf,1,0,0,1,0,0,0,0,2
apache_olingo-odata4.org.apache.olingo.commons.api.edm.provider.annotation.CsdlCollection,1,0,0,1,0,0,0,0,2
apache_olingo-odata4.org.apache.olingo.commons.api.edm.provider.annotation.CsdlCast,1,0,0,1,0,0,0,0,2
apache_olingo-odata4.org.apache.olingo.commons.api.edm.annotation.EdmPropertyValue,1,0,0,1,0,1,0,0,3
apache_olingo-odata4.org.apache.olingo.commons.api.edm.provider.annotation.CsdlPropertyValue,1,0,0,1,0,0,0,0,2
apache_olingo-odata4.org.apache.olingo.commons.api.edm.provider.annotation.CsdlLabeledElement,1,0,0,1,0,0,0,0,2
apache_olingo-odata4.org.apache.olingo.commons.api.edm.annotation.EdmAnnotationPath,1,0,0,1,0,0,0,0,2
apache_olingo-odata4.org.apache.olingo.commons.api.edm.provider.annotation.CsdlApply,1,0,0,1,0,0,0,0,2
apache_olingo-odata4.org.apache.olingo.commons.api.edm.EdmEnumType,2,0,0,1,0,0,0,0,3
apache_olingo-odata4.org.apache.olingo.commons.api.edm.provider.CsdlEntityType,7,0,0,7,0,0,0,1,15
apache_olingo-odata4.org.apache.olingo.commons.api.edm.EdmBindingTarget,0,0,0,0,0,0,0,0,0
apache_olingo-odata4.org.apache.olingo.commons.api.edm.provider.CsdlEntityContainerInfo,1,0,0,1,0,1,0,0,3
apache_olingo-odata4.org.apache.olingo.commons.api.edm.provider.CsdlFunction,1,0,0,1,0,0,0,0,2
apache_olingo-odata4.org.apache.olingo.commons.api.edm.provider.CsdlTypeDefinition,1,0,0,1,0,0,0,0,2
apache_olingo-odata4.org.apache.olingo.commons.core.edm.EdmTypeDefinitionImpl,2,0,0,0,0,2,0,0,4
apache_olingo-odata4.org.apache.olingo.commons.api.edm.provider.CsdlPropertyRef,3,0,0,3,0,0,0,0,6
apache_olingo-odata4.org.apache.olingo.commons.api.edm.EdmTerm,1,0,0,1,0,1,0,0,3
apache_olingo-odata4.org.apache.olingo.commons.api.edm.provider.CsdlTerm,6,0,0,4,0,2,0,0,12
apache_olingo-odata4.org.apache.olingo.commons.api.edm.EdmOperationImport,1,0,0,0,0,0,0,0,1
apache_olingo-odata4.org.apache.olingo.commons.api.edm.EdmProperty,2,0,0,2,0,1,0,0,5
apache_olingo-odata4.org.apache.olingo.commons.api.edm.provider.CsdlProperty,1,0,0,1,0,0,0,0,2
apache_olingo-odata4.org.apache.olingo.commons.api.edm.EdmMappable,1,0,0,1,0,0,0,0,2
apache_olingo-odata4.org.apache.olingo.commons.api.edm.EdmMapping,1,0,0,1,0,0,0,0,2
apache_olingo-odata4.org.apache.olingo.commons.core.edm.EdmMemberImpl,1,0,0,1,0,0,0,0,2
apache_olingo-odata4.org.apache.olingo.commons.api.edm.EdmReturnType,1,0,0,1,0,1,0,0,3
apache_olingo-odata4.org.apache.olingo.commons.api.edm.provider.CsdlReturnType,1,0,0,1,0,0,0,0,2
apache_olingo-odata4.org.apache.olingo.commons.api.edm.EdmEntityType,4,0,0,3,0,0,0,0,7
apache_olingo-odata4.org.apache.olingo.commons.core.edm.EdmParameterImpl,1,0,0,1,0,1,0,0,3
apache_olingo-odata4.org.apache.olingo.commons.api.edm.provider.CsdlParameter,1,0,0,1,0,0,0,0,2
apache_olingo-odata4.org.apache.olingo.commons.api.edm.EdmFunction,0,0,0,0,0,0,0,0,0
apache_olingo-odata4.org.apache.olingo.commons.api.edm.EdmReferentialConstraint,2,0,0,2,0,0,0,0,4
apache_olingo-odata4.org.apache.olingo.commons.api.edm.EdmAnnotation,1,0,0,1,0,1,0,0,3
apache_olingo-odata4.org.apache.olingo.commons.api.edm.EdmAnnotatable,2,0,0,2,0,0,0,0,4
apache_olingo-odata4.org.apache.olingo.commons.api.edm.provider.CsdlComplexType,0,0,0,0,0,0,0,1,1
apache_olingo-odata4.org.apache.olingo.commons.api.edm.EdmComplexType,1,0,0,0,0,0,0,0,1
apache_olingo-odata4.org.apache.olingo.client.api.domain.ClientLinked,3,0,0,3,0,1,0,0,7
apache_olingo-odata4.org.apache.olingo.client.api.communication.request.ODataRequest,27,0,0,27,0,4,2,8,68
apache_olingo-odata4.org.apache.olingo.client.api.communication.response.ODataInvokeResponse,2,0,0,2,0,0,0,0,4
apache_olingo-odata4.org.apache.olingo.client.api.communication.request.ODataBasicRequest,70,12,0,69,0,6,0,0,157
apache_olingo-odata4.org.apache.olingo.client.api.domain.ClientValuable,1,0,0,1,0,0,0,0,2
apache_olingo-odata4.org.apache.olingo.client.api.data.ResWrap,1,0,0,1,0,0,0,0,2
apache_olingo-odata4.org.apache.olingo.client.api.domain.ClientAnnotatable,1,0,0,1,0,0,0,0,2
apache_olingo-odata4.org.apache.olingo.client.api.communication.response.ODataResponse,32,2,0,31,0,0,0,0,65
apache_olingo-odata4.org.apache.olingo.client.api.communication.ODataClientErrorException,2,0,0,0,0,18,0,0,20
apache_olingo-odata4.org.apache.olingo.client.api.domain.ClientObjectFactory,7,1,0,6,0,2,1,0,17
apache_olingo-odata4.org.apache.olingo.client.api.edm.xml.Reference,1,0,0,1,0,0,0,0,2
apache_olingo-odata4.org.apache.olingo.client.api.Configuration,1,0,0,1,0,0,0,0,2
apache_olingo-odata4.org.apache.olingo.client.api.communication.request.ODataPayloadManager,1,0,0,1,0,0,0,0,2
apache_olingo-odata4.org.apache.olingo.client.api.communication.request.ODataStreamedRequest,6,0,0,6,0,2,0,0,14
apache_olingo-odata4.org.apache.olingo.client.api.communication.request.batch.BatchManager,2,0,0,2,0,0,0,0,4
apache_olingo-odata4.org.apache.olingo.client.api.communication.request.batch.BatchRequestFactory,1,0,0,1,0,0,0,0,2
allanbank_mongodb-async-driver.com.allanbank.mongodb.DurabilityEditor,0,0,0,0,0,0,0,0,0
allanbank_mongodb-async-driver.com.allanbank.mongodb.ProfilingStatus,5,0,0,4,0,0,0,0,9
allanbank_mongodb-async-driver.com.allanbank.mongodb.CredentialEditor,0,0,0,0,0,0,0,0,0
allanbank_mongodb-async-driver.com.allanbank.mongodb.MongoClientConfiguration,135,12,0,128,0,24,0,1,300
allanbank_mongodb-async-driver.com.allanbank.mongodb.MongoDbConfiguration,1,0,0,1,0,0,0,0,2
allanbank_mongodb-async-driver.com.allanbank.mongodb.Durability,24,1,0,22,0,2,0,1,50
allanbank_mongodb-async-driver.com.allanbank.mongodb.Credential,8,0,0,6,0,0,0,0,14
allanbank_mongodb-async-driver.com.allanbank.mongodb.Version,6,3,0,1,0,0,0,0,10
allanbank_mongodb-async-driver.com.allanbank.mongodb.MongoFactory,0,0,0,0,0,0,0,0,0
allanbank_mongodb-async-driver.com.allanbank.mongodb.MongoClient,1,0,0,1,0,0,0,0,2
allanbank_mongodb-async-driver.com.allanbank.mongodb.Mongo,1,0,0,1,0,0,0,0,2
allanbank_mongodb-async-driver.com.allanbank.mongodb.ReadPreferenceEditor,1,0,0,0,0,0,0,0,1
allanbank_mongodb-async-driver.com.allanbank.mongodb.ReadPreference,9,0,0,9,0,0,0,0,18
allanbank_mongodb-async-driver.com.allanbank.mongodb.bson.builder.DocumentBuilder,62,1,0,60,0,17,0,94,234
allanbank_mongodb-async-driver.com.allanbank.mongodb.bson.builder.BuilderFactory,207,26,0,199,0,46,0,44,522
allanbank_mongodb-async-driver.com.allanbank.mongodb.bson.DocumentEditor,0,0,0,0,0,0,0,0,0
allanbank_mongodb-async-driver.com.allanbank.mongodb.bson.DocumentReference,5,0,0,5,0,0,0,0,10
allanbank_mongodb-async-driver.com.allanbank.mongodb.bson.io.StringEncoder,5,0,0,1,0,0,0,0,6
allanbank_mongodb-async-driver.com.allanbank.mongodb.bson.io.StringDecoderCache,3,0,0,3,0,0,0,0,6
allanbank_mongodb-async-driver.com.allanbank.mongodb.bson.io.BsonInputStream,5,0,0,5,0,0,0,1,11
allanbank_mongodb-async-driver.com.allanbank.mongodb.bson.io.SizeOfVisitor,1,0,0,1,0,0,0,0,2
allanbank_mongodb-async-driver.com.allanbank.mongodb.bson.io.RandomAccessOutputStream,2,0,0,2,0,0,0,1,5
allanbank_mongodb-async-driver.com.allanbank.mongodb.bson.io.StringDecoder,1,0,0,0,0,0,0,0,1
allanbank_mongodb-async-driver.com.allanbank.mongodb.bson.io.EndianUtils,12,1,0,11,0,1,0,0,25
allanbank_mongodb-async-driver.com.allanbank.mongodb.bson.io.BsonOutputStream,1,0,0,1,0,0,0,0,2
allanbank_mongodb-async-driver.com.allanbank.mongodb.bson.Visitor,0,0,0,0,0,0,0,3,3
allanbank_mongodb-async-driver.com.allanbank.mongodb.bson.impl.ImmutableDocument,0,0,0,0,0,0,0,0,0
allanbank_mongodb-async-driver.com.allanbank.mongodb.bson.impl.AbstractDocument,7,0,0,0,0,0,0,0,7
allanbank_mongodb-async-driver.com.allanbank.mongodb.bson.builder.ArrayBuilder,3,0,0,3,0,0,0,0,6
allanbank_mongodb-async-driver.com.allanbank.mongodb.bson.impl.RootDocument,3,0,0,2,0,0,0,0,5
allanbank_mongodb-async-driver.com.allanbank.mongodb.bson.DocumentAssignable,2,1,0,2,0,0,0,0,5
allanbank_mongodb-async-driver.com.allanbank.mongodb.bson.impl.EmptyDocument,0,0,0,0,0,0,0,0,0
allanbank_mongodb-async-driver.com.allanbank.mongodb.bson.Element,19,0,0,1,0,0,0,0,20
allanbank_mongodb-async-driver.com.allanbank.mongodb.bson.builder.impl.DocumentBuilderImpl,12,0,0,10,0,0,0,0,22
allanbank_mongodb-async-driver.com.allanbank.mongodb.bson.builder.impl.ArrayBuilderImpl,14,0,0,11,0,0,0,0,25
allanbank_mongodb-async-driver.com.allanbank.mongodb.bson.json.JsonParser,6,0,0,6,0,0,0,0,12
allanbank_mongodb-async-driver.com.allanbank.mongodb.bson.json.Json,1,0,0,1,0,0,0,0,2
allanbank_mongodb-async-driver.com.allanbank.mongodb.bson.element.MongoTimestampElement,3,0,0,3,0,0,0,1,7
allanbank_mongodb-async-driver.com.allanbank.mongodb.bson.element.AbstractElement,10,0,0,3,0,0,0,0,13
allanbank_mongodb-async-driver.com.allanbank.mongodb.bson.element.TimestampElement,3,0,0,3,0,0,0,1,7
allanbank_mongodb-async-driver.com.allanbank.mongodb.bson.element.JsonSerializationVisitor,0,0,0,0,0,0,0,0,0
allanbank_mongodb-async-driver.com.allanbank.mongodb.bson.element.BooleanElement,5,0,0,3,0,0,0,1,9
allanbank_mongodb-async-driver.com.allanbank.mongodb.bson.element.DocumentElement,9,0,0,4,0,0,0,2,15
allanbank_mongodb-async-driver.com.allanbank.mongodb.bson.element.RegularExpressionElement,5,0,0,4,0,0,0,1,10
allanbank_mongodb-async-driver.com.allanbank.mongodb.bson.element.JavaScriptElement,3,0,0,3,0,0,0,1,7
allanbank_mongodb-async-driver.com.allanbank.mongodb.bson.element.ObjectIdElement,3,0,0,3,0,0,0,1,7
allanbank_mongodb-async-driver.com.allanbank.mongodb.bson.element.SymbolElement,3,0,0,3,0,0,0,1,7
allanbank_mongodb-async-driver.com.allanbank.mongodb.bson.element.UuidElement,4,0,0,4,0,0,0,0,8
allanbank_mongodb-async-driver.com.allanbank.mongodb.bson.element.MaxKeyElement,2,0,0,2,0,0,0,1,5
allanbank_mongodb-async-driver.com.allanbank.mongodb.bson.element.NullElement,2,0,0,2,0,0,0,1,5
allanbank_mongodb-async-driver.com.allanbank.mongodb.bson.element.JavaScriptWithScopeElement,3,0,0,3,0,0,0,1,7
allanbank_mongodb-async-driver.com.allanbank.mongodb.bson.element.BinaryElement,8,0,0,7,0,0,0,1,16
allanbank_mongodb-async-driver.com.allanbank.mongodb.bson.element.ObjectId,3,0,0,2,0,0,0,0,5
allanbank_mongodb-async-driver.com.allanbank.mongodb.bson.element.IntegerElement,3,0,0,3,0,0,0,1,7
allanbank_mongodb-async-driver.com.allanbank.mongodb.bson.element.MinKeyElement,2,0,0,2,0,0,0,1,5
allanbank_mongodb-async-driver.com.allanbank.mongodb.bson.element.ArrayElement,9,0,0,6,0,0,0,2,17
allanbank_mongodb-async-driver.com.allanbank.mongodb.bson.element.LongElement,3,0,0,3,0,0,0,1,7
allanbank_mongodb-async-driver.com.allanbank.mongodb.bson.element.DoubleElement,3,0,0,3,0,0,0,1,7
allanbank_mongodb-async-driver.com.allanbank.mongodb.bson.element.DBPointerElement,3,0,0,3,0,0,0,1,7
allanbank_mongodb-async-driver.com.allanbank.mongodb.bson.element.StringElement,3,0,0,3,0,0,0,1,7
allanbank_mongodb-async-driver.com.allanbank.mongodb.gridfs.GridFs,5,0,0,1,0,3,0,4,13
allanbank_mongodb-async-driver.com.allanbank.mongodb.MongoCollection,7,0,0,6,0,6,0,0,19
allanbank_mongodb-async-driver.com.allanbank.mongodb.util.Assertions,0,0,0,0,0,2,0,0,2
allanbank_mongodb-async-driver.com.allanbank.mongodb.util.PatternUtils,2,0,0,0,0,0,0,0,2
allanbank_mongodb-async-driver.com.allanbank.mongodb.util.IOUtils,4,0,0,0,0,0,0,1,5
allanbank_mongodb-async-driver.com.allanbank.mongodb.util.ServerNameUtils,2,0,0,1,0,0,0,0,3
allanbank_mongodb-async-driver.com.allanbank.mongodb.util.log.Log,19,0,0,0,0,0,0,0,19
allanbank_mongodb-async-driver.com.allanbank.mongodb.util.log.LogFactory,0,0,0,0,0,0,0,0,0
allanbank_mongodb-async-driver.com.allanbank.mongodb.MongoDatabase,2,0,0,2,0,0,0,0,4
allanbank_mongodb-async-driver.com.allanbank.mongodb.client.AbstractMongoOperations,0,0,0,0,0,0,0,0,0
allanbank_mongodb-async-driver.com.allanbank.mongodb.builder.Text,4,0,0,4,0,0,0,0,8
allanbank_mongodb-async-driver.com.allanbank.mongodb.builder.BatchedWrite,15,0,0,15,0,4,0,3,37
allanbank_mongodb-async-driver.com.allanbank.mongodb.client.MongoIteratorImpl,5,0,0,5,0,0,0,0,10
allanbank_mongodb-async-driver.com.allanbank.mongodb.client.Client,7,0,0,7,0,3,0,2,19
allanbank_mongodb-async-driver.com.allanbank.mongodb.client.MongoClientImpl,7,0,0,7,0,0,0,1,15
allanbank_mongodb-async-driver.com.allanbank.mongodb.client.NamedReference,0,0,0,0,0,0,0,0,0
allanbank_mongodb-async-driver.com.allanbank.mongodb.client.SimpleMongoIteratorImpl,1,0,0,1,0,0,0,1,3
allanbank_mongodb-async-driver.com.allanbank.mongodb.client.MongoDatabaseImpl,11,0,0,11,0,0,0,0,22
allanbank_mongodb-async-driver.com.allanbank.mongodb.client.LambdaCallbackAdapter,0,0,0,0,0,0,0,2,2
allanbank_mongodb-async-driver.com.allanbank.mongodb.client.BatchedAsyncMongoCollectionImpl,11,0,0,11,0,1,0,0,23
allanbank_mongodb-async-driver.com.allanbank.mongodb.client.ClientImpl,4,0,0,4,0,1,0,10,19
allanbank_mongodb-async-driver.com.allanbank.mongodb.client.connection.ConnectionFactory,0,0,0,0,0,0,0,8,8
allanbank_mongodb-async-driver.com.allanbank.mongodb.client.SerialClientImpl,3,0,0,3,0,0,0,3,9
allanbank_mongodb-async-driver.com.allanbank.mongodb.client.MongoImpl,1,0,0,1,0,0,0,0,2
allanbank_mongodb-async-driver.com.allanbank.mongodb.client.VersionRange,5,0,0,5,0,0,0,0,10
allanbank_mongodb-async-driver.com.allanbank.mongodb.client.FutureCallback,10,0,0,9,0,8,0,2,29
allanbank_mongodb-async-driver.com.allanbank.mongodb.client.state.Cluster,16,0,0,16,0,0,0,0,32
allanbank_mongodb-async-driver.com.allanbank.mongodb.client.state.Server,7,0,0,7,0,0,0,0,14
allanbank_mongodb-async-driver.com.allanbank.mongodb.client.state.ClusterPinger,16,0,0,16,0,0,0,0,32
allanbank_mongodb-async-driver.com.allanbank.mongodb.client.state.LatencyServerSelector,0,0,0,0,0,0,0,0,0
allanbank_mongodb-async-driver.com.allanbank.mongodb.client.state.ServerUpdateCallback,0,0,0,0,0,0,0,3,3
allanbank_mongodb-async-driver.com.allanbank.mongodb.client.state.SimpleReconnectStrategy,1,0,0,1,0,0,0,0,2
allanbank_mongodb-async-driver.com.allanbank.mongodb.client.metrics.LogMessagesListener,0,0,0,0,0,0,0,0,0
allanbank_mongodb-async-driver.com.allanbank.mongodb.client.metrics.AbstractMetrics,1,0,0,1,0,0,0,0,2
allanbank_mongodb-async-driver.com.allanbank.mongodb.client.metrics.NoOpMongoMessageListener,0,0,0,0,0,0,0,3,3
allanbank_mongodb-async-driver.com.allanbank.mongodb.client.metrics.jmx.JmxSupport,10,0,0,0,0,0,0,0,10
allanbank_mongodb-async-driver.com.allanbank.mongodb.client.metrics.jmx.JmxDatabaseMetrics,0,0,0,0,0,0,0,3,3
allanbank_mongodb-async-driver.com.allanbank.mongodb.client.metrics.jmx.JmxServerMetricsListener,0,0,0,0,0,0,0,2,2
allanbank_mongodb-async-driver.com.allanbank.mongodb.client.metrics.jmx.JmxOperationMetricsListener,0,0,0,0,0,0,0,2,2
allanbank_mongodb-async-driver.com.allanbank.mongodb.client.metrics.jmx.JmxCollectionMetrics,0,0,0,0,0,0,0,1,1
allanbank_mongodb-async-driver.com.allanbank.mongodb.client.metrics.jmx.JmxLogicalMetricsListener,0,0,0,0,0,0,0,2,2
allanbank_mongodb-async-driver.com.allanbank.mongodb.client.metrics.jmx.JmxOperationMetrics,0,0,0,0,0,0,0,1,1
allanbank_mongodb-async-driver.com.allanbank.mongodb.client.metrics.jmx.JmxMongoClientMetrics,0,0,0,0,0,0,0,2,2
allanbank_mongodb-async-driver.com.allanbank.mongodb.client.metrics.jmx.JmxServerMetrics,0,0,0,0,0,0,0,1,1
allanbank_mongodb-async-driver.com.allanbank.mongodb.client.metrics.jmx.JmxMetricsRegistrar,0,0,0,0,0,0,0,0,0
allanbank_mongodb-async-driver.com.allanbank.mongodb.client.metrics.jmx.JmxConnectionMetrics,0,0,0,0,0,0,0,1,1
allanbank_mongodb-async-driver.com.allanbank.mongodb.client.metrics.noop.NoOpMetricsRegistrar,0,0,0,0,0,0,0,0,0
allanbank_mongodb-async-driver.com.allanbank.mongodb.client.metrics.noop.NoOpMongoClientMetrics,0,0,0,0,0,0,0,3,3
allanbank_mongodb-async-driver.com.allanbank.mongodb.client.metrics.basic.BasicDatabaseMetrics,2,0,0,2,0,0,0,0,4
allanbank_mongodb-async-driver.com.allanbank.mongodb.client.metrics.basic.BasicMongoClientMetrics,0,0,0,0,0,0,0,3,3
allanbank_mongodb-async-driver.com.allanbank.mongodb.client.metrics.basic.BasicOperationMetrics,0,0,0,0,0,0,0,0,0
allanbank_mongodb-async-driver.com.allanbank.mongodb.client.metrics.basic.BasicServerMetricsListener,2,0,0,2,0,0,0,0,4
allanbank_mongodb-async-driver.com.allanbank.mongodb.client.metrics.basic.BasicLogicalMetricsListener,2,0,0,2,0,0,0,0,4
allanbank_mongodb-async-driver.com.allanbank.mongodb.client.metrics.basic.BasicMetricsRegistrar,0,0,0,0,0,0,0,0,0
allanbank_mongodb-async-driver.com.allanbank.mongodb.client.metrics.basic.BasicConnectionMetrics,0,0,0,0,0,0,0,2,2
allanbank_mongodb-async-driver.com.allanbank.mongodb.client.metrics.basic.BasicCollectionMetrics,0,0,0,0,0,0,0,0,0
allanbank_mongodb-async-driver.com.allanbank.mongodb.client.metrics.basic.BasicServerMetrics,0,0,0,0,0,0,0,0,0
allanbank_mongodb-async-driver.com.allanbank.mongodb.client.metrics.basic.BasicOperationMetricsListener,2,0,0,2,0,0,0,0,4
allanbank_mongodb-async-driver.com.allanbank.mongodb.client.callback.CursorCallback,2,0,0,2,0,0,0,0,4
allanbank_mongodb-async-driver.com.allanbank.mongodb.client.callback.ReplyCommandCallback,0,0,0,0,0,0,0,0,0
allanbank_mongodb-async-driver.com.allanbank.mongodb.client.callback.ReplyLongCallback,0,0,0,0,0,0,0,0,0
allanbank_mongodb-async-driver.com.allanbank.mongodb.client.callback.CursorStreamingCallback,3,0,0,3,0,0,0,9,15
allanbank_mongodb-async-driver.com.allanbank.mongodb.client.callback.NoOpCallback,0,0,0,0,0,0,0,2,2
allanbank_mongodb-async-driver.com.allanbank.mongodb.client.callback.BatchedWriteCallback,13,0,0,13,0,0,0,0,26
allanbank_mongodb-async-driver.com.allanbank.mongodb.client.callback.IteratorToListCallbackAdapter,0,0,0,0,0,1,0,2,3
allanbank_mongodb-async-driver.com.allanbank.mongodb.client.callback.ReplyHandler,0,0,0,0,0,0,0,10,10
allanbank_mongodb-async-driver.com.allanbank.mongodb.client.callback.SingleDocumentReplyCallback,0,0,0,0,0,0,0,0,0
allanbank_mongodb-async-driver.com.allanbank.mongodb.client.callback.TextCallback,0,0,0,0,0,0,0,1,1
allanbank_mongodb-async-driver.com.allanbank.mongodb.client.callback.LongToIntCallback,0,0,0,0,0,0,0,2,2
allanbank_mongodb-async-driver.com.allanbank.mongodb.client.callback.LegacyStreamCallbackAdapter,0,0,0,0,0,0,0,3,3
allanbank_mongodb-async-driver.com.allanbank.mongodb.client.callback.ReplyDocumentCallback,0,0,0,0,0,0,0,0,0
allanbank_mongodb-async-driver.com.allanbank.mongodb.client.callback.ReplyArrayCallback,0,0,0,0,0,0,0,0,0
allanbank_mongodb-async-driver.com.allanbank.mongodb.client.callback.ReplyIntegerCallback,0,0,0,0,0,0,0,0,0
allanbank_mongodb-async-driver.com.allanbank.mongodb.client.callback.ReplyResultCallback,0,0,0,0,0,0,0,0,0
allanbank_mongodb-async-driver.com.allanbank.mongodb.client.callback.BatchedNativeWriteCallback,4,0,0,4,0,0,0,0,8
allanbank_mongodb-async-driver.com.allanbank.mongodb.client.Message,5,0,0,5,0,0,0,0,10
allanbank_mongodb-async-driver.com.allanbank.mongodb.client.connection.socket.SocketConnectionFactory,3,0,0,2,0,0,0,1,6
allanbank_mongodb-async-driver.com.allanbank.mongodb.client.connection.socket.Sequence,3,0,0,3,0,0,0,0,6
allanbank_mongodb-async-driver.com.allanbank.mongodb.client.connection.socket.TransportConnection,3,0,0,2,0,0,0,0,5
allanbank_mongodb-async-driver.com.allanbank.mongodb.client.message.Delete,5,0,0,5,0,2,0,1,13
allanbank_mongodb-async-driver.com.allanbank.mongodb.client.message.Insert,5,1,0,5,0,3,0,1,15
allanbank_mongodb-async-driver.com.allanbank.mongodb.client.message.GetMore,3,0,0,3,0,1,0,1,8
allanbank_mongodb-async-driver.com.allanbank.mongodb.client.message.KillCursors,4,0,0,4,0,2,0,1,11
allanbank_mongodb-async-driver.com.allanbank.mongodb.client.message.Query,9,0,0,9,0,2,0,2,22
allanbank_mongodb-async-driver.com.allanbank.mongodb.client.message.Update,4,0,0,4,0,3,0,2,13
allanbank_mongodb-async-driver.com.allanbank.mongodb.client.message.PendingMessage,3,0,0,3,0,0,0,0,6
allanbank_mongodb-async-driver.com.allanbank.mongodb.client.connection.Connection,2,0,0,0,0,2,0,10,14
allanbank_mongodb-async-driver.com.allanbank.mongodb.client.connection.rs.ReplicaSetReconnectStrategy,4,0,0,4,0,0,0,0,8
allanbank_mongodb-async-driver.com.allanbank.mongodb.client.connection.rs.ReplicaSetConnectionFactory,3,0,0,3,0,0,0,4,10
allanbank_mongodb-async-driver.com.allanbank.mongodb.client.connection.proxy.ProxiedConnectionFactory,0,0,0,0,0,0,0,0,0
allanbank_mongodb-async-driver.com.allanbank.mongodb.client.connection.auth.CredentialsCallbackHandler,0,0,0,0,0,4,0,0,4
allanbank_mongodb-async-driver.com.allanbank.mongodb.client.connection.auth.SaslResponseCallback,6,0,0,0,0,6,0,0,12
allanbank_mongodb-async-driver.com.allanbank.mongodb.client.connection.auth.X509Authenticator,1,0,0,0,0,0,0,0,1
allanbank_mongodb-async-driver.com.allanbank.mongodb.client.connection.auth.MongoDbAuthenticator,6,0,0,6,0,0,0,0,12
allanbank_mongodb-async-driver.com.allanbank.mongodb.client.connection.auth.X509ResponseCallback,2,0,0,0,0,2,0,0,4
allanbank_mongodb-async-driver.com.allanbank.mongodb.client.connection.auth.AuthenticationConnectionFactory,0,0,0,0,0,0,0,1,1
allanbank_mongodb-async-driver.com.allanbank.mongodb.client.connection.auth.ScramSha1Authenticator,0,0,0,0,0,0,0,0,0
allanbank_mongodb-async-driver.com.allanbank.mongodb.client.connection.auth.ScramSaslClient,12,0,0,8,0,6,0,0,26
allanbank_mongodb-async-driver.com.allanbank.mongodb.client.connection.auth.AuthenticatingConnection,6,0,0,2,0,5,0,7,20
allanbank_mongodb-async-driver.com.allanbank.mongodb.client.connection.bootstrap.BootstrapConnectionFactory,4,0,0,4,0,1,0,1,10
allanbank_mongodb-async-driver.com.allanbank.mongodb.client.connection.proxy.AbstractProxyConnection,8,0,0,0,0,9,0,8,25
allanbank_mongodb-async-driver.com.allanbank.mongodb.client.connection.sharded.ShardedConnectionFactory,5,0,0,5,0,1,0,1,12
allanbank_mongodb-async-driver.com.allanbank.mongodb.client.connection.sharded.ShardedConnection,6,0,0,6,0,0,0,0,12
allanbank_mongodb-async-driver.com.allanbank.mongodb.client.message.AbstractMessage,5,0,0,5,0,0,0,0,10
allanbank_mongodb-async-driver.com.allanbank.mongodb.client.message.BatchedWriteCommand,1,0,0,1,0,0,0,0,2
allanbank_mongodb-async-driver.com.allanbank.mongodb.client.message.ParallelScanCommand,1,0,0,1,0,0,0,0,2
allanbank_mongodb-async-driver.com.allanbank.mongodb.client.message.PendingMessageQueue,26,0,0,20,0,22,0,0,68
allanbank_mongodb-async-driver.com.allanbank.mongodb.client.message.Header,1,0,0,1,0,0,0,0,2
allanbank_mongodb-async-driver.com.allanbank.mongodb.client.message.AggregateCommand,1,0,0,1,0,0,0,0,2
allanbank_mongodb-async-driver.com.allanbank.mongodb.client.message.ListCollectionsCommand,2,0,0,2,0,0,0,0,4
allanbank_mongodb-async-driver.com.allanbank.mongodb.builder.ConditionBuilder,189,0,0,189,0,1,0,0,379
allanbank_mongodb-async-driver.com.allanbank.mongodb.client.message.Command,2,0,0,2,0,1,0,0,5
allanbank_mongodb-async-driver.com.allanbank.mongodb.builder.Index,6,0,0,6,0,0,0,0,12
allanbank_mongodb-async-driver.com.allanbank.mongodb.client.message.Reply,2,0,0,2,0,0,0,1,5
allanbank_mongodb-async-driver.com.allanbank.mongodb.client.message.QueryVersionVisitor,1,0,0,1,0,0,0,0,2
allanbank_mongodb-async-driver.com.allanbank.mongodb.client.message.ListIndexesCommand,2,0,0,2,0,0,0,0,4
allanbank_mongodb-async-driver.com.allanbank.mongodb.builder.ListIndexes,4,0,0,4,0,0,0,0,8
allanbank_mongodb-async-driver.com.allanbank.mongodb.builder.AggregationGeoNear,4,0,0,4,0,0,0,0,8
allanbank_mongodb-async-driver.com.allanbank.mongodb.builder.Aggregate,19,0,0,18,0,0,0,0,37
allanbank_mongodb-async-driver.com.allanbank.mongodb.builder.AggregationGroupId,2,0,0,2,0,0,0,0,4
allanbank_mongodb-async-driver.com.allanbank.mongodb.builder.expression.Expressions,42,0,0,42,0,0,0,0,84
allanbank_mongodb-async-driver.com.allanbank.mongodb.builder.Sort,2,0,0,1,0,0,0,0,3
allanbank_mongodb-async-driver.com.allanbank.mongodb.builder.TextResult,3,0,0,3,0,0,0,0,6
allanbank_mongodb-async-driver.com.allanbank.mongodb.builder.Distinct,4,0,0,4,0,0,0,0,8
allanbank_mongodb-async-driver.com.allanbank.mongodb.builder.GeoJson,0,0,0,0,0,0,0,0,0
allanbank_mongodb-async-driver.com.allanbank.mongodb.builder.FindAndModify,4,0,0,4,0,0,0,0,8
allanbank_mongodb-async-driver.com.allanbank.mongodb.builder.Find,19,0,0,19,0,0,0,0,38
allanbank_mongodb-async-driver.com.allanbank.mongodb.builder.Count,3,0,0,3,0,0,0,0,6
allanbank_mongodb-async-driver.com.allanbank.mongodb.builder.ParallelScan,2,0,0,2,0,0,0,0,4
allanbank_mongodb-async-driver.com.allanbank.mongodb.builder.GroupBy,4,0,0,4,0,0,0,0,8
allanbank_mongodb-async-driver.com.allanbank.mongodb.builder.QueryBuilder,1,0,0,1,0,2,0,0,4
allanbank_mongodb-async-driver.com.allanbank.mongodb.builder.AggregationGroupField,0,0,0,0,0,0,0,0,0
allanbank_mongodb-async-driver.com.allanbank.mongodb.builder.ListCollections,5,0,0,5,0,0,0,0,10
allanbank_mongodb-async-driver.com.allanbank.mongodb.builder.MapReduce,6,0,0,6,0,0,0,0,12
allanbank_mongodb-async-driver.com.allanbank.mongodb.builder.AggregationProjectFields,0,0,0,0,0,0,0,0,0
allanbank_mongodb-async-driver.com.allanbank.mongodb.builder.write.DeleteOperation,2,0,0,1,0,0,0,0,3
allanbank_mongodb-async-driver.com.allanbank.mongodb.builder.write.UpdateOperation,2,0,0,1,0,0,0,0,3
allanbank_mongodb-async-driver.com.allanbank.mongodb.builder.write.InsertOperation,1,0,0,1,0,0,0,0,2
allanbank_mongodb-async-driver.com.allanbank.mongodb.builder.expression.Constant,0,0,0,0,0,0,0,0,0
allanbank_mongodb-async-driver.com.allanbank.mongodb.builder.expression.Expression,0,0,0,0,0,0,0,0,0
allanbank_mongodb-async-driver.com.allanbank.mongodb.error.ReplyException,12,0,0,8,0,0,0,0,20
allanbank_mongodb-async-driver.com.allanbank.mongodb.error.DocumentToLargeException,1,0,0,1,0,0,0,0,2
allanbank_mongodb-async-driver.com.allanbank.mongodb.error.JsonParseException,6,0,0,6,0,0,0,0,12
allanbank_mongodb-async-driver.com.allanbank.mongodb.error.ServerVersionException,4,0,0,4,0,1,0,0,9
allanbank_mongodb-async-driver.com.allanbank.mongodb.error.MongoClientClosedException,5,0,0,0,0,0,0,0,5
tlaukkan_zigbee4java.org.bubblecloud.zigbee.network.impl.ZigBeeNetworkManagerImpl,0,0,0,0,0,0,2,2,4
tlaukkan_zigbee4java.org.bubblecloud.zigbee.network.discovery.ZigBeeDiscoveryManager,0,0,0,0,0,0,2,2,4
tlaukkan_zigbee4java.org.bubblecloud.zigbee.ZigBeeApi,0,0,0,0,0,0,2,2,4
tlaukkan_zigbee4java.org.bubblecloud.zigbee.v3.ZigBeeGatewayClient,1,0,0,1,0,0,1,0,3
tlaukkan_zigbee4java.org.bubblecloud.zigbee.network.impl.NetworkStateSerializer,1,0,0,1,0,0,0,0,2
tlaukkan_zigbee4java.org.bubblecloud.zigbee.network.packet.ZToolPacketStream,1,0,0,0,0,0,0,0,1
tlaukkan_zigbee4java.org.bubblecloud.zigbee.network.packet.ZToolPacketParser,1,0,0,1,0,0,1,0,3
tlaukkan_zigbee4java.org.bubblecloud.zigbee.network.packet.ZToolPacket,4,0,0,1,0,0,0,0,5
tlaukkan_zigbee4java.org.bubblecloud.zigbee.network.packet.zdo.ZDO_IEEE_ADDR_REQ,3,0,0,0,0,0,0,0,3
tlaukkan_zigbee4java.org.bubblecloud.zigbee.network.packet.zdo.ZDO_SIMPLE_DESC_RSP,6,0,0,0,0,0,0,2,8
tlaukkan_zigbee4java.org.bubblecloud.zigbee.network.packet.zdo.ZDO_IEEE_ADDR_RSP,1,0,0,0,0,0,0,0,1
tlaukkan_zigbee4java.org.bubblecloud.zigbee.network.packet.zdo.ZDO_ACTIVE_EP_RSP,1,0,0,0,0,0,0,0,1
tlaukkan_zigbee4java.org.bubblecloud.zigbee.network.packet.zdo.ZDO_MGMT_LQI_RSP,1,0,0,1,0,0,0,0,2
tlaukkan_zigbee4java.org.bubblecloud.zigbee.network.packet.af.AF_DATA_CONFIRM,1,0,0,0,0,0,0,0,1
tlaukkan_zigbee4java.org.bubblecloud.zigbee.api.cluster.impl.global.write.WriteAttributeCommand,0,0,0,0,0,0,0,0,0
tlaukkan_zigbee4java.org.bubblecloud.zigbee.api.cluster.impl.global.reporting.ConfigureReportingCommand,0,0,0,0,0,0,0,0,0
tlaukkan_zigbee4java.org.bubblecloud.zigbee.api.cluster.impl.general.alarms.ResetAlarmCommand,0,0,0,0,0,0,0,0,0
tlaukkan_zigbee4java.org.bubblecloud.zigbee.api.cluster.impl.general.GroupsCluster,2,0,0,2,0,2,2,0,8
tlaukkan_zigbee4java.org.bubblecloud.zigbee.api.cluster.impl.general.AlarmsCluster,1,0,0,0,0,1,1,0,3
tlaukkan_zigbee4java.org.bubblecloud.zigbee.api.cluster.impl.general.groups.AddGroupIfIdentyfingCommand,1,0,0,0,0,0,0,0,1
tlaukkan_zigbee4java.org.bubblecloud.zigbee.api.cluster.impl.general.groups.GetGroupMembershipResponseImpl,1,0,0,1,0,1,0,0,3
tlaukkan_zigbee4java.org.bubblecloud.zigbee.api.cluster.impl.general.groups.GetGroupMembershipCommand,0,0,0,0,0,0,0,0,0
tlaukkan_zigbee4java.org.bubblecloud.zigbee.api.cluster.impl.general.groups.AddGroupResponseImpl,1,0,0,1,0,1,0,0,3
tlaukkan_zigbee4java.org.bubblecloud.zigbee.api.cluster.impl.general.groups.AddGroupCommand,0,0,0,0,0,0,0,0,0
tlaukkan_zigbee4java.org.bubblecloud.zigbee.api.cluster.impl.general.groups.ViewGroupResponseImpl,1,0,0,1,0,1,0,0,3
tlaukkan_zigbee4java.org.bubblecloud.zigbee.api.cluster.impl.general.level_control.StepCommand,0,0,0,0,0,0,0,0,0
tlaukkan_zigbee4java.org.bubblecloud.zigbee.v3.ZigBeeNetworkState,0,0,0,0,0,0,1,1,2
tlaukkan_zigbee4java.org.bubblecloud.zigbee.v3.zcl.protocol.command.door.lock.LockDoorCommand,0,0,0,0,0,0,0,1,1
tlaukkan_zigbee4java.org.bubblecloud.zigbee.v3.zcl.protocol.command.door.lock.UnlockDoorCommand,0,0,0,0,0,0,0,1,1
tlaukkan_zigbee4java.org.bubblecloud.zigbee.v3.zcl.protocol.command.general.DiscoverAttributesCommand,0,0,0,0,0,0,0,1,1
tlaukkan_zigbee4java.org.bubblecloud.zigbee.v3.zcl.protocol.command.general.DiscoverAttributesResponseCommand,0,0,0,0,0,0,0,1,1
tlaukkan_zigbee4java.org.bubblecloud.zigbee.v3.zcl.field.AttributeIdentifier,0,0,0,0,0,0,0,1,1
tlaukkan_zigbee4java.org.bubblecloud.zigbee.v3.zcl.field.ReadAttributeStatusRecord,0,0,0,0,0,0,0,1,1
tlaukkan_zigbee4java.org.bubblecloud.zigbee.v3.zcl.field.WriteAttributeRecord,0,0,0,0,0,0,0,3,3
tlaukkan_zigbee4java.org.bubblecloud.zigbee.v3.zcl.field.WriteAttributeStatusRecord,0,0,0,0,0,0,0,1,1
tlaukkan_zigbee4java.org.bubblecloud.zigbee.v3.zcl.field.AttributeReportingConfigurationRecord,0,0,0,0,0,0,0,2,2
tlaukkan_zigbee4java.org.bubblecloud.zigbee.v3.zcl.field.AttributeStatusRecord,0,0,0,0,0,0,0,1,1
tlaukkan_zigbee4java.org.bubblecloud.zigbee.v3.zcl.field.AttributeRecord,0,0,0,0,0,0,0,1,1
tlaukkan_zigbee4java.org.bubblecloud.zigbee.v3.zcl.field.AttributeReport,0,0,0,0,0,0,0,1,1
tlaukkan_zigbee4java.org.bubblecloud.zigbee.v3.zcl.protocol.command.scenes.AddSceneCommand,0,0,0,0,0,0,0,1,1
tlaukkan_zigbee4java.org.bubblecloud.zigbee.v3.zcl.protocol.command.rssi.location.ReportRssiMeasurementsCommand,0,0,0,0,0,0,0,1,1
tlaukkan_zigbee4java.org.bubblecloud.zigbee.v3.zcl.protocol.command.ias.ace.BypassCommand,0,0,0,0,0,0,0,1,1
tlaukkan_zigbee4java.org.bubblecloud.zigbee.v3.zcl.protocol.command.groups.GetGroupMembershipCommand,0,0,0,0,0,0,0,1,1
tlaukkan_zigbee4java.org.bubblecloud.zigbee.util.ByteUtils,1,0,0,1,0,0,0,0,2
Team254_TrajectoryLib.com.team254.lib.trajectory.WaypointSequence,1,0,0,1,0,0,0,8,10
tkaczmarzyk_specification-arg-resolver.net.kaczmarzyk.spring.data.jpa.utils.JoinPathUtils,1,0,0,0,0,0,0,0,1
tkaczmarzyk_specification-arg-resolver.net.kaczmarzyk.spring.data.jpa.utils.PathVariableResolver,1,0,0,0,0,0,0,0,1
tkaczmarzyk_specification-arg-resolver.net.kaczmarzyk.spring.data.jpa.utils.Converter,2,0,0,0,0,0,0,1,3
tkaczmarzyk_specification-arg-resolver.net.kaczmarzyk.spring.data.jpa.utils.TypeUtil,0,0,0,0,0,0,0,0,0
tkaczmarzyk_specification-arg-resolver.net.kaczmarzyk.spring.data.jpa.web.WebRequestProcessingContext,26,0,0,0,0,0,0,1,27
tkaczmarzyk_specification-arg-resolver.net.kaczmarzyk.spring.data.jpa.web.AndSpecificationResolver,0,0,0,0,0,0,0,0,0
tkaczmarzyk_specification-arg-resolver.net.kaczmarzyk.spring.data.jpa.web.SimpleSpecificationResolver,5,0,0,3,0,0,0,0,8
tkaczmarzyk_specification-arg-resolver.net.kaczmarzyk.spring.data.jpa.web.RepeatedJoinFetchResolver,0,0,0,0,0,0,0,0,0
tkaczmarzyk_specification-arg-resolver.net.kaczmarzyk.spring.data.jpa.web.SpecificationArgumentResolver,5,0,0,5,0,0,0,0,10
tkaczmarzyk_specification-arg-resolver.net.kaczmarzyk.spring.data.jpa.web.OrSpecificationResolver,0,0,0,0,0,0,0,0,0
tkaczmarzyk_specification-arg-resolver.net.kaczmarzyk.spring.data.jpa.web.ConjunctionSpecificationResolver,0,0,0,0,0,0,0,0,0
tkaczmarzyk_specification-arg-resolver.net.kaczmarzyk.spring.data.jpa.web.RepeatedJoinResolver,0,0,0,0,0,0,0,0,0
tkaczmarzyk_specification-arg-resolver.net.kaczmarzyk.spring.data.jpa.web.DisjunctionSpecificationResolver,0,0,0,0,0,0,0,0,0
twitter_hpack.com.twitter.hpack.HuffmanDecoder,0,0,0,0,0,0,0,1,1
twitter_hpack.com.twitter.hpack.Decoder,3,0,0,0,0,0,0,0,3
recruit-tech_redpen.cc.redpen.validator.sentence.WeakExpressionValidator,1,0,0,1,0,0,0,0,2
recruit-tech_redpen.cc.redpen.config.Configuration,215,0,0,211,0,10,0,0,436
recruit-tech_redpen.cc.redpen.model.Document,92,0,0,89,0,0,0,0,181
recruit-tech_redpen.cc.redpen.validator.ValidatorFactory,19,0,0,19,0,0,0,1,39
recruit-tech_redpen.cc.redpen.validator.sentence.ParenthesizedSentenceValidator,1,0,0,1,0,0,0,0,2
recruit-tech_redpen.cc.redpen.RedPen,12,0,0,11,0,0,0,0,23
recruit-tech_redpen.cc.redpen.validator.sentence.HyphenationValidator,1,0,0,1,0,0,0,0,2
recruit-tech_redpen.cc.redpen.validator.sentence.KatakanaEndHyphenValidator,0,0,0,0,0,0,0,0,0
recruit-tech_redpen.cc.redpen.validator.sentence.SentenceLengthValidator,0,0,0,0,0,0,0,0,0
recruit-tech_redpen.cc.redpen.validator.sentence.SpaceBetweenAlphabeticalWordValidator,1,0,0,0,0,0,0,0,1
recruit-tech_redpen.cc.redpen.validator.Validator,11,0,0,9,0,0,0,0,20
recruit-tech_redpen.cc.redpen.validator.sentence.EndOfSentenceValidator,0,0,0,0,0,0,0,0,0
recruit-tech_redpen.cc.redpen.validator.sentence.NumberFormatValidator,0,0,0,0,0,0,0,0,0
recruit-tech_redpen.cc.redpen.validator.sentence.WordNumberValidator,3,0,0,3,0,0,0,0,6
recruit-tech_redpen.cc.redpen.validator.sentence.KatakanaSpellCheckValidator,1,0,0,1,0,0,0,0,2
recruit-tech_redpen.cc.redpen.validator.JavaScriptValidator,4,0,0,3,0,0,0,0,7
recruit-tech_redpen.cc.redpen.model.Section,15,0,0,15,0,0,0,0,30
recruit-tech_redpen.cc.redpen.model.Paragraph,11,0,0,11,0,0,0,0,22
recruit-tech_redpen.cc.redpen.model.Sentence,2,0,0,2,0,0,0,0,4
recruit-tech_redpen.cc.redpen.model.ListBlock,7,0,0,7,0,0,0,0,14
recruit-tech_redpen.cc.redpen.Main,1,1,0,0,0,0,0,0,2
recruit-tech_redpen.cc.redpen.formatter.Formatter,0,0,0,0,0,0,0,0,0
recruit-tech_redpen.cc.redpen.tokenizer.TokenElement,0,0,0,0,0,0,0,0,0
recruit-tech_redpen.cc.redpen.tokenizer.NeologdJapaneseTokenizer,1,0,0,1,0,0,0,0,2
recruit-tech_redpen.cc.redpen.tokenizer.RedPenTokenizer,4,0,0,4,0,0,0,0,8
recruit-tech_redpen.cc.redpen.config.SymbolTable,5,0,0,5,0,0,0,0,10
recruit-tech_redpen.cc.redpen.config.ConfigurationLoader,14,0,0,14,0,0,0,0,28
recruit-tech_redpen.cc.redpen.config.ValidatorConfiguration,1,0,0,1,0,0,0,0,2
recruit-tech_redpen.cc.redpen.config.ConfigurationExporter,0,0,0,0,0,0,0,0,0
recruit-tech_redpen.cc.redpen.parser.SentenceExtractor,22,0,0,22,0,0,0,1,45
recruit-tech_redpen.cc.redpen.parser.LineOffset,2,0,0,0,0,0,0,0,2
recruit-tech_redpen.cc.redpen.parser.markdown.MergedCandidateSentence,1,0,0,1,0,0,0,0,2
recruit-tech_redpen.cc.redpen.parser.common.Line,0,0,0,0,0,0,0,0,0
recruit-tech_redpen.cc.redpen.parser.review.ReVIEWParser,2,0,0,0,0,0,0,0,2
recruit-tech_redpen.cc.redpen.parser.latex.Lexer,1,0,0,0,0,0,0,0,1
recruit-tech_redpen.cc.redpen.util.DictionaryLoader,2,0,0,0,0,0,0,0,2
recruit-tech_redpen.cc.redpen.util.LanguageDetector,1,0,0,0,0,0,0,0,1
recruit-tech_redpen.cc.redpen.util.StringUtils,0,0,0,0,0,0,0,0,0
recruit-tech_redpen.cc.redpen.util.LevenshteinDistance,5,0,0,4,0,0,0,0,9
recruit-tech_redpen.cc.redpen.util.EndOfSentenceDetector,1,0,0,0,0,0,0,0,1
recruit-tech_redpen.cc.redpen.util.RuleExtractor,3,0,0,0,0,0,0,0,3
recruit-tech_redpen.cc.redpen.validator.document.GappedSectionValidator,0,0,0,0,0,0,0,0,0
recruit-tech_redpen.cc.redpen.validator.document.FrequentSentenceStartValidator,0,0,0,0,0,0,0,0,0
recruit-tech_redpen.cc.redpen.validator.document.WordFrequencyValidator,0,0,0,0,0,0,0,0,0
recruit-tech_redpen.cc.redpen.validator.section.EmptySectionValidator,0,0,0,0,0,0,0,0,0
recruit-tech_redpen.cc.redpen.validator.section.ParagraphNumberValidator,0,0,0,0,0,0,0,0,0
recruit-tech_redpen.cc.redpen.validator.section.HeaderLengthValidator,0,0,0,0,0,0,0,0,0
recruit-tech_redpen.cc.redpen.validator.section.SectionLevelValidator,0,0,0,0,0,0,0,0,0
recruit-tech_redpen.cc.redpen.validator.section.ListLevelValidator,0,0,0,0,0,0,0,0,0
recruit-tech_redpen.cc.redpen.validator.section.VoidSectionValidator,0,0,0,0,0,0,0,0,0
recruit-tech_redpen.cc.redpen.validator.section.SectionLengthValidator,0,0,0,0,0,0,0,0,0
recruit-tech_redpen.cc.redpen.server.api.CORSFilter,0,0,0,0,0,0,0,3,3
recruit-tech_redpen.cc.redpen.server.api.RedPenService,3,0,0,3,0,0,0,0,6
recruit-tech_redpen.cc.redpen.server.api.RedPenConfigurationResource,2,0,0,0,0,0,0,0,2
recruit-tech_redpen.cc.redpen.server.api.RedPenResource,2,0,0,0,0,1,0,0,3
dropwizard_dropwizard-java8.io.dropwizard.java8.jdbi.args.LocalDateMapper,0,0,0,0,0,0,0,0,0
dropwizard_dropwizard-java8.io.dropwizard.java8.jdbi.args.LocalDateTimeMapper,0,0,0,0,0,0,0,0,0
dropwizard_dropwizard-java8.io.dropwizard.java8.jdbi.args.InstantMapper,0,0,0,0,0,0,0,0,0
dropwizard_dropwizard-java8.io.dropwizard.java8.jdbi.args.LocalDateArgument,0,0,0,0,0,0,0,2,2
dropwizard_dropwizard-java8.io.dropwizard.java8.jdbi.args.InstantArgument,0,0,0,0,0,0,0,3,3
dropwizard_dropwizard-java8.io.dropwizard.java8.jdbi.args.LocalDateTimeArgument,0,0,0,0,0,0,0,2,2
dropwizard_dropwizard-java8.com.example.helloworld.db.PersonDAO,1,0,0,0,0,0,0,0,1
dropwizard_dropwizard-java8.com.example.helloworld.api.Saying,0,0,0,0,0,0,0,0,0
dropwizard_dropwizard-java8.com.example.helloworld.core.Person,1,0,0,1,0,0,0,0,2
dropwizard_dropwizard-java8.io.dropwizard.java8.auth.CachingAuthenticator,2,0,0,1,0,0,0,1,4
jtrfp_terminal-recall.org.jtrfp.trcl.obj.MiniMap,0,0,0,0,0,0,0,0,0
jtrfp_terminal-recall.org.jtrfp.trcl.img.vq.CompositeVectorListND,0,0,0,0,0,0,0,0,0
jtrfp_terminal-recall.org.jtrfp.trcl.tools.Util,0,0,0,0,0,0,0,0,0
jtrfp_terminal-recall.org.jtrfp.trcl.file.PODINIFile,2,0,0,0,0,0,0,0,2
jtrfp_terminal-recall.org.jtrfp.trcl.math.Mat4x4,1,0,0,0,0,0,0,0,1
jtrfp_terminal-recall.org.jtrfp.trcl.math.ColumnMajorTranslationMatrixFactory,1,0,0,1,0,0,0,0,2
jtrfp_terminal-recall.org.jtrfp.trcl.snd.AudioDriver,0,0,0,0,0,0,0,6,6
jtrfp_terminal-recall.org.jtrfp.trcl.core.FeaturesImpl,3,0,0,3,0,0,0,2,8
jtrfp_terminal-recall.org.jtrfp.trcl.flow.TransientExecutor,0,0,0,0,0,1,0,0,1
jtrfp_terminal-recall.org.jtrfp.trcl.core.GroupMutex,0,0,0,0,0,0,0,3,3
jtrfp_terminal-recall.org.jtrfp.trcl.pool.IndexPool,3,0,0,3,0,0,0,0,6
jtrfp_terminal-recall.org.jtrfp.trcl.pool.EntryBasedIndexPool,6,0,0,4,0,0,0,1,11
jtrfp_terminal-recall.org.jtrfp.trcl.pool.IndexList,10,0,0,6,0,0,0,0,16
jtrfp_terminal-recall.org.jtrfp.trcl.coll.PropertyBasedTagger,8,0,0,3,0,0,0,0,11
jtrfp_terminal-recall.org.jtrfp.trcl.coll.ListActionAdapter,12,0,0,10,0,0,0,0,22
jtrfp_terminal-recall.org.jtrfp.trcl.coll.ListActionTelemetry,6,0,0,3,0,0,0,0,9
jtrfp_terminal-recall.org.jtrfp.trcl.SpacePartitioningGrid,2,0,0,1,0,0,0,0,3
jtrfp_terminal-recall.org.jtrfp.trcl.coll.CollectionActionDispatcher,3,0,0,2,0,0,0,0,5
jtrfp_terminal-recall.org.jtrfp.trcl.coll.PredicatedORCollectionActionFilter,10,0,0,3,0,0,0,0,13
jtrfp_terminal-recall.org.jtrfp.trcl.coll.ListActionDispatcher,21,0,0,6,0,0,0,0,27
jtrfp_terminal-recall.org.jtrfp.trcl.coll.PartitionedList,3,0,0,1,0,0,0,1,5
jtrfp_terminal-recall.org.jtrfp.trcl.coll.CollectionMap,2,0,0,0,0,0,0,0,2
jtrfp_terminal-recall.org.jtrfp.trcl.coll.CollectionActionPacker,11,0,0,5,0,0,0,0,16
jtrfp_terminal-recall.org.jtrfp.trcl.coll.ObjectTallyCollection,1,0,0,0,0,0,0,6,7
mulesoft_raml-for-jax-rs.org.raml.jaxrs.parser.gatherers.JerseyGatherer,0,0,0,0,0,0,0,0,0
mulesoft_raml-for-jax-rs.org.raml.jaxrs.parser.model.JerseyJaxRsEntity,0,0,0,0,0,0,0,0,0
mulesoft_raml-for-jax-rs.org.raml.jaxrs.parser.source.Utilities,0,0,0,0,0,0,0,0,0
mulesoft_raml-for-jax-rs.org.raml.utilities.types.Cast,0,0,0,0,0,0,0,0,0
bramp_ffmpeg-cli-wrapper.net.bramp.ffmpeg.FFcommon,4,0,0,0,0,0,0,0,4
bramp_ffmpeg-cli-wrapper.net.bramp.ffmpeg.FFmpeg,2,0,0,0,0,0,0,0,2
bramp_ffmpeg-cli-wrapper.net.bramp.ffmpeg.FFprobe,6,0,0,6,0,0,0,1,13
bramp_ffmpeg-cli-wrapper.net.bramp.ffmpeg.Preconditions,0,0,0,0,0,0,0,2,2
bramp_ffmpeg-cli-wrapper.net.bramp.ffmpeg.FFmpegExecutor,2,0,0,2,0,0,0,1,5
bramp_ffmpeg-cli-wrapper.net.bramp.ffmpeg.builder.FFmpegBuilder,2,0,0,2,0,0,0,0,4
bramp_ffmpeg-cli-wrapper.net.bramp.ffmpeg.FFmpegUtils,4,0,0,0,0,0,0,0,4
bramp_ffmpeg-cli-wrapper.net.bramp.ffmpeg.builder.AbstractFFmpegStreamBuilder,0,0,0,0,0,0,1,1,2
bramp_ffmpeg-cli-wrapper.net.bramp.ffmpeg.RunProcessFunction,0,0,0,0,0,0,1,1,2
bramp_ffmpeg-cli-wrapper.net.bramp.ffmpeg.progress.StreamProgressParser,0,0,0,0,0,0,0,0,0
bramp_ffmpeg-cli-wrapper.net.bramp.ffmpeg.progress.ProgressParser,0,0,0,0,0,0,0,0,0
bramp_ffmpeg-cli-wrapper.net.bramp.ffmpeg.nut.RawHandler,0,0,0,0,0,0,0,0,0
bramp_ffmpeg-cli-wrapper.net.bramp.ffmpeg.nut.NutReader,0,0,0,0,0,1,0,0,1
bramp_ffmpeg-cli-wrapper.net.bramp.ffmpeg.builder.StreamSpecifier,1,0,0,1,0,0,0,0,2
bramp_ffmpeg-cli-wrapper.net.bramp.ffmpeg.builder.FFmpegOutputBuilder,0,0,0,0,0,0,0,0,0
bramp_ffmpeg-cli-wrapper.net.bramp.ffmpeg.builder.MetadataSpecifier,1,0,0,1,0,0,0,0,2
pietermartin_sqlg.org.umlg.sqlg.structure.SqlgGraph,610,95,0,566,0,24,0,115,1410
pietermartin_sqlg.org.umlg.sqlg.sql.dialect.SqlDialect,76,3,0,76,0,1,0,54,210
pietermartin_sqlg.org.umlg.sqlg.structure.topology.Topology,106,23,0,103,0,24,0,7,263
pietermartin_sqlg.org.umlg.sqlg.structure.topology.Schema,128,64,0,127,0,13,0,10,342
pietermartin_sqlg.org.umlg.sqlg.test.BaseTest,143,14,0,134,0,7,1,25,324
pietermartin_sqlg.org.umlg.sqlg.structure.SchemaTable,0,0,0,0,0,0,0,0,0
pietermartin_sqlg.org.umlg.sqlg.structure.SqlgIoRegistryV3,1,0,0,0,0,0,0,0,1
pietermartin_sqlg.org.umlg.sqlg.sql.dialect.SqlSchemaChangeDialect,0,0,0,0,0,0,0,1,1
pietermartin_sqlg.org.umlg.sqlg.structure.topology.AbstractLabel,3,0,0,2,0,1,0,0,6
pietermartin_sqlg.org.umlg.sqlg.structure.topology.VertexLabel,6,2,0,6,0,0,0,0,14
pietermartin_sqlg.org.umlg.sqlg.structure.SqlgTransaction,39,6,0,39,0,0,0,110,194
pietermartin_sqlg.org.umlg.sqlg.predicate.FullText,1,0,0,0,0,0,0,0,1
pietermartin_sqlg.org.umlg.sqlg.structure.topology.IndexType,1,0,0,0,0,0,0,0,1
Flow_Caustic.com.flowpowered.caustic.api.data.VertexData,1,0,0,1,0,0,0,0,2
revapi_revapi.org.revapi.configuration.ConfigurationValidator,1,0,0,1,0,0,0,0,2
revapi_revapi.org.revapi.basic.ConfigurableElementFilter,1,0,0,1,0,0,0,0,2
revapi_revapi.org.revapi.basic.VersionsTransform,3,0,0,3,0,0,0,0,6
revapi_revapi.org.revapi.TransformationResult,2,0,0,0,0,0,0,0,2
revapi_revapi.org.revapi.basic.AbstractDifferenceReferringTransform,14,0,0,14,0,0,0,0,28
revapi_revapi.org.revapi.FilterFinishResult,0,0,0,0,0,0,0,0,0
revapi_revapi.org.revapi.Difference,7,0,0,7,0,0,0,0,14
revapi_revapi.org.revapi.AnalysisContext,6,1,0,6,0,0,0,0,13
revapi_revapi.org.revapi.PipelineConfiguration,0,0,0,0,0,0,0,0,0
revapi_revapi.org.revapi.Revapi,7,0,0,7,0,0,0,1,15
revapi_revapi.org.revapi.CoIterator,4,1,0,4,0,0,0,0,9
revapi_revapi.org.revapi.ReportComparator,1,0,0,0,0,0,0,0,1
revapi_revapi.org.revapi.configuration.ValidationResult,2,0,0,2,0,0,0,0,4
revapi_revapi.org.revapi.base.BaseElement,6,0,0,6,0,0,0,0,12
revapi_revapi.org.revapi.TreeFilter,6,0,0,6,0,0,0,0,12
revapi_revapi.org.revapi.FilterStartResult,7,0,0,7,0,0,0,0,14
revapi_revapi.org.revapi.java.spi.Util,5,0,0,0,0,0,0,0,5
revapi_revapi.org.revapi.Report,7,0,0,5,0,0,0,0,12
revapi_revapi.org.revapi.java.JavaArchiveAnalyzer,7,1,0,7,0,0,0,1,16
revapi_revapi.org.revapi.Element,1,0,0,0,0,0,0,0,1
revapi_revapi.org.revapi.java.JavaApiAnalyzer,0,0,0,0,0,0,0,0,0
revapi_revapi.org.revapi.java.matcher.PackageMatcher,3,0,0,3,0,0,0,0,6
revapi_revapi.org.revapi.java.model.JavaElementForest,2,0,0,2,0,0,0,0,4
revapi_revapi.org.revapi.examples.treefilter.PackageTreeFilterProvider,2,0,0,2,0,0,0,0,4
revapi_revapi.org.revapi.examples.elementmatcher.TypeKindElementMatcher,1,0,0,1,0,0,0,0,2
revapi_revapi.org.revapi.maven.ConfigurationFile,0,0,0,0,0,0,0,0,0
revapi_revapi.org.revapi.maven.SchemaDrivenJSONToXmlConverter,16,0,0,1,0,0,0,0,17
revapi_revapi.org.revapi.maven.XmlUtil,0,0,0,0,0,0,0,0,0
revapi_revapi.org.revapi.maven.PropertyValueResolver,1,0,0,0,0,0,0,0,1
revapi_revapi.org.revapi.maven.BuildTimeReporter,3,0,0,3,0,0,0,0,6
revapi_revapi.org.revapi.reporter.file.AbstractFileReporter,0,0,0,0,0,0,0,5,5
revapi_revapi.org.revapi.reporter.text.TextReporter,2,0,0,2,0,0,0,0,4
revapi_revapi.org.revapi.configuration.Configurable,0,0,0,0,0,0,0,0,0
revapi_revapi.org.revapi.reporter.json.JsonReporter,1,0,0,1,0,0,0,0,2
revapi_revapi.org.revapi.jackson.JacksonElement,1,0,0,1,0,0,0,0,2
immutables_immutables.org.immutables.check.ObjectChecker,0,0,0,0,0,0,0,20,20
immutables_immutables.org.immutables.value.processor.encode.Code,0,0,0,0,0,0,0,8,8
immutables_immutables.org.immutables.value.processor.meta.LongBits,0,0,0,0,0,0,0,2,2
immutables_immutables.org.immutables.value.processor.meta.ProcessorRule,0,0,0,0,0,0,0,14,14
immutables_immutables.org.immutables.ordinal.ImmutableOrdinalSet,0,0,0,0,0,0,0,5,5
immutables_immutables.org.immutables.check.Checkers,0,0,0,0,0,0,0,26,26
immutables_immutables.org.immutables.check.IterableChecker,0,1,0,0,0,0,0,6,7
immutables_immutables.org.immutables.mongo.repository.internal.Support,0,0,0,0,0,0,0,2,2
immutables_immutables.org.immutables.mongo.bson4gson.BsonWriter,0,0,0,0,0,0,0,1,1
immutables_immutables.org.immutables.mongo.types.Id,0,0,0,0,0,0,0,2,2
immutables_immutables.org.immutables.mongo.concurrent.FluentFuture,0,0,0,0,0,0,0,2,2
immutables_immutables.org.immutables.check.StringChecker,1,0,0,0,0,0,0,29,30
immutables_immutables.org.immutables.mongo.repository.RepositorySetup,0,0,0,0,0,0,0,1,1
immutables_immutables.org.immutables.mongo.types.Binary,0,0,0,0,0,0,0,1,1
immutables_immutables.org.immutables.fixture.nullable.ImmutableNullableAttributes,0,0,0,0,0,0,0,3,3
immutables_immutables.org.immutables.fixture.nullable.ImmutableNullableDefault,0,0,0,0,0,0,0,1,1
immutables_immutables.org.immutables.fixture.nullable.ImmutableFromNullCollection,0,0,0,0,0,0,0,1,1
immutables_immutables.org.immutables.fixture.nullable.ImmutableNullableCompact,0,0,0,0,0,0,0,1,1
immutables_immutables.org.immutables.fixture.nullable.ImmutableNonnullConstruction,0,0,0,0,0,0,0,1,1
immutables_immutables.org.immutables.fixture.nullable.ImmutableNullablyElements,0,0,0,0,0,0,0,7,7
immutables_immutables.org.immutables.fixture.nullable.ImmutableNullAnnElements,0,0,0,0,0,0,0,4,4
immutables_immutables.org.immutables.fixture.nullable.ImmutableNullableTypeUseJdtAccepted,0,0,0,0,0,0,0,1,1
immutables_immutables.org.immutables.fixture.nullable.ImmutableSubtype,0,0,0,0,0,0,0,1,1
immutables_immutables.org.immutables.fixture.ImmutableEntityWithMap,0,0,0,0,0,0,0,1,1
immutables_immutables.org.immutables.fixture.nullable.ImmutableCustomNullableAnnotation,0,0,0,0,0,0,0,2,2
immutables_immutables.org.immutables.fixture.ImmutableInternedInterfaceWithSelfConstant,0,0,0,0,0,0,0,0,0
immutables_immutables.org.immutables.fixture.ImmutableInternedClassWithSelfConstant,0,0,0,0,0,0,0,0,0
immutables_immutables.org.immutables.fixture.ImmutableGetters,0,0,0,0,0,0,0,1,1
immutables_immutables.org.immutables.fixture.ImmutableInternCustomHashCode,0,0,0,0,0,0,0,1,1
immutables_immutables.org.immutables.fixture.ImmutableSampleValue,0,0,0,0,0,0,0,1,1
immutables_immutables.org.immutables.fixture.ImmutableOrderAttributeValue,0,0,0,0,0,0,0,2,2
immutables_immutables.org.immutables.fixture.ExtendingInnerBuilderValue_Builder,0,0,0,0,0,0,0,1,1
immutables_immutables.org.immutables.fixture.ImmutableDefaultAsDefault,0,0,0,0,0,0,0,1,1
immutables_immutables.org.immutables.fixture.ExtendedBuilderInterface,0,0,0,0,0,0,0,1,1
immutables_immutables.org.immutables.fixture.ImmutableIfaceValue,0,0,0,0,0,0,0,3,3
immutables_immutables.org.immutables.fixture.ImmutableAuxDefaultOnForcedSingleton,0,0,0,0,0,0,0,1,1
immutables_immutables.org.immutables.fixture.ImmutableHasNullable,0,0,0,0,0,0,0,2,2
immutables_immutables.org.immutables.fixture.ImmutableCheckForNullAttributes,0,0,0,0,0,0,0,1,1
immutables_immutables.org.immutables.fixture.ImmutableNullableArray,0,0,0,0,0,0,0,1,1
immutables_immutables.org.immutables.fixture.ImmutableSillyValidatedBuiltValue,0,0,0,0,0,0,0,2,2
immutables_immutables.org.immutables.fixture.ImmutableSillyMapHolder,0,0,0,0,0,0,0,1,1
immutables_immutables.org.immutables.fixture.ImmutableSillyLazy,0,0,0,0,0,0,0,1,1
immutables_immutables.org.immutables.fixture.ImmutableSillyInterned,0,0,0,0,0,0,0,1,1
immutables_immutables.org.immutables.fixture.ImmutableUnderwrite,0,0,0,0,0,0,0,1,1
immutables_immutables.org.immutables.fixture.ImmutableNoUnderwrite,0,0,0,0,0,0,0,1,1
immutables_immutables.org.immutables.fixture.ImmutableWitherDerived,0,0,0,0,0,0,0,1,1
immutables_immutables.org.immutables.fixture.ImmutableSillyValidatedConstructedValue,0,0,0,0,0,0,0,1,1
immutables_immutables.org.immutables.fixture.style.ImmutableOptionalWithNullable,0,0,0,0,0,0,0,1,1
immutables_immutables.org.immutables.fixture.ImmutableProperInitInternNoBuilder,0,0,0,0,0,0,0,1,1
immutables_immutables.org.immutables.fixture.ImmutableNormalize,0,0,0,0,0,0,0,1,1
immutables_immutables.org.immutables.fixture.ImmutablePrimitiveOptionals,0,0,0,0,0,0,0,1,1
immutables_immutables.org.immutables.fixture.ImmutableRedacted,0,0,0,0,0,0,0,1,1
immutables_immutables.org.immutables.fixture.ImmutableRedactedMask,0,0,0,0,0,0,0,1,1
immutables_immutables.org.immutables.fixture.ImmutableRedactedMaskJdkOnly,0,0,0,0,0,0,0,1,1
immutables_immutables.org.immutables.fixture.ImmutableRedactedMaskJdkOnlyOpt,0,0,0,0,0,0,0,1,1
immutables_immutables.org.immutables.fixture.ImmutableWithThisCheckForNoNilString,0,0,0,0,0,0,0,1,1
immutables_immutables.org.immutables.fixture.ImmutableThrowsClauses,0,0,0,0,0,0,0,1,1
immutables_immutables.org.immutables.fixture.ImmutablePrivateNoargConstructorIsOverriddenBySingleton,0,0,0,0,0,0,0,0,0
immutables_immutables.org.immutables.fixture.ImmutableCustomInternedNormalized,0,0,0,0,0,0,0,1,1
immutables_immutables.org.immutables.fixture.ImmutableIncludeHashCode,0,0,0,0,0,0,0,1,1
immutables_immutables.org.immutables.fixture.ImmutableLazyHash,0,0,0,0,0,0,0,1,1
immutables_immutables.org.immutables.fixture.ImmutableLazyHashSerializable,0,0,0,0,0,0,0,1,1
immutables_immutables.org.immutables.fixture.ImmutableHugeInterface,0,0,0,0,0,0,0,1,1
immutables_immutables.org.immutables.fixture.ImmutableHugeOccupationOverflow,0,0,0,0,0,0,0,1,1
immutables_immutables.org.immutables.fixture.ImmutableSafeInitIface,0,0,0,0,0,0,0,2,2
immutables_immutables.org.immutables.fixture.ImmutableSafeInitSingl,0,0,0,0,0,0,0,1,1
immutables_immutables.org.immutables.fixture.ImmutableSafeInitAclass,0,0,0,0,0,0,0,1,1
immutables_immutables.org.immutables.fixture.ImmutableDefaultDerivedInit,0,0,0,0,0,0,0,1,1
immutables_immutables.org.immutables.fixture.jackson.DefaultCollection,0,0,0,0,0,0,0,1,1
immutables_immutables.org.immutables.fixture.jackson.ProjectInformation,0,0,0,0,0,0,0,1,1
immutables_immutables.org.immutables.fixture.jackson.ImmutableAttributeIs,0,0,0,0,0,0,0,1,1
immutables_immutables.org.immutables.fixture.jackson.ImmutableNamingStrategy,0,0,0,0,0,0,0,1,1
immutables_immutables.org.immutables.fixture.jackson.ImmutableMinimumAnnotationsMapped,0,0,0,0,0,0,0,1,1
immutables_immutables.org.immutables.fixture.jackson.ImmutableSampleJacksonMapped,0,0,0,0,0,0,0,4,4
immutables_immutables.org.immutables.fixture.jackson.LazyAttributesSafe,0,0,0,0,0,0,0,1,1
immutables_immutables.org.immutables.fixture.jackson.PackageHidden,0,0,0,0,0,0,0,1,1
immutables_immutables.org.immutables.fixture.jackson.CustomBuilderDeserialize,0,0,0,0,0,0,0,1,1
immutables_immutables.org.immutables.fixture.jackson.ImmutableOuterObject,0,0,0,0,0,0,0,1,1
immutables_immutables.org.immutables.fixture.annotation.ImmutableAn,0,0,0,0,0,0,0,1,1
immutables_immutables.org.immutables.fixture.annotation.ImmutableHasDefault,0,0,0,0,0,0,0,1,1
immutables_immutables.org.immutables.fixture.with.ImmutableWithEnums,0,0,0,0,0,0,0,7,7
immutables_immutables.org.immutables.fixture.synthetic.ImmutableSynthetic,0,0,0,0,0,0,0,0,0
immutables_immutables.org.immutables.fixture.deep.ModifiableLine,0,0,0,0,0,0,0,4,4
immutables_immutables.org.immutables.fixture.deep.ImmutableLine,0,0,0,0,0,0,0,3,3
immutables_immutables.org.immutables.fixture.generics.ImmutableGenericChild,0,0,0,0,0,0,0,1,1
immutables_immutables.org.immutables.fixture.jdkonly.ImmutableJdkColl,0,0,0,0,0,0,0,4,4
immutables_immutables.org.immutables.fixture.jdkonly.JdkMapsBuilder,0,0,0,0,0,0,0,2,2
immutables_immutables.org.immutables.fixture.jdkonly.ImmutableEmptyEnumMapAndSet,0,0,0,0,0,0,0,1,1
immutables_immutables.org.immutables.fixture.jdkonly.ImmutableJdkOptionals,0,0,0,0,0,0,0,3,3
immutables_immutables.org.immutables.fixture.jdkonly.ImmutableJdkOptionalsSer,0,0,0,0,0,0,0,1,1
immutables_immutables.org.immutables.fixture.jdkonly.ImmutableDefaultArray,0,0,0,0,0,0,0,1,1
immutables_immutables.org.immutables.fixture.custann.CustomCollection,0,0,0,0,0,0,0,1,1
immutables_immutables.org.immutables.fixture.nested.ImmutableSub,0,0,0,0,0,0,0,1,1
immutables_immutables.org.immutables.fixture.nested.ImmutableAB,0,0,0,0,0,0,0,1,1
immutables_immutables.org.immutables.fixture.style.ImmutableNoValidation,0,0,0,0,0,0,0,2,2
immutables_immutables.org.immutables.fixture.style.ImmutableGuavaInterner,0,0,0,0,0,0,0,1,1
immutables_immutables.org.immutables.fixture.style.ImmutableJdkInterner,0,0,0,0,0,0,0,1,1
immutables_immutables.org.immutables.fixture.style.ImmutableUnderrideObjectMethods,0,0,0,0,0,0,0,1,1
immutables_immutables.org.immutables.fixture.style.ImmutableTrimToString,0,0,0,0,0,0,0,1,1
immutables_immutables.org.immutables.fixture.style.ImmutableForceEqualsInWithers,0,0,0,0,0,0,0,1,1
immutables_immutables.org.immutables.fixture.style.ImmutableSpecifiedExceptionWithNamesConstructor,0,0,0,0,0,0,0,1,1
immutables_immutables.org.immutables.fixture.builder.ImmutableToBuilderClassic,0,0,0,0,0,0,0,1,1
immutables_immutables.org.immutables.fixture.builder.ImmutableNeapolitanAttributeBuilderParent,0,0,0,0,0,0,0,6,6
immutables_immutables.org.immutables.fixture.couse.ImmutableEnumUser,0,0,0,0,0,0,0,1,1
immutables_immutables.org.immutables.fixture.modifiable.BeanFriendly,0,0,0,0,0,1,0,1,2
immutables_immutables.org.immutables.fixture.modifiable.ModifiableAaa,0,0,0,0,0,0,0,1,1
immutables_immutables.org.immutables.fixture.modifiable.ModifiableUnit,0,0,0,0,0,0,0,1,1
immutables_immutables.org.immutables.fixture.modifiable.ModifiableCompanion,0,0,0,0,0,0,0,4,4
immutables_immutables.org.immutables.fixture.modifiable.ModifiableExtra,0,0,0,0,0,0,0,1,1
immutables_immutables.org.immutables.fixture.modifiable.ModifiableStandalone,0,0,0,0,0,0,0,2,2
immutables_immutables.org.immutables.fixture.modifiable.ModifiableNullableAndDefault,0,0,0,0,0,0,0,1,1
immutables_immutables.org.immutables.fixture.modifiable.ModifiableMutableImmutableCollection,0,0,0,0,0,0,0,1,1
immutables_immutables.org.immutables.fixture.modifiable.ImmutableAllowNullsObject,0,0,0,0,0,0,0,1,1
immutables_immutables.org.immutables.fixture.modifiable.ModifiableBeanFriendly,0,0,0,0,0,0,0,2,2
immutables_immutables.org.immutables.fixture.modifiable.ImmutableGenericHolder,0,0,0,0,0,0,0,1,1
immutables_immutables.org.immutables.fixture.modifiable.ModifiableFromType,0,0,0,0,0,0,0,1,1
immutables_immutables.org.immutables.fixture.modifiable.ModifiableFromManyTypes,0,0,0,0,0,0,0,1,1
immutables_immutables.org.immutables.fixture.modifiable.ModifiableDefaultMap,0,0,0,0,0,0,0,1,1
immutables_immutables.org.immutables.fixture.modifiable.ModifiableWithModifiableSuperclass,0,0,0,0,0,0,0,1,1
immutables_immutables.org.immutables.fixture.modifiable.ModifiableWithModifiableInterface,0,0,0,0,0,0,0,1,1
immutables_immutables.org.immutables.fixture.modifiable.ImmutableClearBuilder,0,0,0,0,0,0,0,1,1
immutables_immutables.org.immutables.fixture.serial.ImmutableSomeSer,0,0,0,0,0,0,0,1,1
immutables_immutables.org.immutables.fixture.serial.ModifiableSomeSer,0,0,0,0,0,0,0,1,1
immutables_immutables.org.immutables.fixture.nested.ImmutableCadabra,0,0,0,0,0,0,0,1,1
immutables_immutables.org.immutables.fixture.nested.ImmutableBuagra,0,0,0,0,0,0,0,1,1
immutables_immutables.org.immutables.fixture.ImmutableJsonIgnore,0,0,0,0,0,0,0,1,1
immutables_immutables.org.immutables.fixture.SillyPolyHost,0,0,0,0,0,0,0,1,1
immutables_immutables.org.immutables.fixture.SillyPolyHost2,0,0,0,0,0,0,0,1,1
immutables_immutables.org.immutables.gson.stream.JsonGeneratorWriter,0,0,0,0,0,0,0,0,0
immutables_immutables.org.immutables.generator.PostprocessingMachine,0,0,0,0,0,0,0,26,26
immutables_immutables.org.immutables.generator.SourceTypes,0,0,0,0,0,0,0,1,1
immutables_immutables.org.immutables.generator.Naming,0,0,0,0,0,0,0,12,12
immutables_immutables.org.immutables.criteria.repository.reactive.ReactiveFetcher,1,0,0,0,0,0,0,3,4
immutables_immutables.org.immutables.criteria.matcher.Matchers,0,0,0,0,0,0,0,1,1
immutables_immutables.org.immutables.criteria.expression.Expressions,2,0,0,2,0,0,0,0,4
immutables_immutables.org.immutables.criteria.expression.Path,0,0,0,0,0,0,0,6,6
immutables_immutables.org.immutables.criteria.expression.Constant,0,0,0,0,0,0,0,1,1
immutables_immutables.org.immutables.criteria.backend.KeyExtractor,0,0,0,0,0,0,0,6,6
immutables_immutables.org.immutables.criteria.backend.ContainerNaming,0,0,0,0,0,0,0,1,1
immutables_immutables.org.immutables.criteria.backend.JavaBeanNaming,0,0,0,0,0,0,0,1,1
immutables_immutables.org.immutables.criteria.reflect.ClassScanner,0,0,0,0,0,0,0,2,2
immutables_immutables.org.immutables.value.processor.meta.CriteriaModel,0,0,0,0,0,1,0,1,2
immutables_immutables.org.immutables.criteria.backend.ImmutableDeleteByKey,0,0,0,0,0,0,0,3,3
immutables_immutables.org.immutables.criteria.expression.Query,0,0,0,0,0,0,0,11,11
immutables_immutables.org.immutables.criteria.mongo.bson4jackson.JacksonCodecs,0,0,0,0,0,0,0,6,6
immutables_immutables.org.immutables.criteria.mongo.bson4jackson.BsonGenerator,0,0,0,0,0,0,0,3,3
immutables_immutables.org.immutables.criteria.mongo.bson4jackson.BsonParser,7,0,0,5,0,0,0,0,12
immutables_immutables.org.immutables.criteria.geode.OqlLiterals,0,0,0,0,0,0,0,1,1
immutables_immutables.org.immutables.criteria.geode.KeyLookupAnalyzer,0,0,0,0,0,0,0,0,0
immutables_immutables.org.immutables.criteria.expression.ImmutableQuery,0,0,0,0,0,0,0,2,2
immutables_immutables.org.immutables.criteria.geode.OqlGenerator,0,0,0,0,0,0,0,2,2
immutables_immutables.org.immutables.criteria.geode.BindVariableConverter,0,0,0,0,0,0,0,4,4
immutables_immutables.org.immutables.criteria.elasticsearch.Version,1,0,0,0,0,0,0,0,1
immutables_immutables.org.immutables.criteria.elasticsearch.IndexResolver,0,0,0,0,0,0,0,1,1
immutables_immutables.org.immutables.criteria.elasticsearch.AggregateQueryBuilder,0,0,0,0,0,0,0,1,1
immutables_immutables.org.immutables.criteria.elasticsearch.QueryBuilders,5,0,0,1,0,0,0,0,6
immutables_immutables.org.immutables.criteria.elasticsearch.Json,3,0,0,0,0,0,0,0,3
immutables_immutables.org.immutables.generator.fixture.Generator_Whitespacer,0,0,0,0,0,0,0,1,1
documents4j_documents4j.com.documents4j.api.IConverter,2,0,0,2,0,0,0,0,4
documents4j_documents4j.com.documents4j.job.AggregatingConverter,1,0,0,1,0,0,0,0,2
documents4j_documents4j.com.documents4j.api.ISelectionStrategy,1,0,0,0,0,1,0,0,2
documents4j_documents4j.com.documents4j.api.IInputStreamSource,1,0,0,1,0,0,0,0,2
documents4j_documents4j.com.documents4j.api.IFileSource,1,0,0,1,0,0,0,0,2
documents4j_documents4j.com.documents4j.api.IFileConsumer,0,0,0,0,0,0,0,0,0
documents4j_documents4j.com.documents4j.api.IInputStreamConsumer,1,0,0,0,0,0,0,0,1
documents4j_documents4j.com.documents4j.job.ConsumeOnCloseInputStream,0,0,0,0,0,0,0,1,1
documents4j_documents4j.com.documents4j.api.DocumentType,1,0,0,0,0,0,0,0,1
documents4j_documents4j.com.documents4j.conversion.ConverterRegistry,2,0,0,0,0,0,0,0,2
documents4j_documents4j.com.documents4j.conversion.DefaultConversionManager,0,0,0,0,0,0,0,2,2
documents4j_documents4j.com.documents4j.conversion.msoffice.MicrosoftOfficeTargetNameCorrector,3,0,0,0,0,0,0,0,3
documents4j_documents4j.com.documents4j.server.auth.AuthFilter,0,0,0,0,0,0,0,5,5
documents4j_documents4j.com.documents4j.ws.ConverterServerInformation,1,0,0,1,0,0,0,0,2
documents4j_documents4j.com.documents4j.ws.endpoint.MonitoringHealthCreateDocumentResource,0,0,0,0,0,0,0,0,0
vert-x3_vertx-rx.io.vertx.reactivex.RxHelper,12,0,0,0,0,8,0,4,24
vert-x3_vertx-rx.io.vertx.reactivex.ContextScheduler,0,1,0,0,0,1,0,0,2
vert-x3_vertx-rx.io.vertx.rxjava3.core.RxHelper,6,0,0,0,0,2,0,2,10
vert-x3_vertx-rx.io.vertx.reactivex.core.RxHelper,6,0,0,0,0,2,0,2,10
vert-x3_vertx-rx.io.vertx.rxjava3.core.Vertx,2,0,0,2,0,0,0,4,8
vert-x3_vertx-rx.io.vertx.reactivex.core.Vertx,8,0,0,8,0,0,0,2,18
vert-x3_vertx-rx.io.vertx.rxjava3.core.buffer.Buffer,4,0,0,2,0,0,0,0,6
vert-x3_vertx-rx.io.vertx.reactivex.core.buffer.Buffer,4,0,0,2,0,0,0,0,6
vert-x3_vertx-rx.io.vertx.rxjava3.core.net.SocketAddress,2,0,0,0,0,0,0,0,2
vert-x3_vertx-rx.io.vertx.reactivex.core.net.SocketAddress,2,0,0,0,0,0,0,0,2
vert-x3_vertx-rx.io.vertx.rxjava3.FlowableHelper,0,0,0,0,0,0,0,2,2
vert-x3_vertx-rx.io.vertx.reactivex.FlowableHelper,0,0,0,0,0,0,0,2,2
vert-x3_vertx-rx.io.vertx.rxjava3.ObservableHelper,0,0,0,0,0,0,0,2,2
vert-x3_vertx-rx.io.vertx.reactivex.ObservableHelper,0,0,0,0,0,0,0,2,2
vert-x3_vertx-rx.io.vertx.rxjava3.SingleHelper,0,0,0,0,0,0,0,2,2
vert-x3_vertx-rx.io.vertx.reactivex.SingleHelper,0,0,0,0,0,0,0,2,2
vert-x3_vertx-rx.io.vertx.rxjava3.MaybeHelper,0,0,0,0,0,0,0,2,2
vert-x3_vertx-rx.io.vertx.reactivex.MaybeHelper,0,0,0,0,0,0,0,2,2
vert-x3_vertx-rx.io.vertx.rxjava3.impl.AsyncResultCompletable,0,0,0,0,0,0,0,0,0
vert-x3_vertx-rx.io.vertx.reactivex.impl.AsyncResultCompletable,0,0,0,0,0,0,0,0,0
vert-x3_vertx-rx.io.vertx.rxjava3.RxHelper,12,0,0,0,0,8,0,4,24
vert-x3_vertx-rx.io.vertx.rxjava3.ContextScheduler,0,1,0,0,0,1,0,0,2
vert-x3_vertx-rx.io.vertx.rxjava.core.RxHelper,0,0,0,0,0,0,0,1,1
vert-x3_vertx-rx.io.vertx.rxjava3.sqlclient.SqlConnection,0,0,0,0,0,0,0,0,0
vert-x3_vertx-rx.io.vertx.rxjava3.core.file.FileSystem,0,0,0,0,0,0,0,2,2
vert-x3_vertx-rx.io.vertx.rxjava3.ext.web.client.WebClient,6,0,0,6,0,3,0,0,15
vert-x3_vertx-rx.io.vertx.rxjava.core.Vertx,11,2,0,9,0,0,0,1,23
vert-x3_vertx-rx.io.vertx.reactivex.ext.web.client.WebClient,0,0,0,0,0,3,0,0,3
vert-x3_vertx-rx.io.vertx.rxjava.ext.web.client.WebClient,0,0,0,0,0,3,0,0,3
vert-x3_vertx-rx.io.vertx.rxjava.ext.sql.SQLClient,1,0,0,0,0,1,0,0,2
vert-x3_vertx-rx.io.vertx.reactivex.ext.sql.SQLClientHelper,0,0,0,0,0,1,0,1,2
vert-x3_vertx-rx.io.vertx.rxjava.ext.sql.SQLClientHelper,0,0,0,0,0,1,0,1,2
vert-x3_vertx-rx.io.vertx.rx.java.RxHelper,14,1,0,8,0,0,0,4,27
vert-x3_vertx-rx.io.vertx.rxjava.core.TimeoutStream,0,0,0,0,0,0,0,0,0
vert-x3_vertx-rx.io.vertx.rxjava.core.buffer.Buffer,2,0,0,1,0,0,0,0,3
vert-x3_vertx-rx.io.vertx.rxjava.core.net.SocketAddress,1,0,0,0,0,0,0,0,1
vert-x3_vertx-rx.io.vertx.rx.java.ObservableHandler,1,0,0,7,0,0,0,0,8
vert-x3_vertx-rx.io.vertx.rx.java.ContextScheduler,0,1,0,0,0,1,0,0,2
lightblue-platform_lightblue-core.com.redhat.lightblue.util.JsonUtils,65,1,0,16,0,9,6,4,101
lightblue-platform_lightblue-core.com.redhat.lightblue.util.JsonObject,2,0,0,0,0,0,0,0,2
lightblue-platform_lightblue-core.com.redhat.lightblue.util.test.FileUtil,1,0,0,1,0,0,0,0,2
lightblue-platform_lightblue-core.com.redhat.lightblue.util.MutablePath,4,4,0,0,0,0,0,0,8
lightblue-platform_lightblue-core.com.redhat.lightblue.util.Path,23,14,0,22,0,7,0,8,74
lightblue-platform_lightblue-core.com.redhat.lightblue.util.JsonDoc,116,0,0,26,0,4,4,0,150
lightblue-platform_lightblue-core.com.redhat.lightblue.util.Tuples,2,0,0,0,0,0,0,0,2
lightblue-platform_lightblue-core.com.redhat.lightblue.util.JsonNodeCursor,7,0,0,7,0,0,0,0,14
lightblue-platform_lightblue-core.com.redhat.lightblue.util.Util,2,0,0,0,0,0,0,0,2
lightblue-platform_lightblue-core.com.redhat.lightblue.util.MemoryMonitor,3,0,0,0,0,0,0,0,3
lightblue-platform_lightblue-core.com.redhat.lightblue.util.Error,9,0,0,7,0,1,0,0,17
lightblue-platform_lightblue-core.com.redhat.lightblue.util.CopyOnWriteIterator,2,1,0,2,0,0,0,0,5
lightblue-platform_lightblue-core.com.redhat.lightblue.util.DefaultRegistry,2,0,0,2,0,0,0,0,4
lightblue-platform_lightblue-core.com.redhat.lightblue.util.DefaultResolver,1,0,0,1,0,0,0,0,2
lightblue-platform_lightblue-core.com.redhat.lightblue.util.EmptyIterator,0,0,0,0,0,0,0,0,0
lightblue-platform_lightblue-core.com.redhat.lightblue.util.metrics.RequestMetrics,6,0,0,2,0,0,0,0,8
lightblue-platform_lightblue-core.com.redhat.lightblue.util.test.AbstractJsonSchemaTest,0,0,0,0,0,0,0,59,59
lightblue-platform_lightblue-core.com.redhat.lightblue.util.test.AbstractJsonNodeTest,21,0,0,3,0,0,0,2,26
lightblue-platform_lightblue-core.com.redhat.lightblue.util.metrics.RequestMetric,1,0,0,1,0,0,0,0,2
apache_curator.org.apache.curator.utils.Compatibility,3,0,0,3,0,0,0,0,6
apache_curator.org.apache.curator.framework.schema.SchemaSet,1,0,0,1,0,0,0,0,2
apache_curator.org.apache.curator.framework.CuratorFramework,18,1,0,15,0,0,0,15,49
apache_curator.org.apache.curator.framework.schema.SchemaSetLoader,1,0,0,1,0,0,0,0,2
apache_curator.org.apache.curator.framework.state.CircuitBreakingConnectionStateListener,4,0,0,3,0,0,0,0,7
apache_curator.org.apache.curator.test.compatibility.Timing2,14,0,0,13,0,0,0,2,29
apache_curator.org.apache.curator.framework.state.CircuitBreaker,3,0,0,3,0,0,0,0,6
apache_curator.org.apache.curator.framework.CuratorFrameworkFactory,259,17,0,249,0,38,0,14,577
apache_curator.org.apache.curator.test.BaseClassForTests,9,1,0,9,0,1,0,0,20
apache_curator.org.apache.curator.test.TestingServer,23,5,0,20,0,3,0,0,51
apache_curator.org.apache.curator.utils.CloseableUtils,2,0,0,1,0,2,0,0,5
apache_curator.org.apache.curator.framework.imps.ProtectedUtils,1,0,0,1,0,0,0,0,2
apache_curator.org.apache.curator.framework.imps.GzipCompressionProvider,3,0,0,3,0,0,0,0,6
apache_curator.org.apache.curator.framework.imps.NamespaceWatcher,1,0,0,0,0,0,0,0,1
apache_curator.org.apache.curator.framework.api.Ensembleable,0,0,0,0,0,0,0,1,1
apache_curator.org.apache.curator.test.TestingCluster,3,1,0,3,0,0,0,1,8
apache_curator.org.apache.curator.framework.imps.EnsembleTracker,0,0,0,0,0,0,0,0,0
apache_curator.org.apache.curator.x.discovery.details.JsonInstanceSerializer,6,0,0,6,0,0,0,0,12
apache_curator.org.apache.curator.x.discovery.ServiceInstanceBuilder,8,0,0,8,0,0,0,0,16
apache_curator.org.apache.curator.x.discovery.UriSpec,0,0,0,0,0,0,0,1,1
apache_curator.org.apache.curator.x.discovery.ServiceInstance,2,0,0,1,0,0,0,0,3
apache_curator.org.apache.curator.x.discovery.strategies.StickyStrategy,1,0,0,1,0,0,0,0,2
apache_curator.org.apache.curator.x.discovery.details.OldServiceInstance,1,0,0,0,0,0,0,0,1
apache_curator.org.apache.curator.test.TestingZooKeeperServer,0,0,0,0,0,0,0,0,0
apache_curator.org.apache.curator.x.async.AsyncWrappers,0,0,0,0,0,0,0,0,0
apache_curator.org.apache.curator.x.async.api.AsyncPathAndBytesable,3,0,0,3,0,2,0,0,8
apache_curator.org.apache.curator.x.async.api.AsyncPathable,9,0,0,7,0,4,0,0,20
apache_curator.org.apache.curator.x.async.migrations.MigrationSet,2,0,0,2,0,0,0,0,4
apache_curator.org.apache.curator.test.Timing,3,0,0,3,0,0,0,0,6
apache_curator.org.apache.curator.x.async.modeled.ZPath,6,0,0,6,0,0,0,0,12
apache_curator.org.apache.curator.x.async.AsyncStage,1,0,0,0,0,0,0,0,1
apache_curator.org.apache.curator.CuratorZookeeperClient,1,0,0,1,0,0,0,1,3
apache_curator.org.apache.curator.retry.SleepingRetry,0,0,0,0,0,0,0,0,0
apache_curator.org.apache.curator.retry.RetryForever,0,0,0,0,0,0,0,0,0
apache_curator.org.apache.curator.utils.CloseableScheduledExecutorService,1,0,0,1,0,0,0,0,2
apache_curator.org.apache.curator.utils.CloseableExecutorService,5,0,0,0,0,1,0,0,6
apache_curator.org.apache.curator.utils.ZKPaths,2,0,0,0,0,0,0,0,2
apache_curator.org.apache.curator.x.discovery.server.entity.ServiceNames,0,0,0,0,0,0,0,0,0
apache_curator.org.apache.curator.framework.api.PathAndBytesable,2,0,0,2,0,0,0,0,4
apache_curator.org.apache.curator.framework.schema.SchemaBuilder,0,0,0,0,0,0,0,1,1
apache_curator.org.apache.curator.framework.recipes.cache.TreeCache,10,0,0,2,0,1,0,0,13
apache_curator.org.apache.curator.framework.state.ConnectionStateListenerManagerFactory,1,0,0,1,0,0,0,0,2
apache_curator.org.apache.curator.framework.api.CreateModable,1,0,0,1,0,0,0,0,2
OpenHFT_Chronicle-Core.net.openhft.chronicle.core.Jvm,8,4,0,5,0,0,0,3,20
OpenHFT_Chronicle-Core.net.openhft.chronicle.core.OS,3,0,0,3,0,1,0,2,9
OpenHFT_Chronicle-Core.net.openhft.chronicle.core.io.IOTools,9,1,0,5,0,7,0,0,22
OpenHFT_Chronicle-Core.net.openhft.chronicle.core.LicenceCheck,0,0,0,0,0,0,0,0,0
OpenHFT_Chronicle-Core.net.openhft.chronicle.core.PerformanceTuning,5,0,0,0,0,0,0,0,5
OpenHFT_Chronicle-Core.net.openhft.chronicle.core.StackTrace,1,0,0,1,0,0,0,0,2
OpenHFT_Chronicle-Core.net.openhft.chronicle.core.UnsafeMemory,39,27,0,34,0,4,0,0,104
OpenHFT_Chronicle-Core.net.openhft.chronicle.core.Memory,2,0,0,1,0,0,0,0,3
OpenHFT_Chronicle-Core.net.openhft.chronicle.core.Maths,17,3,0,2,0,1,1,8,32
OpenHFT_Chronicle-Core.net.openhft.chronicle.core.pool.StringInterner,1,1,0,1,0,0,0,0,3
OpenHFT_Chronicle-Core.net.openhft.chronicle.core.internal.analytics.StandardMaps,1,0,0,0,0,0,0,0,1
OpenHFT_Chronicle-Core.net.openhft.chronicle.core.analytics.AnalyticsFacade,0,0,0,0,0,0,0,0,0
OpenHFT_Chronicle-Core.net.openhft.chronicle.core.internal.threads.VanillaThreadLock,4,0,0,2,0,1,0,0,7
OpenHFT_Chronicle-Core.net.openhft.chronicle.core.util.ThreadConfinementAsserter,0,0,0,0,0,0,0,1,1
OpenHFT_Chronicle-Core.net.openhft.chronicle.core.threads.OnDemandEventLoop,1,0,0,1,0,1,0,0,3
OpenHFT_Chronicle-Core.net.openhft.chronicle.core.threads.JitterSampler,1,1,0,1,0,0,0,0,3
OpenHFT_Chronicle-Core.net.openhft.chronicle.core.threads.CleaningThreadLocal,1,0,0,0,0,0,0,0,1
OpenHFT_Chronicle-Core.net.openhft.chronicle.core.threads.CleaningThread,1,0,0,1,0,0,0,0,2
OpenHFT_Chronicle-Core.net.openhft.chronicle.core.io.Closeable,1,0,0,0,0,0,0,0,1
OpenHFT_Chronicle-Core.net.openhft.chronicle.core.io.AbstractCloseable,3,1,0,2,0,1,0,0,7
OpenHFT_Chronicle-Core.net.openhft.chronicle.core.io.AbstractCloseableReferenceCounted,2,0,0,2,0,0,0,0,4
OpenHFT_Chronicle-Core.net.openhft.chronicle.core.io.UnsafeCloseable,0,0,0,0,0,0,0,0,0
OpenHFT_Chronicle-Core.net.openhft.chronicle.core.io.UnsafeText,0,0,0,0,0,0,0,0,0
OpenHFT_Chronicle-Core.net.openhft.chronicle.core.io.ReferenceOwner,0,0,0,0,0,0,0,0,0
OpenHFT_Chronicle-Core.net.openhft.chronicle.core.io.AbstractReferenceCounted,1,0,0,1,0,0,0,0,2
OpenHFT_Chronicle-Core.net.openhft.chronicle.core.io.BackgroundResourceReleaser,1,0,0,1,0,0,0,0,2
OpenHFT_Chronicle-Core.net.openhft.chronicle.core.util.Ints,0,0,0,0,0,0,0,6,6
OpenHFT_Chronicle-Core.net.openhft.chronicle.core.util.Histogram,4,0,0,4,0,0,0,0,8
OpenHFT_Chronicle-Core.net.openhft.chronicle.core.util.StringUtils,3,0,0,0,0,0,1,0,4
OpenHFT_Chronicle-Core.net.openhft.chronicle.core.util.TypeOf,2,0,0,0,0,0,0,0,2
OpenHFT_Chronicle-Core.net.openhft.chronicle.core.util.WeakIdentityHashMap,1,0,0,0,0,0,0,0,1
OpenHFT_Chronicle-Core.net.openhft.chronicle.core.util.URIEncoder,0,0,0,0,0,0,0,0,0
OpenHFT_Chronicle-Core.net.openhft.chronicle.core.util.ObjectUtils,1,0,0,0,0,0,0,0,1
OpenHFT_Chronicle-Core.net.openhft.chronicle.core.util.Longs,0,0,0,0,0,0,0,6,6
OpenHFT_Chronicle-Core.net.openhft.chronicle.core.time.LongTime,4,0,0,4,0,0,0,0,8
OpenHFT_Chronicle-Core.net.openhft.chronicle.core.time.TimeProvider,0,0,0,0,0,1,0,1,2
OpenHFT_Chronicle-Core.net.openhft.chronicle.core.time.SetTimeProvider,5,0,0,5,0,0,0,0,10
OpenHFT_Chronicle-Core.net.openhft.chronicle.core.time.UniqueMicroTimeProvider,2,0,0,2,0,0,0,0,4
OpenHFT_Chronicle-Core.net.openhft.chronicle.core.time.RunningMinimum,0,0,0,0,0,0,0,0,0
OpenHFT_Chronicle-Core.net.openhft.chronicle.core.time.VanillaDifferencer,0,0,0,0,0,0,0,0,0
OpenHFT_Chronicle-Core.net.openhft.chronicle.core.watcher.FileSystemWatcher,1,0,0,1,0,0,0,0,2
OpenHFT_Chronicle-Core.net.openhft.chronicle.core.pool.EnumInterner,1,0,0,0,0,0,0,0,1
OpenHFT_Chronicle-Core.net.openhft.chronicle.core.pool.ClassAliasPool,3,0,0,1,0,0,0,1,5
OpenHFT_Chronicle-Core.net.openhft.chronicle.core.pool.ParsingCache,1,0,0,1,0,0,0,0,2
davidmoten_rxjava-jdbc.com.github.davidmoten.rx.jdbc.Database,23,0,0,11,0,1,2,30,67
davidmoten_rxjava-jdbc.com.github.davidmoten.rx.jdbc.NamedParameters,5,0,0,0,0,0,0,0,5
davidmoten_rxjava-jdbc.com.github.davidmoten.rx.jdbc.ConnectionProviderAutoCommitting,0,0,0,0,0,0,0,0,0
davidmoten_rxjava-jdbc.com.github.davidmoten.rx.jdbc.Util,0,0,0,0,0,0,0,2,2
davidmoten_rxjava-jdbc.com.github.davidmoten.rx.RxUtil,0,0,0,0,0,0,0,1,1
davidmoten_rxjava-jdbc.com.github.davidmoten.rx.jdbc.ConnectionProviderPooled,0,0,0,0,0,0,0,1,1
davidmoten_rxjava-jdbc.com.github.davidmoten.rx.jdbc.ConnectionProvider,0,0,0,0,0,0,0,4,4
davidmoten_rxjava-jdbc.com.github.davidmoten.rx.jdbc.Conditions,0,0,0,0,0,0,0,3,3
davidmoten_rxjava-jdbc.com.github.davidmoten.rx.jdbc.ConnectionNonClosing,1,0,0,1,0,0,0,0,2
oasp_oasp4j.io.oasp.module.test.common.base.BaseTest,0,0,0,0,0,0,0,1,1
oasp_oasp4j.io.oasp.module.logging.common.impl.SecureLogging,1,0,0,0,0,0,0,0,1
oasp_oasp4j.io.oasp.module.logging.common.impl.DiagnosticContextFilter,2,0,0,0,0,0,0,0,2
salyh_elasticsearch-river-imap.de.saly.elasticsearch.importer.imap.support.IMAPUtils,3,0,0,0,0,0,0,0,3
statefulj_statefulj.org.statefulj.common.utils.ReflectionUtils,9,0,0,4,0,0,0,0,13
statefulj_statefulj.org.statefulj.common.utils.FieldAccessor,4,0,0,4,0,0,0,0,8
statefulj_statefulj.org.statefulj.fsm.model.State,4,0,0,2,0,0,0,0,6
statefulj_statefulj.org.statefulj.fsm.FSM,1,0,0,1,0,0,0,0,2
joel-costigliola_assertj-swing.org.assertj.swing.assertions.Assertions,0,0,0,0,0,0,0,3,3
joel-costigliola_assertj-swing.org.assertj.swing.assertions.ImageAssert,0,0,0,0,0,0,0,1,1
joel-costigliola_assertj-swing.org.assertj.swing.image.ScreenshotTaker,1,0,0,0,0,0,0,4,5
joel-costigliola_assertj-swing.org.assertj.swing.image.ImageFileWriter,0,0,0,0,0,0,0,1,1
joel-costigliola_assertj-swing.org.assertj.swing.query.ComponentVisibleQuery,9,0,0,1,0,0,0,0,10
joel-costigliola_assertj-swing.org.assertj.swing.driver.JSpinnerSetValueTask,0,0,0,0,0,0,0,2,2
joel-costigliola_assertj-swing.org.assertj.swing.driver.ComponentDriver,0,0,0,0,0,0,0,0,0
joel-costigliola_assertj-swing.org.assertj.swing.driver.JTreeAddRootIfInvisibleTask,0,0,0,0,0,0,0,0,0
joel-costigliola_assertj-swing.org.assertj.swing.driver.JInternalFrameIconQuery,2,0,0,0,0,0,0,0,2
joel-costigliola_assertj-swing.org.assertj.swing.driver.JMenuPopupMenuQuery,0,0,0,0,0,0,0,0,0
joel-costigliola_assertj-swing.org.assertj.swing.driver.JScrollBarDriver,0,0,0,0,0,0,0,4,4
joel-costigliola_assertj-swing.org.assertj.swing.core.Robot,2,0,0,2,0,0,0,0,4
joel-costigliola_assertj-swing.org.assertj.swing.data.Index,0,0,0,0,0,0,0,16,16
joel-costigliola_assertj-swing.org.assertj.swing.driver.JListSelectedIndexQuery,0,0,0,0,0,0,0,0,0
joel-costigliola_assertj-swing.org.assertj.swing.query.ComponentSizeQuery,0,0,0,0,0,0,0,2,2
joel-costigliola_assertj-swing.org.assertj.swing.data.TableCell,1,0,0,0,0,0,0,39,40
joel-costigliola_assertj-swing.org.assertj.swing.driver.JSplitPaneDriver,0,0,0,0,0,0,0,3,3
joel-costigliola_assertj-swing.org.assertj.swing.driver.JTableCellValueQuery,0,0,0,0,0,0,0,0,0
joel-costigliola_assertj-swing.org.assertj.swing.driver.AbstractButtonTextQuery,2,0,0,0,0,0,0,0,2
joel-costigliola_assertj-swing.org.assertj.swing.util.Platform,1,0,0,0,0,0,0,2,3
joel-costigliola_assertj-swing.org.assertj.swing.util.Range,0,0,0,0,0,0,0,4,4
joel-costigliola_assertj-swing.org.assertj.swing.driver.JPopupMenuElementsAsTextQuery,0,0,0,0,0,0,0,0,0
joel-costigliola_assertj-swing.org.assertj.swing.driver.JListDriver,1,0,0,1,0,0,0,0,2
joel-costigliola_assertj-swing.org.assertj.swing.awt.AWT,1,0,0,0,0,0,0,10,11
joel-costigliola_assertj-swing.org.assertj.swing.core.MouseClickInfo,3,0,0,3,0,0,0,4,10
joel-costigliola_assertj-swing.org.assertj.swing.driver.JOptionPaneMessageTypes,0,0,0,0,0,0,0,0,0
joel-costigliola_assertj-swing.org.assertj.swing.cell.JTableCellWriter,0,0,0,0,0,0,0,0,0
joel-costigliola_assertj-swing.org.assertj.swing.query.ComponentHasFocusQuery,1,0,0,1,0,0,0,0,2
joel-costigliola_assertj-swing.org.assertj.swing.driver.BasicJTreeCellReader,0,0,0,0,0,0,0,0,0
joel-costigliola_assertj-swing.org.assertj.swing.driver.TextAssert,0,0,0,0,0,0,0,4,4
joel-costigliola_assertj-swing.org.assertj.swing.driver.ComponentPerformDefaultAccessibleActionTask,0,0,0,0,0,0,0,3,3
joel-costigliola_assertj-swing.org.assertj.swing.driver.WaitForComponentToShowCondition,0,0,0,0,0,0,0,0,0
joel-costigliola_assertj-swing.org.assertj.swing.driver.JComboBoxSelectionValueQuery,1,0,0,0,0,0,0,2,3
joel-costigliola_assertj-swing.org.assertj.swing.driver.JComboBoxSetSelectedIndexTask,1,0,0,0,0,0,0,1,2
joel-costigliola_assertj-swing.org.assertj.swing.driver.JTabbedPaneSelectTabTask,1,0,0,0,0,0,0,0,1
joel-costigliola_assertj-swing.org.assertj.swing.driver.JComboBoxItemIndexPreconditions,0,0,0,0,0,0,0,4,4
joel-costigliola_assertj-swing.org.assertj.swing.driver.JOptionPaneOptionsQuery,0,0,0,0,0,0,0,0,0
joel-costigliola_assertj-swing.org.assertj.swing.driver.ModelValueToString,0,0,0,0,0,0,0,0,0
joel-costigliola_assertj-swing.org.assertj.swing.driver.JFileChooserSelectFileTask,0,0,0,0,0,0,0,0,0
joel-costigliola_assertj-swing.org.assertj.swing.driver.DialogModalQuery,0,0,0,0,0,0,0,0,0
joel-costigliola_assertj-swing.org.assertj.swing.driver.JTableColumnCountQuery,0,0,0,0,0,0,0,0,0
joel-costigliola_assertj-swing.org.assertj.swing.driver.JListSelectionValuesQuery,0,0,0,0,0,0,0,0,0
joel-costigliola_assertj-swing.org.assertj.swing.driver.JTreeDriver,0,0,0,0,0,0,0,1,1
joel-costigliola_assertj-swing.org.assertj.swing.driver.JComponentToolTipQuery,0,0,0,0,0,0,0,0,0
joel-costigliola_assertj-swing.org.assertj.swing.driver.JTextComponentEditableQuery,0,0,0,0,0,0,0,0,0
joel-costigliola_assertj-swing.org.assertj.swing.core.ComponentFinder,0,0,0,0,0,0,0,2,2
joel-costigliola_assertj-swing.org.assertj.swing.driver.JOptionPaneTitleQuery,0,0,0,0,0,0,0,0,0
joel-costigliola_assertj-swing.org.assertj.swing.driver.JTabbedPaneSelectTabQuery,0,0,0,0,0,0,0,0,0
joel-costigliola_assertj-swing.org.assertj.swing.driver.BasicCellRendererReader,0,0,0,0,0,0,0,0,0
joel-costigliola_assertj-swing.org.assertj.swing.query.ComponentLocationOnScreenQuery,0,0,0,0,0,0,0,0,0
joel-costigliola_assertj-swing.org.assertj.swing.driver.JScrollBarSetValueTask,0,0,0,0,0,0,0,2,2
joel-costigliola_assertj-swing.org.assertj.swing.util.TextMatcher,2,0,0,0,0,0,0,1,3
joel-costigliola_assertj-swing.org.assertj.swing.driver.JTreeChildOfPathCountQuery,0,0,0,0,0,0,0,0,0
joel-costigliola_assertj-swing.org.assertj.swing.driver.JOptionPaneMessageTypeQuery,0,0,0,0,0,0,0,0,0
joel-costigliola_assertj-swing.org.assertj.swing.driver.JInternalFrameCloseTask,0,0,0,0,0,0,0,0,0
joel-costigliola_assertj-swing.org.assertj.swing.driver.JTreeExpandPathTask,2,0,0,0,0,0,0,0,2
joel-costigliola_assertj-swing.org.assertj.swing.driver.JMenuItemMatcher,0,0,0,0,0,0,0,0,0
joel-costigliola_assertj-swing.org.assertj.swing.driver.JTableCancelCellEditingTask,1,0,0,0,0,0,0,4,5
joel-costigliola_assertj-swing.org.assertj.swing.timing.Pause,2,0,0,1,0,0,0,6,9
joel-costigliola_assertj-swing.org.assertj.swing.timing.Timeout,2,0,0,1,0,0,0,12,15
joel-costigliola_assertj-swing.org.assertj.swing.driver.JTableTextComponentEditorCellWriter,0,0,0,0,0,0,0,0,0
joel-costigliola_assertj-swing.org.assertj.swing.driver.AbstractJTableCellWriter,0,0,0,0,0,0,0,0,0
joel-costigliola_assertj-swing.org.assertj.swing.driver.ComponentMovableQuery,0,0,0,0,0,0,0,0,0
joel-costigliola_assertj-swing.org.assertj.swing.driver.JTableStopCellEditingTask,0,0,0,0,0,0,0,4,4
joel-costigliola_assertj-swing.org.assertj.swing.driver.JTreeMatchingPathQuery,0,0,0,0,0,0,0,1,1
joel-costigliola_assertj-swing.org.assertj.swing.driver.JTabbedPaneLocation,0,0,0,0,0,0,0,0,0
joel-costigliola_assertj-swing.org.assertj.swing.driver.JTableHeaderQuery,0,0,0,0,0,0,0,0,0
joel-costigliola_assertj-swing.org.assertj.swing.driver.JSplitPaneSetDividerLocationTask,1,0,0,0,0,0,0,0,1
joel-costigliola_assertj-swing.org.assertj.swing.driver.JComboBoxDropDownListFinder,0,0,0,0,0,0,0,0,0
joel-costigliola_assertj-swing.org.assertj.swing.driver.JAppletDriver,0,0,0,0,0,0,0,1,1
joel-costigliola_assertj-swing.org.assertj.swing.driver.JTreeClearSelectionTask,0,0,0,0,0,0,0,1,1
joel-costigliola_assertj-swing.org.assertj.swing.driver.ComponentShownWaiter,0,0,0,0,0,0,0,0,0
joel-costigliola_assertj-swing.org.assertj.swing.query.ComponentShowingQuery,1,0,0,0,0,0,0,0,1
joel-costigliola_assertj-swing.org.assertj.swing.driver.JLabelTextQuery,0,0,0,0,0,0,0,0,0
joel-costigliola_assertj-swing.org.assertj.swing.driver.JProgressBarValueQuery,0,0,0,0,0,0,0,0,0
joel-costigliola_assertj-swing.org.assertj.swing.driver.AbstractButtonSelectedQuery,0,0,0,0,0,0,0,0,0
joel-costigliola_assertj-swing.org.assertj.swing.driver.JTextComponentTextQuery,1,0,0,0,0,0,0,0,1
joel-costigliola_assertj-swing.org.assertj.swing.driver.AbstractButtonArmedQuery,0,0,0,0,0,0,0,0,0
joel-costigliola_assertj-swing.org.assertj.swing.driver.JTabbedPaneTabTitlesQuery,0,0,0,0,0,0,0,0,0
joel-costigliola_assertj-swing.org.assertj.swing.driver.ComponentMoveTask,0,0,0,0,0,0,0,0,0
joel-costigliola_assertj-swing.org.assertj.swing.core.KeyPressInfo,1,0,0,1,0,0,0,0,2
joel-costigliola_assertj-swing.org.assertj.swing.driver.JSliderSetValueTask,0,0,0,0,0,0,0,0,0
joel-costigliola_assertj-swing.org.assertj.swing.fixture.JTableFixture,2,0,0,1,0,0,0,5,8
joel-costigliola_assertj-swing.org.assertj.swing.driver.JProgressBarIndeterminateQuery,0,0,0,0,0,0,0,0,0
joel-costigliola_assertj-swing.org.assertj.swing.driver.JListContentQuery,0,0,0,0,0,0,0,0,0
joel-costigliola_assertj-swing.org.assertj.swing.driver.JComboBoxEditableQuery,0,0,0,0,0,0,0,0,0
joel-costigliola_assertj-swing.org.assertj.swing.driver.JSpinnerValueQuery,0,0,0,0,0,0,0,0,0
joel-costigliola_assertj-swing.org.assertj.swing.driver.Actions,0,0,0,0,0,0,0,0,0
joel-costigliola_assertj-swing.org.assertj.swing.driver.JTextComponentSetTextTask,0,0,0,0,0,0,0,0,0
joel-costigliola_assertj-swing.org.assertj.swing.driver.JTableRowCountQuery,0,0,0,0,0,0,0,0,0
joel-costigliola_assertj-swing.org.assertj.swing.driver.JFileChooserApproveButtonTextQuery,0,0,0,0,0,0,0,0,0
joel-costigliola_assertj-swing.org.assertj.swing.driver.JScrollBarValueQuery,0,0,0,0,0,0,0,0,0
joel-costigliola_assertj-swing.org.assertj.swing.driver.MenuElementComponentQuery,0,0,0,0,0,0,0,0,0
joel-costigliola_assertj-swing.org.assertj.swing.driver.JComboBoxSelectedIndexQuery,0,0,0,0,0,0,0,0,0
joel-costigliola_assertj-swing.org.assertj.swing.driver.JOptionPaneMessageQuery,0,0,0,0,0,0,0,0,0
joel-costigliola_assertj-swing.org.assertj.swing.driver.JComboBoxDriver,0,0,0,0,0,0,0,1,1
joel-costigliola_assertj-swing.org.assertj.swing.driver.JTreeEditableQuery,0,0,0,0,0,0,0,0,0
joel-costigliola_assertj-swing.org.assertj.swing.driver.MultipleSelectionTemplate,0,0,0,0,0,0,0,0,0
joel-costigliola_assertj-swing.org.assertj.swing.input.DisposedWindowMonitor,5,0,0,0,0,0,0,2,7
joel-costigliola_assertj-swing.org.assertj.swing.input.NativeDndIdentifier,0,0,0,0,0,0,0,0,0
joel-costigliola_assertj-swing.org.assertj.swing.input.EventNormalizer,0,0,0,0,0,0,0,2,2
joel-costigliola_assertj-swing.org.assertj.swing.input.DisposalMonitor,1,0,0,0,0,0,0,0,1
joel-costigliola_assertj-swing.org.assertj.swing.annotation.GUITestFinder,0,0,0,0,0,0,0,0,0
joel-costigliola_assertj-swing.org.assertj.swing.format.ComponentFormatterTemplate,0,0,0,0,0,0,0,0,0
joel-costigliola_assertj-swing.org.assertj.swing.format.Formatting,0,0,0,0,0,0,0,0,0
joel-costigliola_assertj-swing.org.assertj.swing.format.IntEnum,0,0,0,0,0,0,0,0,0
joel-costigliola_assertj-swing.org.assertj.swing.format.IntrospectionComponentFormatter,0,0,0,0,0,0,0,0,0
joel-costigliola_assertj-swing.org.assertj.swing.timing.Condition,0,0,0,0,0,0,0,0,0
joel-costigliola_assertj-swing.org.assertj.swing.testing.AssertJSwingTestCaseTemplate,1,0,0,1,0,0,0,0,2
joel-costigliola_assertj-swing.org.assertj.swing.exception.ActionFailedException,0,0,0,0,0,0,0,0,0
joel-costigliola_assertj-swing.org.assertj.swing.exception.ComponentLookupException,0,0,0,0,0,0,0,0,0
joel-costigliola_assertj-swing.org.assertj.swing.exception.UnexpectedException,0,0,0,0,0,0,0,0,0
joel-costigliola_assertj-swing.org.assertj.swing.util.Maps,1,0,0,1,0,0,0,0,2
joel-costigliola_assertj-swing.org.assertj.swing.monitor.WindowMetrics,0,0,0,0,0,0,0,0,0
joel-costigliola_assertj-swing.org.assertj.swing.util.RobotFactory,0,0,0,0,0,1,0,1,2
joel-costigliola_assertj-swing.org.assertj.swing.monitor.Context,0,0,0,0,0,0,0,9,9
joel-costigliola_assertj-swing.org.assertj.swing.monitor.ContextMonitor,1,0,0,1,0,0,0,1,3
joel-costigliola_assertj-swing.org.assertj.swing.monitor.ProtectingTimerTask,0,0,0,0,0,0,0,0,0
joel-costigliola_assertj-swing.org.assertj.swing.listener.WeakEventListener,2,0,0,0,0,0,0,0,2
joel-costigliola_assertj-swing.org.assertj.swing.data.TableCellByColumnId,1,0,0,1,0,0,0,0,2
joel-costigliola_assertj-swing.org.assertj.swing.data.TableCellInSelectedRow,1,0,0,0,0,0,0,1,2
joel-costigliola_assertj-swing.org.assertj.swing.data.TableCellInRowByValue,1,0,0,0,0,0,0,0,1
joel-costigliola_assertj-swing.org.assertj.swing.keystroke.KeyStrokeLocale,0,0,0,0,0,0,0,0,0
joel-costigliola_assertj-swing.org.assertj.swing.keystroke.KeyStrokeMappingsParser,0,0,0,0,0,4,0,1,5
joel-costigliola_assertj-swing.org.assertj.swing.keystroke.KeyStrokeMapping,1,0,0,1,0,0,0,0,2
joel-costigliola_assertj-swing.org.assertj.swing.keystroke.KeyStrokeMappingProviderNames,0,0,0,0,0,0,0,0,0
joel-costigliola_assertj-swing.org.assertj.swing.keystroke.KeyStrokeMappingProviderFactory,0,0,0,0,0,0,0,0,0
joel-costigliola_assertj-swing.org.assertj.swing.keystroke.KeyStrokeMappingProvider,0,0,0,0,0,0,0,0,0
joel-costigliola_assertj-swing.org.assertj.swing.keystroke.KeyStrokeMap,0,0,0,0,0,0,0,0,0
joel-costigliola_assertj-swing.org.assertj.swing.text.JTextComponentTextReader,0,0,0,0,0,0,0,0,0
joel-costigliola_assertj-swing.org.assertj.swing.text.TextReader,0,0,0,0,0,0,0,1,1
joel-costigliola_assertj-swing.org.assertj.swing.text.JLabelTextReader,0,0,0,0,0,0,0,0,0
joel-costigliola_assertj-swing.org.assertj.swing.text.AbstractButtonTextReader,0,0,0,0,0,0,0,0,0
joel-costigliola_assertj-swing.org.assertj.swing.text.JListTextReader,0,0,0,0,0,0,0,0,0
joel-costigliola_assertj-swing.org.assertj.swing.fixture.AbstractComponentFixture,32,0,0,31,0,0,0,10,73
joel-costigliola_assertj-swing.org.assertj.swing.security.StackTraces,0,0,0,0,0,0,0,4,4
joel-costigliola_assertj-swing.org.assertj.swing.util.OSIdentifier,9,0,0,9,0,0,0,0,18
joel-costigliola_assertj-swing.org.assertj.swing.util.TimeoutWatch,0,0,0,0,0,0,0,0,0
joel-costigliola_assertj-swing.org.assertj.swing.util.StringTextMatcher,0,0,0,0,0,0,0,0,0
joel-costigliola_assertj-swing.org.assertj.swing.util.Arrays,0,0,0,0,0,0,0,0,0
joel-costigliola_assertj-swing.org.assertj.swing.util.AWTEvents,0,0,0,0,0,0,0,0,0
joel-costigliola_assertj-swing.org.assertj.swing.util.Strings,0,0,0,0,0,0,0,0,0
joel-costigliola_assertj-swing.org.assertj.swing.util.Modifiers,6,0,0,0,0,0,0,0,6
joel-costigliola_assertj-swing.org.assertj.swing.util.AWTExceptionHandlerInstaller,0,0,0,0,0,0,0,2,2
joel-costigliola_assertj-swing.org.assertj.swing.util.PatternTextMatcher,0,0,0,0,0,0,0,0,0
joel-costigliola_assertj-swing.org.assertj.swing.util.Colors,0,0,0,0,0,0,0,0,0
joel-costigliola_assertj-swing.org.assertj.swing.util.ImageReader,1,0,0,0,0,0,0,2,3
joel-costigliola_assertj-swing.org.assertj.swing.util.ToolkitProvider,0,0,0,0,0,0,0,0,0
joel-costigliola_assertj-swing.org.assertj.swing.util.Patterns,0,0,0,0,0,0,0,0,0
joel-costigliola_assertj-swing.org.assertj.swing.edt.GuiActionRunner,1,0,0,1,0,0,0,2,4
joel-costigliola_assertj-swing.org.assertj.swing.edt.FailOnThreadViolationRepaintManager,0,0,0,0,0,1,0,2,3
joel-costigliola_assertj-swing.org.assertj.swing.query.ComponentEnabledQuery,0,0,0,0,0,0,0,0,0
joel-costigliola_assertj-swing.org.assertj.swing.query.ComponentParentQuery,1,0,0,0,0,0,0,0,1
joel-costigliola_assertj-swing.org.assertj.swing.listener.EventDispatchThreadedEventListener,1,0,0,0,0,0,0,1,2
joel-costigliola_assertj-swing.org.assertj.swing.fixture.AbstractWindowFixture,0,0,0,0,0,0,0,8,8
joel-costigliola_assertj-swing.org.assertj.swing.core.AbstractComponentMatcher,0,0,0,0,0,0,0,0,0
joel-costigliola_assertj-swing.org.assertj.swing.core.NameMatcher,0,0,0,0,0,0,0,0,0
joel-costigliola_assertj-swing.org.assertj.swing.core.InputModifiers,0,0,0,0,0,0,0,0,0
joel-costigliola_assertj-swing.org.assertj.swing.core.FocusMonitor,0,0,0,0,0,0,0,0,0
joel-costigliola_assertj-swing.org.assertj.swing.core.BasicRobot,1,0,0,1,0,0,0,2,4
joel-costigliola_assertj-swing.org.assertj.swing.core.RobotEventGenerator,0,0,0,0,0,0,0,0,0
joel-costigliola_assertj-swing.org.assertj.swing.core.MainThreadIdentifier,0,0,0,0,0,0,0,0,0
joel-costigliola_assertj-swing.org.assertj.swing.core.GenericTypeMatcher,1,0,0,0,0,0,0,0,1
joel-costigliola_assertj-swing.org.assertj.swing.core.LabelMatcher,0,0,0,0,0,0,0,0,0
joel-costigliola_assertj-swing.org.assertj.swing.core.EmergencyAbortListener,0,0,0,0,0,0,0,7,7
joel-costigliola_assertj-swing.org.assertj.swing.core.ThreadsSource,0,0,0,0,0,0,0,2,2
joel-costigliola_assertj-swing.org.assertj.swing.core.SimpleFallbackExceptionHandler,0,0,0,0,0,0,0,1,1
joel-costigliola_assertj-swing.org.assertj.swing.core.WindowAncestorFinder,0,0,0,0,0,0,0,0,0
joel-costigliola_assertj-swing.org.assertj.swing.core.ComponentFoundCondition,2,0,0,2,0,0,0,2,6
joel-costigliola_assertj-swing.org.assertj.swing.core.Settings,0,0,0,0,0,0,0,2,2
joel-costigliola_assertj-swing.org.assertj.swing.core.FocusOwnerFinderStrategy,0,0,0,0,0,0,0,0,0
joel-costigliola_assertj-swing.org.assertj.swing.core.BasicComponentPrinter,0,0,0,0,0,0,0,0,0
joel-costigliola_assertj-swing.org.assertj.swing.core.HierarchyRootsSource,0,0,0,0,0,0,0,0,0
joel-costigliola_assertj-swing.org.assertj.swing.core.Scrolling,0,0,0,0,0,0,0,1,1
joel-costigliola_assertj-swing.org.assertj.swing.core.FrameDisposer,0,0,0,0,0,0,0,0,0
joel-costigliola_assertj-swing.org.assertj.swing.core.ComponentIsFocusableQuery,0,0,0,0,0,0,0,0,0
joel-costigliola_assertj-swing.org.assertj.swing.hierarchy.ComponentHierarchy,0,0,0,0,0,0,0,1,1
joel-costigliola_assertj-swing.org.assertj.swing.core.EdtSafeCondition,0,0,0,0,0,0,0,0,0
joel-costigliola_assertj-swing.org.assertj.swing.core.matcher.DialogMatcher,0,0,0,0,0,0,0,0,0
joel-costigliola_assertj-swing.org.assertj.swing.core.matcher.JTextComponentMatcher,0,0,0,0,0,0,0,0,0
joel-costigliola_assertj-swing.org.assertj.swing.core.matcher.JButtonMatcher,0,0,0,0,0,0,0,0,0
joel-costigliola_assertj-swing.org.assertj.swing.core.matcher.JLabelMatcher,0,0,0,0,0,0,0,0,0
joel-costigliola_assertj-swing.org.assertj.swing.core.matcher.FrameMatcher,0,0,0,0,0,0,0,0,0
joel-costigliola_assertj-swing.org.assertj.swing.core.matcher.NamedComponentMatcherTemplate,0,0,0,0,0,0,0,0,0
joel-costigliola_assertj-swing.org.assertj.swing.lock.ScreenLock,0,0,0,0,0,0,0,0,0
joel-costigliola_assertj-swing.org.assertj.swing.finder.JOptionPaneFinder,0,0,0,0,0,0,0,1,1
joel-costigliola_assertj-swing.org.assertj.swing.finder.JFileChooserFinder,0,0,0,0,0,0,0,0,0
joel-costigliola_assertj-swing.org.assertj.swing.finder.FrameFinder,0,0,0,0,0,0,0,0,0
joel-costigliola_assertj-swing.org.assertj.swing.finder.DialogFinder,0,0,0,0,0,0,0,1,1
joel-costigliola_assertj-swing.org.assertj.swing.finder.WindowFinder,0,0,0,0,0,0,0,0,0
joel-costigliola_assertj-swing.org.assertj.swing.fixture.JTextComponentFixture,0,0,0,0,0,0,0,0,0
joel-costigliola_assertj-swing.org.assertj.swing.fixture.JTableHeaderFixture,0,0,0,0,0,0,0,0,0
joel-costigliola_assertj-swing.org.assertj.swing.driver.JTableHeaderDriver,0,0,0,0,0,0,0,0,0
joel-costigliola_assertj-swing.org.assertj.swing.fixture.FontFixture,0,0,0,0,0,0,0,15,15
joel-costigliola_assertj-swing.org.assertj.swing.driver.JPopupMenuDriver,0,0,0,0,0,0,0,0,0
joel-costigliola_assertj-swing.org.assertj.swing.fixture.JPanelFixture,0,0,0,0,0,0,0,0,0
joel-costigliola_assertj-swing.org.assertj.swing.driver.JComponentDriver,0,0,0,0,0,0,0,0,0
joel-costigliola_assertj-swing.org.assertj.swing.fixture.JProgressBarFixture,0,0,0,0,0,0,0,0,0
joel-costigliola_assertj-swing.org.assertj.swing.fixture.AbstractContainerFixture,0,0,0,0,0,0,0,2,2
joel-costigliola_assertj-swing.org.assertj.swing.fixture.JListFixture,1,0,0,1,0,0,0,2,4
joel-costigliola_assertj-swing.org.assertj.swing.fixture.JScrollBarFixture,0,0,0,0,0,0,0,1,1
joel-costigliola_assertj-swing.org.assertj.swing.fixture.JComboBoxFixture,0,0,0,0,0,0,0,4,4
joel-costigliola_assertj-swing.org.assertj.swing.fixture.Containers,0,0,0,0,0,0,0,0,0
joel-costigliola_assertj-swing.org.assertj.swing.fixture.JTableCellFixture,2,0,0,2,0,0,0,4,8
joel-costigliola_assertj-swing.org.assertj.swing.fixture.JListItemFixture,1,0,0,1,0,0,0,0,2
joel-costigliola_assertj-swing.org.assertj.swing.fixture.JSpinnerFixture,0,0,0,0,0,0,0,0,0
joel-costigliola_assertj-swing.org.assertj.swing.fixture.JLabelFixture,0,0,0,0,0,0,0,0,0
joel-costigliola_assertj-swing.org.assertj.swing.fixture.JTabbedPaneFixture,0,0,0,0,0,0,0,1,1
joel-costigliola_assertj-swing.org.assertj.swing.fixture.JFileChooserFixture,0,0,0,0,0,0,0,2,2
joel-costigliola_assertj-swing.org.assertj.swing.driver.JFileChooserDriver,0,0,0,0,0,0,0,0,0
joel-costigliola_assertj-swing.org.assertj.swing.fixture.JInternalFrameFixture,0,0,0,0,0,0,0,1,1
joel-costigliola_assertj-swing.org.assertj.swing.driver.JTableDriver,1,0,0,1,0,0,0,0,2
joel-costigliola_assertj-swing.org.assertj.swing.fixture.JTreeFixture,2,0,0,2,0,0,0,3,7
joel-costigliola_assertj-swing.org.assertj.swing.fixture.JTreePathFixture,1,0,0,1,0,0,0,0,2
joel-costigliola_assertj-swing.org.assertj.swing.fixture.JTreeRowFixture,0,0,0,0,0,0,0,0,0
joel-costigliola_assertj-swing.org.assertj.swing.fixture.ColorFixture,0,0,0,0,0,0,0,4,4
joel-costigliola_assertj-swing.org.assertj.swing.fixture.JToolBarFixture,0,0,0,0,0,0,0,0,0
joel-costigliola_assertj-swing.org.assertj.swing.fixture.JSplitPaneFixture,0,0,0,0,0,0,0,0,0
joel-costigliola_assertj-swing.org.assertj.swing.fixture.FrameFixture,0,0,0,0,0,0,0,0,0
joel-costigliola_assertj-swing.org.assertj.swing.fixture.JSliderFixture,0,0,0,0,0,0,0,0,0
joel-costigliola_assertj-swing.org.assertj.swing.fixture.AbstractTwoStateButtonFixture,0,0,0,0,0,0,0,0,0
joel-costigliola_assertj-swing.org.assertj.swing.fixture.DialogFixture,0,0,0,0,0,0,0,0,0
joel-costigliola_assertj-swing.org.assertj.swing.driver.JOptionPaneDriver,0,0,0,0,0,0,0,0,0
joel-costigliola_assertj-swing.org.assertj.swing.fixture.JOptionPaneFixture,0,0,0,0,0,0,0,0,0
joel-costigliola_assertj-swing.org.assertj.swing.driver.JScrollPaneDriver,0,0,0,0,0,0,0,0,0
joel-costigliola_assertj-swing.org.assertj.swing.hierarchy.ExistingHierarchy,0,0,0,0,0,0,0,1,1
joel-costigliola_assertj-swing.org.assertj.swing.hierarchy.NewHierarchy,1,0,0,1,0,0,0,0,2
joel-costigliola_assertj-swing.org.assertj.swing.hierarchy.ParentFinder,0,0,0,0,0,0,0,0,0
joel-costigliola_assertj-swing.org.assertj.swing.hierarchy.JMenuChildrenFinder,0,0,0,0,0,0,0,0,0
joel-costigliola_assertj-swing.org.assertj.swing.hierarchy.WindowChildrenFinder,0,0,0,0,0,0,0,0,0
joel-costigliola_assertj-swing.org.assertj.swing.monitor.WindowMonitor,0,0,0,0,0,0,0,0,0
joel-costigliola_assertj-swing.org.assertj.swing.hierarchy.ChildrenFinderStrategy,0,0,0,0,0,0,0,0,0
joel-costigliola_assertj-swing.org.assertj.swing.hierarchy.ChildrenFinder,0,0,0,0,0,0,0,0,0
joel-costigliola_assertj-swing.org.assertj.swing.hierarchy.JDesktopPaneChildrenFinder,0,0,0,0,0,0,0,0,0
joel-costigliola_assertj-swing.org.assertj.swing.assertions.data.Point,0,0,0,0,0,0,0,0,0
joel-costigliola_assertj-swing.org.assertj.swing.assertions.data.RgbColor,1,0,0,0,0,0,0,1,2
joel-costigliola_assertj-swing.org.assertj.swing.launcher.AppletLauncher,1,0,0,1,0,0,0,3,5
joel-costigliola_assertj-swing.org.assertj.swing.launcher.ApplicationLauncher,0,0,0,0,0,0,0,3,3
joel-costigliola_assertj-swing.org.assertj.swing.launcher.AppletParameter,1,0,0,0,0,0,0,0,1
joel-costigliola_assertj-swing.org.assertj.swing.assertions.error.ShouldHaveDimension,2,0,0,0,0,0,0,0,2
joel-costigliola_assertj-swing.org.assertj.swing.assertions.error.ShouldBeEqualColors,2,0,0,0,0,0,0,0,2
fabric8io_quickstarts.io.fabric8.tooling.archetype.builder.ArchetypeBuilder,1,0,0,0,0,0,0,0,1
fabric8io_quickstarts.io.fabric8.tooling.archetype.ArchetypeUtils,4,0,0,0,0,0,0,0,4
ehcache_ehcache-jcache.org.ehcache.jcache.JCacheConfiguration,1,0,0,0,0,0,0,0,1
ehcache_ehcache-jcache.org.ehcache.jcache.JCacheCachingProvider,0,0,0,0,0,0,0,1,1
expercise_expercise.com.expercise.interpreter.InterpreterResult,1,0,0,1,0,0,0,0,2
expercise_expercise.com.expercise.interpreter.TestCaseModel,1,0,0,1,0,0,0,0,2
expercise_expercise.com.expercise.repository.challenge.ChallengeRepository,2,0,0,0,0,0,0,0,2
expercise_expercise.com.expercise.repository.challenge.UserPointRepository,0,0,0,0,0,0,0,0,0
expercise_expercise.com.expercise.repository.challenge.SolutionRepository,0,0,0,0,0,0,0,0,0
expercise_expercise.com.expercise.service.language.Python2SignatureGenerator,0,0,0,0,0,0,0,0,0
expercise_expercise.com.expercise.service.language.JavaSignatureGenerator,0,0,0,0,0,0,0,0,0
expercise_expercise.com.expercise.service.language.JavaScriptSignatureGenerator,0,0,0,0,0,0,0,0,0
expercise_expercise.com.expercise.service.email.EmailTemplateProcessor,0,0,0,0,0,0,0,1,1
expercise_expercise.com.expercise.service.challenge.LeaderBoardService,2,0,0,2,0,0,0,1,5
expercise_expercise.com.expercise.service.challenge.ChallengeDisplayRule,0,0,0,0,0,0,0,0,0
expercise_expercise.com.expercise.service.challenge.SolutionService,0,0,0,0,0,0,0,1,1
expercise_expercise.com.expercise.service.challenge.UserPointService,1,0,0,1,0,0,0,0,2
expercise_expercise.com.expercise.service.challenge.ChallengeService,3,0,0,3,0,0,0,0,6
expercise_expercise.com.expercise.service.challenge.action.PostEvaluationExecutor,0,0,0,0,0,0,0,2,2
expercise_expercise.com.expercise.service.challenge.action.PreEvaluationExecutor,0,0,0,0,0,0,0,1,1
expercise_expercise.com.expercise.service.challenge.action.postaction.CreateSolutionResponsePostAction,4,0,0,4,0,0,0,0,8
expercise_expercise.com.expercise.service.challenge.action.postaction.PrepareChallengeUserSolutionsPostAction,1,0,0,1,0,0,0,0,2
expercise_expercise.com.expercise.service.challenge.action.postaction.SaveUserSolutionPostAction,2,0,0,2,0,0,0,0,4
expercise_expercise.com.expercise.service.challenge.action.postaction.GiveSuccessPointPostAction,0,0,0,0,0,0,0,1,1
expercise_expercise.com.expercise.service.user.UserService,0,0,0,0,0,0,0,0,0
expercise_expercise.com.expercise.service.quote.QuoteService,1,0,0,1,0,0,0,0,2
expercise_expercise.com.expercise.utils.CookieUtils,0,0,0,0,0,0,0,0,0
expercise_expercise.com.expercise.utils.JsonUtils,1,0,0,0,0,0,0,0,1
expercise_expercise.com.expercise.interceptor.CommonViewParamsInterceptor,0,0,0,0,0,0,0,0,0
expercise_expercise.com.expercise.domain.user.User,0,0,0,0,0,0,0,0,0
expercise_expercise.com.expercise.controller.user.management.UserListingController,1,0,0,1,0,0,0,0,2
expercise_expercise.com.expercise.controller.HomeController,0,0,0,0,0,0,0,0,0
Firebase_geofire-java.com.firebase.geofire.util.GeoUtils,3,0,0,0,0,0,0,0,3
Firebase_geofire-java.com.firebase.geofire.testing.GeoFireTestingRule,6,0,0,4,0,0,0,7,17
Firebase_geofire-java.com.firebase.geofire.core.GeoHashQuery,3,1,0,0,0,0,0,0,4
mstahv_maddon.org.vaadin.viritin.fields.LabelField,0,0,0,0,0,0,0,0,0
mstahv_maddon.org.vaadin.viritin.fields.HeaderField,0,0,0,0,0,0,0,0,0
mstahv_maddon.org.vaadin.viritin.fluency.ui.FluentHasValueChangeMode,1,0,0,0,0,0,0,0,1
mstahv_maddon.org.vaadin.viritin.fields.DoubleField,0,0,0,0,0,0,0,0,0
mstahv_maddon.org.vaadin.viritin.fields.IntegerField,0,0,0,0,0,0,0,0,0
etsy_statsd-jvm-profiler.com.etsy.statsd.profiler.Profiler,0,0,0,0,0,0,0,1,1
etsy_statsd-jvm-profiler.com.etsy.statsd.profiler.util.StackTraceFilter,4,0,0,0,0,0,0,0,4
etsy_statsd-jvm-profiler.com.etsy.statsd.profiler.util.MapUtil,1,0,0,0,0,0,0,0,1
etsy_statsd-jvm-profiler.com.etsy.statsd.profiler.util.StackTraceFormatter,1,0,0,0,0,0,0,0,1
etsy_statsd-jvm-profiler.com.etsy.statsd.profiler.util.CPUTraces,2,0,0,2,0,0,0,0,4
etsy_statsd-jvm-profiler.com.etsy.statsd.profiler.util.TagUtil,0,0,0,0,0,0,0,1,1
etsy_statsd-jvm-profiler.com.etsy.statsd.profiler.util.TimeUtil,1,0,0,0,0,0,0,0,1
etsy_statsd-jvm-profiler.com.etsy.statsd.profiler.Arguments,2,0,0,0,0,0,0,4,6
etsy_statsd-jvm-profiler.com.etsy.statsd.profiler.worker.ProfilerThreadFactory,0,0,0,0,0,0,0,0,0
etsy_statsd-jvm-profiler.com.etsy.statsd.profiler.reporter.InfluxDBReporter,0,0,0,0,0,0,0,0,0
xmlunit_xmlunit.org.xmlunit.assertj.CompareAssert,0,0,0,0,0,0,0,55,55
xmlunit_xmlunit.org.xmlunit.assertj.XmlAssert,0,0,0,0,0,0,0,84,84
xmlunit_xmlunit.org.xmlunit.assertj.ValueAssert,0,0,0,0,0,0,0,18,18
xmlunit_xmlunit.org.xmlunit.assertj.MultipleNodeAssert,0,0,0,0,0,0,0,30,30
xmlunit_xmlunit.org.xmlunit.matchers.TypeMatcher,5,0,0,5,0,0,0,0,10
xmlunit_xmlunit.org.xmlunit.matchers.EvaluateXPathMatcher,4,0,0,0,0,1,0,0,5
xmlunit_xmlunit.org.xmlunit.matchers.CompareMatcher,7,0,0,3,0,5,0,0,15
xmlunit_xmlunit.org.xmlunit.matchers.HasXPathMatcher,6,0,0,1,0,1,0,0,8
xmlunit_xmlunit.org.xmlunit.matchers.ValidationMatcher,0,0,0,0,0,0,0,0,0
xmlunit_xmlunit.org.xmlunit.diff.ElementSelectors,6,0,0,6,0,0,1,0,13
xmlunit_xmlunit.org.xmlunit.builder.DiffBuilder,16,2,0,16,0,3,0,0,37
xmlunit_xmlunit.org.xmlunit.placeholder.PlaceholderHandler,0,0,0,0,0,0,0,0,0
xmlunit_xmlunit.org.xmlunit.builder.jakarta_jaxb.JakartaJaxbBuilder,3,2,0,0,0,0,0,0,5
xmlunit_xmlunit.org.xmlunit.builder.Input,2,1,0,1,0,0,0,12,16
xmlunit_xmlunit.org.xmlunit.builder.JaxbBuilder,4,4,0,0,0,0,0,0,8
xmlunit_xmlunit.org.xmlunit.input.NormalizedSource,1,0,0,0,0,0,0,0,1
xmlunit_xmlunit.org.xmlunit.util.Convert,2,0,0,0,0,3,0,0,5
xmlunit_xmlunit.org.xmlunit.xpath.XPathEngine,3,0,0,0,0,0,0,0,3
xmlunit_xmlunit.org.xmlunit.util.IterableNodeList,0,0,0,0,0,0,0,0,0
xmlunit_xmlunit.org.xmlunit.util.Nodes,7,0,0,0,0,0,0,0,7
xmlunit_xmlunit.org.xmlunit.util.Linqy,2,0,0,0,0,0,0,0,2
xmlunit_xmlunit.org.xmlunit.util.IsNullPredicate,0,0,0,0,0,0,0,0,0
xmlunit_xmlunit.org.xmlunit.validation.ValidationProblem,3,0,0,2,0,0,0,0,5
xmlunit_xmlunit.org.xmlunit.validation.ValidationHandler,5,0,0,5,0,0,0,0,10
xmlunit_xmlunit.org.xmlunit.validation.JAXPValidator,11,0,0,9,0,2,0,0,22
xmlunit_xmlunit.org.xmlunit.validation.ParsingValidator,5,0,0,5,0,0,0,0,10
xmlunit_xmlunit.org.xmlunit.validation.Validator,1,0,0,0,0,0,0,0,1
xmlunit_xmlunit.org.xmlunit.builder.Transform,0,0,0,0,0,0,0,0,0
xmlunit_xmlunit.org.xmlunit.builder.javax_jaxb.JavaxJaxbBuilder,3,2,0,0,0,0,0,0,5
xmlunit_xmlunit.org.xmlunit.diff.ComparisonController,3,0,0,0,0,0,0,0,3
xmlunit_xmlunit.org.xmlunit.diff.ElementSelector,9,0,0,0,0,0,0,0,9
xmlunit_xmlunit.org.xmlunit.diff.MultiLevelByNameAndTextSelector,1,0,0,0,0,0,0,0,1
xmlunit_xmlunit.org.xmlunit.diff.ComparisonListenerSupport,1,0,0,1,0,0,0,1,3
xmlunit_xmlunit.org.xmlunit.diff.AbstractDifferenceEngine,10,0,0,10,0,0,0,0,20
xmlunit_xmlunit.org.xmlunit.diff.RecursiveXPathBuilder,1,0,0,1,0,0,0,0,2
xmlunit_xmlunit.org.xmlunit.diff.DefaultNodeMatcher,3,0,0,1,0,0,0,0,4
xmlunit_xmlunit.org.xmlunit.diff.ChildNodeXPathContextProvider,0,0,0,0,0,0,0,0,0
xmlunit_xmlunit.org.xmlunit.diff.DOMDifferenceEngine,21,4,0,20,0,0,0,0,45
xmlunit_xmlunit.org.xmlunit.diff.DefaultComparisonFormatter,0,0,0,0,0,0,0,1,1
xmlunit_xmlunit.org.xmlunit.diff.Difference,0,0,0,0,0,0,0,0,0
xmlunit_xmlunit.org.xmlunit.diff.XPathContext,10,0,0,10,0,0,0,0,20
xmlunit_xmlunit.org.xmlunit.diff.DifferenceEvaluator,2,0,0,0,0,0,0,0,2
xmlunit_xmlunit.org.xmlunit.transform.Transformation,1,0,0,0,0,1,0,7,9
xmlunit_xmlunit.org.xmlunit.assertj3.CompareAssert,0,0,0,0,0,0,0,55,55
xmlunit_xmlunit.org.xmlunit.assertj3.XmlAssert,0,0,0,0,0,0,0,84,84
xmlunit_xmlunit.org.xmlunit.assertj3.ValueAssert,0,0,0,0,0,0,0,18,18
xmlunit_xmlunit.org.xmlunit.assertj3.MultipleNodeAssert,0,0,0,0,0,0,0,30,30
apache_incubator-twill.org.apache.twill.internal.zookeeper.InMemoryZKServer,3,0,0,2,0,0,0,0,5
apache_incubator-twill.org.apache.twill.internal.Services,0,0,0,0,0,0,0,0,0
apache_incubator-twill.org.apache.twill.filesystem.Location,3,0,0,3,0,0,0,0,6
apache_incubator-twill.org.apache.twill.filesystem.LocationFactories,1,0,0,1,0,0,0,0,2
apache_incubator-twill.org.apache.twill.filesystem.LocationFactory,1,0,0,1,0,0,0,0,2
apache_incubator-twill.org.apache.twill.api.TwillPreparer,6,0,0,6,0,0,0,1,13
apache_incubator-twill.org.apache.twill.api.ServiceController,3,0,0,3,0,0,0,0,6
apache_incubator-twill.org.apache.twill.api.TwillRunner,5,0,0,5,0,0,1,0,11
apache_incubator-twill.org.apache.twill.api.logging.LogEntry,1,1,0,1,0,0,0,0,3
apache_incubator-twill.org.apache.twill.api.TwillSpecification,2,0,0,2,0,0,0,0,4
apache_incubator-twill.org.apache.twill.discovery.DiscoveryServiceClient,6,0,0,6,0,1,0,0,13
apache_incubator-twill.org.apache.twill.internal.state.MessageCodec,1,0,0,1,0,0,0,0,2
apache_incubator-twill.org.apache.twill.filesystem.LocalLocationFactory,1,0,0,1,0,0,0,0,2
apache_incubator-twill.org.apache.twill.internal.json.JvmOptionsCodec,3,0,0,3,0,0,0,0,6
apache_incubator-twill.org.apache.twill.kafka.client.KafkaConsumer,1,0,0,1,0,0,0,0,2
apache_incubator-twill.org.apache.twill.zookeeper.RetryStrategy,5,0,0,5,0,0,0,0,10
apache_incubator-twill.org.apache.twill.zookeeper.ZKOperations,0,0,0,0,0,0,0,0,0
apache_incubator-twill.org.apache.twill.zookeeper.ZKClient,8,0,0,8,0,1,0,0,17
springer-opensource_omelet.omelet.driver.Driver,0,0,0,0,0,0,0,0,0
springer-opensource_omelet.omelet.data.xml.MappingParserRevisit,0,0,0,0,0,0,0,0,0
springer-opensource_omelet.omelet.data.driverconf.RefinedBrowserConf,0,0,0,0,0,0,0,0,0
springer-opensource_omelet.omelet.common.Utils,4,0,0,0,0,0,0,0,4
springer-opensource_omelet.omelet.data.xml.BrowserXmlParser,3,0,0,3,0,0,0,0,6
springer-opensource_omelet.omelet.data.driverconf.PrepareDriverConf,0,0,0,0,0,0,0,0,0
springer-opensource_omelet.omelet.mail.Email,0,2,0,0,0,0,0,0,2
redraiment_jactiverecord.me.zzp.util.Seq,1,0,0,0,0,0,0,0,1
redraiment_jactiverecord.me.zzp.ar.sql.SqlBuilder,7,0,0,7,0,0,0,0,14
redraiment_jactiverecord.me.zzp.ar.DB,1,0,0,1,0,0,0,2,4
OpenHFT_Chronicle-Wire.net.openhft.chronicle.wire.WireOut,55,2,0,55,0,0,0,2,114
OpenHFT_Chronicle-Wire.net.openhft.chronicle.wire.WireIn,3,0,0,3,0,0,0,4,10
OpenHFT_Chronicle-Wire.net.openhft.chronicle.wire.LongConverter,2,0,0,2,0,0,0,1,5
OpenHFT_Chronicle-Wire.net.openhft.chronicle.wire.AbstractLongConverter,0,0,0,0,0,0,0,0,0
OpenHFT_Chronicle-Wire.net.openhft.chronicle.wire.TextWire,21,0,0,9,0,1,1,11,43
OpenHFT_Chronicle-Wire.net.openhft.chronicle.wire.YamlWire,8,0,0,8,0,0,0,7,23
OpenHFT_Chronicle-Wire.net.openhft.chronicle.wire.AbstractTimestampLongConverter,4,0,0,4,0,0,0,0,8
OpenHFT_Chronicle-Wire.net.openhft.chronicle.wire.ValueOut,106,4,0,106,0,0,2,23,241
OpenHFT_Chronicle-Wire.net.openhft.chronicle.wire.MessagePathClassifier,1,0,0,0,0,0,0,0,1
OpenHFT_Chronicle-Wire.net.openhft.chronicle.wire.JSONWire,4,0,0,4,0,0,0,0,8
OpenHFT_Chronicle-Wire.net.openhft.chronicle.wire.MessageHistory,1,0,0,1,0,0,0,0,2
OpenHFT_Chronicle-Wire.net.openhft.chronicle.wire.VanillaMessageHistory,3,0,0,3,0,0,0,0,6
OpenHFT_Chronicle-Wire.net.openhft.chronicle.wire.CharSequenceObjectMap,0,0,0,0,0,0,0,0,0
OpenHFT_Chronicle-Wire.net.openhft.chronicle.wire.Marshallable,21,0,0,4,0,1,1,0,27
OpenHFT_Chronicle-Wire.net.openhft.chronicle.wire.VanillaMethodReader,1,0,0,1,0,0,0,0,2
OpenHFT_Chronicle-Wire.net.openhft.chronicle.wire.AbstractWire,6,0,0,2,0,1,0,0,9
OpenHFT_Chronicle-Wire.net.openhft.chronicle.wire.WireParser,0,0,0,0,0,0,0,0,0
OpenHFT_Chronicle-Wire.net.openhft.chronicle.wire.WireCommon,52,6,0,42,0,1,0,4,105
OpenHFT_Chronicle-Wire.net.openhft.chronicle.wire.MarshallableOut,0,0,0,0,0,0,0,1,1
OpenHFT_Chronicle-Wire.net.openhft.chronicle.wire.ValueIn,6,1,0,6,0,1,0,0,14
OpenHFT_Chronicle-Wire.net.openhft.chronicle.wire.VanillaWireParser,0,0,0,0,0,0,0,0,0
OpenHFT_Chronicle-Wire.net.openhft.chronicle.wire.CSVWire,1,0,0,1,0,0,0,1,3
OpenHFT_Chronicle-Wire.net.openhft.chronicle.wire.IntConverter,1,0,0,0,0,0,0,0,1
OpenHFT_Chronicle-Wire.net.openhft.chronicle.wire.QueryWire,1,0,0,1,0,0,0,0,2
OpenHFT_Chronicle-Wire.net.openhft.chronicle.wire.Wire,3,0,0,1,0,0,0,0,4
OpenHFT_Chronicle-Wire.net.openhft.chronicle.wire.GenerateMethodDelegate,0,0,0,0,0,0,0,0,0
OpenHFT_Chronicle-Wire.net.openhft.chronicle.wire.Base85IntConverter,1,0,0,0,0,0,0,0,1
OpenHFT_Chronicle-Wire.net.openhft.chronicle.wire.IdentifierLongConverter,1,0,0,0,0,0,0,0,1
OpenHFT_Chronicle-Wire.net.openhft.chronicle.wire.BinaryWire,3,0,0,1,0,0,1,0,5
OpenHFT_Chronicle-Wire.net.openhft.chronicle.wire.WireSerializedLambda,1,0,0,0,0,0,0,0,1
OpenHFT_Chronicle-Wire.net.openhft.chronicle.wire.WireToOutputStream,0,0,0,0,0,0,0,0,0
OpenHFT_Chronicle-Wire.net.openhft.chronicle.wire.Base256IntConverter,1,0,0,0,0,0,0,0,1
OpenHFT_Chronicle-Wire.net.openhft.chronicle.wire.ChronicleBitSet,4,1,0,3,0,0,1,2,11
OpenHFT_Chronicle-Wire.net.openhft.chronicle.wire.WireDumper,0,0,0,0,0,0,0,0,0
OpenHFT_Chronicle-Wire.net.openhft.chronicle.wire.HashWire,0,0,0,0,0,0,0,0,0
OpenHFT_Chronicle-Wire.net.openhft.chronicle.wire.utils.SourceCodeFormatter,0,0,0,0,0,0,0,0,0
OpenHFT_Chronicle-Wire.net.openhft.chronicle.wire.utils.YamlTester,0,0,0,0,0,0,0,0,0
OpenHFT_Chronicle-Wire.net.openhft.chronicle.wire.channel.SystemContext,2,0,0,0,0,1,0,0,3
OpenHFT_Chronicle-Wire.net.openhft.chronicle.wire.channel.ChronicleContext,1,0,0,0,0,0,0,4,5
OpenHFT_Chronicle-Wire.net.openhft.chronicle.wire.MethodWriter,1,0,0,1,0,0,0,0,2
OpenHFT_Chronicle-Wire.net.openhft.chronicle.wire.DocumentContext,0,0,0,0,0,0,0,0,0
OpenHFT_Chronicle-Wire.net.openhft.chronicle.wire.domestic.reduction.ConcurrentCollectors,2,0,0,0,0,0,0,0,2
OpenHFT_Chronicle-Wire.net.openhft.chronicle.wire.domestic.reduction.Reductions,1,0,0,1,0,0,0,0,2
OpenHFT_Chronicle-Wire.net.openhft.chronicle.wire.domestic.reduction.Reduction,0,0,0,0,0,0,0,0,0
OpenHFT_Chronicle-Wire.net.openhft.chronicle.wire.domestic.stream.Streams,0,0,0,0,0,0,0,1,1
MER-C_wiki-java.org.wikipedia.ExternalLinks,2,0,0,0,0,0,0,0,2
MER-C_wiki-java.org.wikipedia.Wiki,58,1,0,13,0,0,0,0,72
MER-C_wiki-java.org.wikipedia.MathsAndStats,4,0,0,0,0,0,0,0,4
MER-C_wiki-java.org.wikipedia.Pages,6,0,0,3,0,0,0,0,9
MER-C_wiki-java.org.wikipedia.WMFWiki,3,0,0,1,0,0,0,0,4
MER-C_wiki-java.org.wikipedia.WMFWikiFarm,3,0,0,2,0,0,0,0,5
MER-C_wiki-java.org.wikipedia.WikitextUtils,2,0,0,0,0,0,0,0,2
MER-C_wiki-java.org.wikipedia.DataTable,3,0,0,1,0,0,0,0,4
MER-C_wiki-java.org.wikipedia.Users,2,0,0,1,0,0,0,0,3
MER-C_wiki-java.org.wikipedia.tools.CCIAnalyzer,9,0,0,8,0,0,0,0,17
MER-C_wiki-java.org.wikipedia.tools.NPPCheck,2,0,0,2,0,0,0,0,4
MER-C_wiki-java.org.wikipedia.tools.ContributionSurveyor,4,0,0,4,0,0,0,0,8
MER-C_wiki-java.org.wikipedia.tools.ArticleEditorIntersector,3,0,0,2,0,0,0,0,5
MER-C_wiki-java.org.wikipedia.tools.CommandLineParser,3,0,0,3,0,0,0,0,6
MER-C_wiki-java.org.wikipedia.tools.UserLinkAdditionFinder,2,1,0,1,0,0,0,0,4
MER-C_wiki-java.org.wikipedia.tools.GapFillingTextSearch,1,0,0,0,0,0,0,0,1
MER-C_wiki-java.org.wikipedia.tools.ExternalLinkPopularity,3,0,0,1,0,0,0,0,4
MER-C_wiki-java.org.wikipedia.servlets.ServletUtils,2,0,0,1,0,0,0,0,3
MER-C_wiki-java.org.wikiutils.ParseUtils,1,0,0,0,0,0,0,0,1
jitsi_jicofo.org.jitsi.jicofo.conference.Participant,1,0,0,1,0,0,0,0,2
tesis-dynaware_graph-editor.de.tesis.dynaware.grapheditor.model.GModel,8,1,0,3,0,0,0,0,12
tesis-dynaware_graph-editor.de.tesis.dynaware.grapheditor.model.GConnectable,2,0,0,2,0,0,0,0,4
tesis-dynaware_graph-editor.de.tesis.dynaware.grapheditor.model.GNode,1,0,0,0,0,0,0,0,1
tesis-dynaware_graph-editor.de.tesis.dynaware.grapheditor.model.GConnector,2,0,0,0,0,0,0,0,2
tesis-dynaware_graph-editor.de.tesis.dynaware.grapheditor.model.GConnection,1,0,0,0,0,0,0,0,1
tesis-dynaware_graph-editor.de.tesis.dynaware.grapheditor.model.GJoint,1,0,0,0,0,0,0,0,1
tesis-dynaware_graph-editor.de.tesis.dynaware.grapheditor.model.GraphFactory,3,1,0,3,0,0,0,0,7
NirmataOSS_workflow.com.nirmata.workflow.details.AutoCleanerHolder,2,0,0,2,0,1,0,0,5
NirmataOSS_workflow.com.nirmata.workflow.WorkflowManagerBuilder,8,0,0,8,0,0,0,0,16
NirmataOSS_workflow.com.nirmata.workflow.models.Id,4,0,0,4,0,2,0,0,10
NirmataOSS_workflow.com.nirmata.workflow.details.ZooKeeperConstants,0,0,0,0,0,0,0,1,1
NirmataOSS_workflow.com.nirmata.workflow.WorkflowManager,1,0,0,1,0,1,0,0,3
NirmataOSS_workflow.com.nirmata.workflow.models.ExecutableTask,3,0,0,3,0,2,0,0,8
NirmataOSS_workflow.com.nirmata.workflow.details.SchedulerSelector,1,0,0,1,0,0,0,0,2
NirmataOSS_workflow.com.nirmata.workflow.serialization.JsonSerializer,0,0,0,0,0,0,0,0,0
phax_ph-css.com.helger.css.CSSFilenameHelper,1,0,0,1,0,0,0,0,2
phax_ph-css.com.helger.css.property.ICSSProperty,2,0,0,0,0,0,0,0,2
phax_ph-css.com.helger.css.tools.MediaQueryTools,2,0,0,1,0,0,0,0,3
phax_ph-css.com.helger.css.utils.CSSNumberHelper,4,1,0,0,0,0,0,0,5
phax_ph-css.com.helger.css.utils.CSSDataURLHelper,2,0,0,1,0,0,0,0,3
phax_ph-css.com.helger.css.utils.CSSColorHelper,14,0,0,11,0,0,0,0,25
phax_ph-css.com.helger.css.utils.CSSURLHelper,2,0,0,1,0,0,0,0,3
phax_ph-css.com.helger.css.utils.CSSRectHelper,2,0,0,0,0,0,0,0,2
phax_ph-css.com.helger.css.parser.CSSParseHelper,1,0,0,0,0,0,0,0,1
phax_ph-css.com.helger.css.parser.ParserCSS30,1,0,0,1,0,0,0,0,2
phax_ph-css.com.helger.css.decl.CSSUnknownRule,1,0,0,1,0,0,0,0,2
phax_ph-css.com.helger.css.decl.CSSNamespaceRule,1,0,0,1,0,0,0,0,2
phax_ph-css.com.helger.css.decl.CSSURI,2,0,0,2,0,0,0,0,4
phax_ph-css.com.helger.css.decl.CSSImportRule,1,0,0,1,0,0,0,0,2
phax_ph-css.com.helger.css.ICSSWriteable,1,0,0,1,0,0,0,0,2
phax_ph-css.com.helger.css.decl.CSSRect,1,0,0,1,0,0,0,0,2
phax_ph-css.com.helger.css.decl.CSSStyleRule,2,0,0,2,0,0,0,0,4
phax_ph-css.com.helger.css.decl.CSSSelector,1,0,0,1,0,0,0,0,2
phax_ph-css.com.helger.css.decl.CSSSupportsRule,2,0,0,2,0,0,0,0,4
phax_ph-css.com.helger.css.decl.CascadingStyleSheet,12,0,0,12,0,0,0,0,24
phax_ph-css.com.helger.css.reader.CSSReaderDeclarationList,5,0,0,3,0,0,0,0,8
phax_ph-css.com.helger.css.reader.CSSReader,33,1,0,30,0,0,0,0,64
phax_ph-css.com.helger.css.decl.shorthand.CSSShortHandRegistry,1,0,0,0,0,0,0,0,1
phax_ph-css.com.helger.css.decl.shorthand.CSSShortHandDescriptor,26,0,0,26,0,0,0,0,52
phax_ph-css.com.helger.css.reader.CSSReaderSettings,5,1,0,5,0,0,1,0,12
phax_ph-css.com.helger.css.writer.CSSWriter,9,0,0,9,0,0,0,0,18
phax_ph-css.com.helger.css.decl.AbstractHasTopLevelRules,10,0,0,10,0,0,0,1,21
internet-research-network_breeze.eu.icolumbo.breeze.connect.SpringRPCRequest,2,0,0,2,0,0,0,0,4
internet-research-network_breeze.eu.icolumbo.breeze.connect.SpringRPCResponse,3,0,0,3,0,0,0,1,7
internet-research-network_breeze.eu.icolumbo.breeze.SpringSpout,2,0,0,1,0,1,0,6,10
internet-research-network_breeze.eu.icolumbo.breeze.SpringComponent,6,0,0,5,0,1,0,1,13
internet-research-network_breeze.eu.icolumbo.breeze.SpringBolt,0,0,0,0,0,0,0,1,1
internet-research-network_breeze.eu.icolumbo.breeze.build.TopologyCompilation,1,0,0,0,0,1,0,1,3
internet-research-network_breeze.eu.icolumbo.breeze.namespace.TopologyStarter,1,0,0,0,0,0,0,0,1
internet-research-network_breeze.eu.icolumbo.breeze.FunctionSignature,0,0,0,0,0,0,0,0,0
davidmoten_rtree.com.github.davidmoten.rtree.RTree,15,0,0,17,0,0,1,11,44
davidmoten_rtree.com.github.davidmoten.rtree.internal.util.ImmutableStack,1,0,0,1,0,0,0,1,3
davidmoten_rtree.com.github.davidmoten.rtree.geometry.Geometries,2,0,0,2,0,0,0,0,4
davidmoten_rtree.com.github.davidmoten.rtree.geometry.Geometry,9,0,0,2,0,0,0,0,11
davidmoten_rtree.com.github.davidmoten.rtree.internal.Util,0,0,0,0,0,0,0,0,0
davidmoten_rtree.com.github.davidmoten.rtree.NodePosition,0,0,0,0,0,0,0,0,0
davidmoten_rtree.com.github.davidmoten.rtree.ImageSaver,0,0,0,0,0,0,0,0,0
davidmoten_rtree.com.github.davidmoten.rtree.Serializers,0,0,0,0,0,0,0,8,8
davidmoten_rtree.com.github.davidmoten.rtree.Factories,0,0,0,0,0,0,0,1,1
davidmoten_rtree.com.github.davidmoten.rtree.Entry,0,0,0,0,0,0,0,0,0
davidmoten_rtree.com.github.davidmoten.rtree.internal.util.BoundedPriorityQueue,0,0,0,0,0,0,0,0,0
davidmoten_rtree.com.github.davidmoten.rtree.internal.util.ObjectsHelper,0,0,0,0,0,0,0,1,1
davidmoten_rtree.com.github.davidmoten.rtree.fbs.SerializerFlatBuffers,1,0,0,0,0,1,0,0,2
davidmoten_rtree.com.github.davidmoten.rtree.geometry.Point,2,0,0,2,0,0,0,0,4
davidmoten_rtree.com.github.davidmoten.rtree.geometry.Rectangle,2,0,0,2,0,0,0,0,4
davidmoten_rtree.com.github.davidmoten.rtree.geometry.HasGeometry,0,0,0,0,0,0,0,0,0
davidmoten_rtree.com.github.davidmoten.rtree.geometry.Circle,1,0,0,1,0,0,0,0,2
awslabs_aws-ant-tasks.com.amazonaws.ant.elasticbeanstalk.DeployAppToBeanstalkTask,2,2,0,2,0,2,0,0,8
awslabs_aws-ant-tasks.com.amazonaws.ant.s3.UploadFileSetToS3Task,1,0,0,1,0,0,0,0,2
awslabs_aws-ant-tasks.com.amazonaws.ant.s3.DownloadFileFromS3Task,1,0,0,1,0,0,0,0,2
awslabs_aws-ant-tasks.com.amazonaws.ant.cloudformation.CreateStackTask,1,0,0,1,0,0,0,0,2
awslabs_aws-ant-tasks.com.amazonaws.ant.opsworks.CreateLayerTask,1,0,0,1,0,0,0,0,2
javaparser_javaparser.com.github.javaparser.symbolsolver.javaparser.Navigator,135,0,0,135,0,0,0,1,271
javaparser_javaparser.com.github.javaparser.ParserConfiguration,42,1,0,42,0,3,0,3,91
javaparser_javaparser.com.github.javaparser.StaticJavaParser,31,0,0,31,0,0,0,14,76
javaparser_javaparser.com.github.javaparser.symbolsolver.javaparsermodel.JavaParserFacade,29,0,0,29,0,0,0,2,60
javaparser_javaparser.com.github.javaparser.symbolsolver.model.resolution.TypeSolver,62,3,0,61,0,1,0,3,130
javaparser_javaparser.com.github.javaparser.ast.CompilationUnit,28,0,0,28,0,0,0,3,59
javaparser_javaparser.com.github.javaparser.ParseResult,18,0,0,17,0,3,0,0,38
javaparser_javaparser.com.github.javaparser.symbolsolver.resolution.typesolvers.CombinedTypeSolver,22,0,0,22,0,4,0,5,53
javaparser_javaparser.com.github.javaparser.ast.nodeTypes.NodeWithMembers,8,0,0,4,0,0,0,0,12
javaparser_javaparser.com.github.javaparser.ast.Node,22,0,0,18,0,0,0,1,41
javaparser_javaparser.com.github.javaparser.utils.ProjectRoot,0,0,0,0,0,0,0,0,0
javaparser_javaparser.com.github.javaparser.symbolsolver.utils.SymbolSolverCollectionStrategy,0,0,0,0,0,0,0,0,0
javaparser_javaparser.com.github.javaparser.symbolsolver.cache.GuavaCache,5,0,0,2,0,0,0,0,7
javaparser_javaparser.com.github.javaparser.symbolsolver.cache.InMemoryCache,4,0,0,1,0,0,0,0,5
javaparser_javaparser.com.github.javaparser.symbolsolver.cache.NoCache,4,0,0,1,0,0,0,0,5
javaparser_javaparser.com.github.javaparser.symbolsolver.model.typesystem.NullType,1,0,0,0,0,0,0,0,1
javaparser_javaparser.com.github.javaparser.resolution.types.ResolvedType,23,0,0,3,0,0,0,0,26
javaparser_javaparser.com.github.javaparser.resolution.types.ResolvedWildcard,4,0,0,1,0,0,0,0,5
javaparser_javaparser.com.github.javaparser.resolution.declarations.ResolvedTypeParameterDeclaration,2,0,0,2,0,0,0,0,4
javaparser_javaparser.com.github.javaparser.symbolsolver.model.typesystem.ReferenceTypeImpl,9,1,0,2,0,0,0,0,12
javaparser_javaparser.com.github.javaparser.resolution.types.ResolvedArrayType,4,0,0,0,0,0,0,0,4
javaparser_javaparser.com.github.javaparser.resolution.types.ResolvedReferenceType,16,0,0,11,0,0,0,0,27
javaparser_javaparser.com.github.javaparser.resolution.declarations.ResolvedReferenceTypeDeclaration,7,0,0,7,0,0,0,7,21
javaparser_javaparser.com.github.javaparser.resolution.declarations.ResolvedClassDeclaration,3,0,0,1,0,0,0,0,4
javaparser_javaparser.com.github.javaparser.resolution.declarations.ResolvedDeclaration,10,7,0,4,0,0,0,0,21
javaparser_javaparser.com.github.javaparser.resolution.declarations.ResolvedTypeDeclaration,8,4,0,1,0,0,0,0,13
javaparser_javaparser.com.github.javaparser.symbolsolver.reflectionmodel.ReflectionClassDeclaration,3,0,0,3,0,0,0,0,6
javaparser_javaparser.com.github.javaparser.resolution.MethodUsage,5,0,0,5,0,0,0,0,10
javaparser_javaparser.com.github.javaparser.resolution.declarations.ResolvedFieldDeclaration,1,0,0,0,0,0,0,2,3
javaparser_javaparser.com.github.javaparser.symbolsolver.reflectionmodel.ReflectionAnnotationDeclaration,0,0,0,0,0,0,0,0,0
javaparser_javaparser.com.github.javaparser.symbolsolver.logic.AbstractTypeDeclaration,0,0,0,0,0,0,0,0,0
javaparser_javaparser.com.github.javaparser.symbolsolver.logic.FunctionalInterfaceLogic,2,0,0,2,0,0,0,0,4
javaparser_javaparser.com.github.javaparser.symbolsolver.logic.InferenceContext,0,0,0,0,0,0,0,0,0
javaparser_javaparser.com.github.javaparser.symbolsolver.javaparsermodel.declarations.JavaParserClassDeclaration,14,0,0,14,0,0,0,0,28
javaparser_javaparser.com.github.javaparser.symbolsolver.javaparsermodel.declarations.JavaParserTypeVariableDeclaration,0,0,0,0,0,0,0,0,0
javaparser_javaparser.com.github.javaparser.symbolsolver.javaparsermodel.declarations.JavaParserInterfaceDeclaration,0,0,0,0,0,0,0,0,0
javaparser_javaparser.com.github.javaparser.symbolsolver.javaparsermodel.declarations.JavaParserEnumDeclaration,1,0,0,1,0,0,0,0,2
javaparser_javaparser.com.github.javaparser.symbolsolver.javaparsermodel.declarations.JavaParserSymbolDeclaration,3,0,0,3,0,0,0,0,6
javaparser_javaparser.com.github.javaparser.ast.nodeTypes.NodeWithVariables,1,0,0,0,0,0,0,2,3
javaparser_javaparser.com.github.javaparser.symbolsolver.resolution.typesolvers.AarTypeSolver,1,0,0,1,0,0,0,0,2
javaparser_javaparser.com.github.javaparser.symbolsolver.resolution.typesolvers.ClassLoaderTypeSolver,1,0,0,1,0,0,0,0,2
javaparser_javaparser.com.github.javaparser.symbolsolver.resolution.typesolvers.MemoryTypeSolver,2,0,0,1,0,0,0,1,4
javaparser_javaparser.com.github.javaparser.symbolsolver.resolution.typesolvers.JarTypeSolver,3,0,0,3,0,0,0,0,6
javaparser_javaparser.com.github.javaparser.symbolsolver.model.resolution.SymbolReference,0,0,0,0,0,0,0,0,0
javaparser_javaparser.com.github.javaparser.symbolsolver.resolution.typesolvers.JavaParserTypeSolver,6,0,0,5,0,0,0,0,11
javaparser_javaparser.com.github.javaparser.symbolsolver.resolution.typeinference.ConstraintFormula,1,0,0,1,0,0,0,0,2
javaparser_javaparser.com.github.javaparser.symbolsolver.resolution.typeinference.Bound,1,0,0,0,0,0,0,0,1
javaparser_javaparser.com.github.javaparser.symbolsolver.resolution.naming.NameLogic,2,0,0,2,0,0,0,0,4
javaparser_javaparser.com.github.javaparser.ast.expr.MethodCallExpr,1,0,0,1,0,0,0,0,2
javaparser_javaparser.com.github.javaparser.ast.body.Parameter,0,0,0,0,0,0,0,0,0
javaparser_javaparser.com.github.javaparser.ast.body.BodyDeclaration,10,0,0,10,0,0,0,4,24
javaparser_javaparser.com.github.javaparser.symbolsolver.resolution.SymbolSolver,9,0,0,5,0,7,0,0,21
javaparser_javaparser.com.github.javaparser.ast.expr.NameExpr,1,0,0,1,0,0,0,1,3
javaparser_javaparser.com.github.javaparser.ast.body.EnumConstantDeclaration,0,0,0,0,0,0,0,0,0
javaparser_javaparser.com.github.javaparser.ast.expr.Expression,6,0,0,6,0,0,0,0,12
javaparser_javaparser.com.github.javaparser.utils.Log,1,0,0,1,0,0,0,0,2
javaparser_javaparser.com.github.javaparser.symbolsolver.core.resolution.Context,8,0,0,7,0,0,0,0,15
javaparser_javaparser.com.github.javaparser.ast.body.VariableDeclarator,1,0,0,1,0,0,0,1,3
javaparser_javaparser.com.github.javaparser.ast.stmt.Statement,5,0,0,5,0,0,0,4,14
javaparser_javaparser.com.github.javaparser.ast.NodeList,25,0,0,21,0,0,0,1,47
javaparser_javaparser.com.github.javaparser.symbolsolver.javassistmodel.JavassistAnnotationDeclaration,1,0,0,1,0,0,0,0,2
javaparser_javaparser.com.github.javaparser.symbolsolver.javassistmodel.JavassistParameterDeclaration,0,0,0,0,0,0,0,0,0
javaparser_javaparser.com.github.javaparser.symbolsolver.javassistmodel.JavassistInterfaceDeclaration,0,0,0,0,0,0,0,0,0
javaparser_javaparser.com.github.javaparser.symbolsolver.javassistmodel.JavassistClassDeclaration,6,0,0,6,0,0,0,0,12
javaparser_javaparser.com.github.javaparser.ast.nodeTypes.NodeWithStatements,0,0,0,0,0,0,0,1,1
javaparser_javaparser.com.github.javaparser.symbolsolver.javassistmodel.JavassistMethodDeclaration,1,0,0,1,0,0,0,0,2
javaparser_javaparser.com.github.javaparser.ast.type.Type,2,0,0,2,0,0,0,0,4
javaparser_javaparser.com.github.javaparser.ast.type.ArrayType,6,0,0,6,0,0,0,0,12
javaparser_javaparser.com.github.javaparser.ast.type.ClassOrInterfaceType,6,0,0,5,0,0,0,0,11
javaparser_javaparser.com.github.javaparser.ast.nodeTypes.NodeWithJavadoc,3,0,0,3,0,0,0,0,6
javaparser_javaparser.com.github.javaparser.Providers,7,0,0,7,0,0,0,0,14
javaparser_javaparser.com.github.javaparser.ast.body.FieldDeclaration,5,0,0,5,0,0,0,0,10
javaparser_javaparser.com.github.javaparser.ast.nodeTypes.NodeWithBlockStmt,0,0,0,0,0,0,0,0,0
javaparser_javaparser.com.github.javaparser.ast.body.AnnotationMemberDeclaration,1,0,0,1,0,0,0,0,2
javaparser_javaparser.com.github.javaparser.ast.body.ClassOrInterfaceDeclaration,5,0,0,5,0,0,0,0,10
javaparser_javaparser.com.github.javaparser.ast.body.RecordDeclaration,12,0,0,8,0,0,0,0,20
javaparser_javaparser.com.github.javaparser.ast.nodeTypes.NodeWithType,1,0,0,0,0,0,0,0,1
javaparser_javaparser.com.github.javaparser.ast.nodeTypes.NodeWithSimpleName,1,0,0,1,0,0,0,0,2
javaparser_javaparser.com.github.javaparser.ast.body.TypeDeclaration,0,0,0,0,0,0,0,0,0
javaparser_javaparser.com.github.javaparser.ast.nodeTypes.NodeWithModifiers,0,0,0,0,0,0,0,0,0
javaparser_javaparser.com.github.javaparser.ast.nodeTypes.NodeWithTraversableScope,1,0,0,1,0,0,0,0,2
javaparser_javaparser.com.github.javaparser.ast.nodeTypes.NodeWithBody,0,0,0,0,0,0,0,0,0
javaparser_javaparser.com.github.javaparser.ast.stmt.YieldStmt,0,0,0,0,0,0,0,0,0
javaparser_javaparser.com.github.javaparser.ast.stmt.BreakStmt,7,0,0,4,0,0,0,0,11
javaparser_javaparser.com.github.javaparser.ast.stmt.SwitchStmt,1,0,0,1,0,0,0,0,2
javaparser_javaparser.com.github.javaparser.ast.stmt.TryStmt,1,0,0,1,0,0,0,0,2
javaparser_javaparser.com.github.javaparser.ast.stmt.ForEachStmt,2,0,0,2,0,0,0,0,4
javaparser_javaparser.com.github.javaparser.ast.visitor.NoCommentEqualsVisitor,0,0,0,0,0,0,0,0,0
javaparser_javaparser.com.github.javaparser.ast.visitor.TreeVisitor,0,0,0,0,0,0,0,3,3
javaparser_javaparser.com.github.javaparser.ast.expr.LiteralStringValueExpr,3,0,0,3,0,0,0,0,6
javaparser_javaparser.com.github.javaparser.printer.lexicalpreservation.LexicalPreservingPrinter,10,0,0,8,0,1,0,1,20
javaparser_javaparser.com.github.javaparser.ast.visitor.CloneVisitor,1,1,0,1,0,0,0,0,3
javaparser_javaparser.com.github.javaparser.ast.visitor.NoCommentHashCodeVisitor,0,0,0,0,0,0,0,94,94
javaparser_javaparser.com.github.javaparser.ast.visitor.ObjectIdentityHashCodeVisitor,0,0,0,0,0,0,0,0,0
javaparser_javaparser.com.github.javaparser.ast.visitor.HashCodeVisitor,0,0,0,0,0,0,0,97,97
javaparser_javaparser.com.github.javaparser.ast.type.PrimitiveType,1,0,0,1,0,0,0,0,2
javaparser_javaparser.com.github.javaparser.ast.expr.TextBlockLiteralExpr,1,0,0,1,0,0,0,0,2
javaparser_javaparser.com.github.javaparser.ast.expr.SimpleName,0,0,0,0,0,0,0,0,0
javaparser_javaparser.com.github.javaparser.ast.expr.ThisExpr,0,0,0,0,0,0,0,0,0
javaparser_javaparser.com.github.javaparser.ast.expr.MethodReferenceExpr,0,0,0,0,0,0,0,0,0
javaparser_javaparser.com.github.javaparser.ast.expr.LambdaExpr,0,0,0,0,0,0,0,0,0
javaparser_javaparser.com.github.javaparser.ast.expr.SuperExpr,0,0,0,0,0,0,0,0,0
javaparser_javaparser.com.github.javaparser.ast.expr.InstanceOfExpr,2,0,0,2,0,0,0,0,4
javaparser_javaparser.com.github.javaparser.ast.expr.DoubleLiteralExpr,0,0,0,0,0,0,0,0,0
javaparser_javaparser.com.github.javaparser.ast.expr.Name,2,0,0,2,0,0,0,0,4
javaparser_javaparser.com.github.javaparser.ast.expr.SwitchExpr,1,0,0,1,0,0,0,0,2
javaparser_javaparser.com.github.javaparser.ast.validator.Validators,0,0,0,0,0,0,0,0,0
javaparser_javaparser.com.github.javaparser.ast.type.UnionType,0,0,0,0,0,0,0,0,0
javaparser_javaparser.com.github.javaparser.ast.comments.Comment,3,0,0,3,0,0,0,0,6
javaparser_javaparser.com.github.javaparser.javadoc.description.JavadocDescription,1,0,0,1,0,0,0,0,2
javaparser_javaparser.com.github.javaparser.metamodel.PropertyMetaModel,3,0,0,3,0,0,0,0,6
javaparser_javaparser.com.github.javaparser.utils.CodeGenerationUtils,2,0,0,0,0,0,0,1,3
javaparser_javaparser.com.github.javaparser.TokenRange,1,0,0,1,0,0,0,0,2
javaparser_javaparser.com.github.javaparser.Problem,1,0,0,1,0,0,0,0,2
javaparser_javaparser.com.github.javaparser.Range,21,0,0,4,0,0,0,0,25
javaparser_javaparser.com.github.javaparser.javadoc.Javadoc,5,0,0,5,0,0,0,0,10
javaparser_javaparser.com.github.javaparser.JavadocParser,0,0,0,0,0,0,0,0,0
javaparser_javaparser.com.github.javaparser.UnicodeEscapeProcessingProvider,1,0,0,1,0,0,0,0,2
javaparser_javaparser.com.github.javaparser.JavaToken,1,0,0,0,0,0,0,0,1
javaparser_javaparser.com.github.javaparser.printer.YamlPrinter,0,0,0,0,0,0,0,1,1
javaparser_javaparser.com.github.javaparser.utils.ParserCollectionStrategy,1,0,0,1,0,0,0,0,2
javaparser_javaparser.com.github.javaparser.utils.Pair,0,0,0,0,0,0,0,0,0
javaparser_javaparser.com.github.javaparser.utils.Utils,10,0,0,0,0,0,0,0,10
javaparser_javaparser.com.github.javaparser.utils.SourceZip,2,0,0,2,0,0,0,0,4
javaparser_javaparser.com.github.javaparser.utils.PositionUtils,6,0,0,6,0,0,0,0,12
javaparser_javaparser.com.github.javaparser.utils.VisitorList,3,0,0,3,0,0,0,0,6
javaparser_javaparser.com.github.javaparser.utils.VisitorMap,1,0,0,1,0,0,0,0,2
javaparser_javaparser.com.github.javaparser.utils.SourceRoot,1,0,0,1,0,0,0,3,5
javaparser_javaparser.com.github.javaparser.printer.configuration.PrinterConfiguration,1,0,0,0,0,0,0,0,1
javaparser_javaparser.com.github.javaparser.printer.configuration.ConfigurationOption,1,0,0,1,0,0,0,0,2
javaparser_javaparser.com.github.javaparser.printer.configuration.DefaultPrinterConfiguration,1,0,0,1,0,0,0,0,2
javaparser_javaparser.com.github.javaparser.printer.DefaultPrettyPrinter,0,0,0,0,0,0,0,0,0
javaparser_javaparser.com.github.javaparser.printer.configuration.Indentation,6,0,0,6,0,0,0,0,12
javaparser_javaparser.com.github.javaparser.printer.DotPrinter,0,0,0,0,0,0,0,0,0
javaparser_javaparser.com.github.javaparser.ast.expr.CastExpr,0,0,0,0,0,0,0,0,0
javaparser_javaparser.com.github.javaparser.printer.XmlPrinter,0,0,0,0,0,0,0,0,0
javaparser_javaparser.com.github.javaparser.ast.body.CallableDeclaration,1,0,0,1,0,0,0,0,2
javaparser_javaparser.com.github.javaparser.ast.Modifier,4,0,0,4,0,0,0,0,8
javaparser_javaparser.com.github.javaparser.ast.stmt.SwitchEntry,0,0,0,0,0,0,0,0,0
javaparser_javaparser.com.github.javaparser.ast.expr.ObjectCreationExpr,0,0,0,0,0,0,0,0,0
javaparser_javaparser.com.github.javaparser.printer.lexicalpreservation.DifferenceElement,2,0,0,0,0,0,0,0,2
javaparser_javaparser.com.github.javaparser.printer.ConcreteSyntaxModel,1,0,0,1,0,0,0,0,2
javaparser_javaparser.com.github.javaparser.printer.lexicalpreservation.DifferenceElementCalculator,5,0,0,5,0,0,0,0,10
javaparser_javaparser.com.github.javaparser.printer.lexicalpreservation.LexicalDifferenceCalculator,16,0,0,16,0,0,0,0,32
javaparser_javaparser.com.github.javaparser.ast.body.EnumDeclaration,0,0,0,0,0,0,0,0,0
javaparser_javaparser.com.github.javaparser.printer.lexicalpreservation.ChildTextElement,1,0,0,1,0,0,0,0,2
javaparser_javaparser.com.github.javaparser.printer.lexicalpreservation.TextElement,1,0,0,1,0,0,0,0,2
javaparser_javaparser.com.github.javaparser.ast.nodeTypes.NodeWithAnnotations,0,0,0,0,0,0,0,0,0
javaparser_javaparser.com.github.javaparser.ast.stmt.IfStmt,0,0,0,0,0,0,0,0,0
javaparser_javaparser.com.github.javaparser.ast.nodeTypes.NodeWithParameters,0,0,0,0,0,0,0,0,0
javaparser_javaparser.com.github.javaparser.ast.body.MethodDeclaration,1,0,0,1,0,0,0,0,2
javaparser_javaparser.com.github.javaparser.printer.lexicalpreservation.changes.NoChange,0,0,0,0,0,0,0,0,0
javaparser_javaparser.com.github.javaparser.resolution.declarations.HasAccessSpecifier,0,0,0,0,0,0,0,0,0
javaparser_javaparser.com.github.javaparser.resolution.declarations.ResolvedPatternDeclaration,0,0,0,0,0,0,0,0,0
javaparser_javaparser.com.github.javaparser.resolution.declarations.ResolvedEnumConstantDeclaration,0,0,0,0,0,0,0,0,0
javaparser_javaparser.com.github.javaparser.resolution.declarations.AssociableToAST,1,1,0,0,0,0,0,0,2
javaparser_javaparser.com.github.javaparser.resolution.declarations.ResolvedValueDeclaration,0,0,0,0,0,0,0,0,0
javaparser_javaparser.com.github.javaparser.resolution.declarations.ResolvedEnumDeclaration,0,0,0,0,0,0,0,0,0
javaparser_javaparser.com.github.javaparser.resolution.declarations.ResolvedParameterDeclaration,0,0,0,0,0,0,0,0,0
javaparser_javaparser.com.github.javaparser.resolution.declarations.ResolvedAnnotationDeclaration,0,0,0,0,0,0,0,0,0
javaparser_javaparser.com.github.javaparser.resolution.declarations.ResolvedTypeParametrizable,0,0,0,0,0,0,0,0,0
javaparser_javaparser.com.github.javaparser.javadoc.description.JavadocInlineTag,0,0,0,0,0,0,0,0,0
javaparser_javaparser.com.github.javaparser.serialization.JavaParserJsonDeserializer,4,0,0,4,0,0,0,0,8
javaparser_javaparser.com.github.javaparser.ast.ImportDeclaration,2,0,0,2,0,0,0,0,4
javaparser_javaparser.com.github.javaparser.ast.body.InitializerDeclaration,0,0,0,0,0,0,0,0,0
javaparser_javaparser.com.github.javaparser.ast.body.ConstructorDeclaration,0,0,0,0,0,0,0,0,0
javaparser_javaparser.com.github.javaparser.ast.ArrayCreationLevel,0,0,0,0,0,0,0,0,0
javaparser_javaparser.com.github.javaparser.ast.modules.ModuleDeclaration,3,0,0,3,0,0,0,0,6
javaparser_javaparser.com.github.javaparser.generator.core.utils.CodeUtils,0,0,0,0,0,0,0,0,0
javaparser_javaparser.com.github.javaparser.ast.type.VarType,0,0,0,0,0,0,0,0,0
tynamo_tapestry-security.org.tynamo.security.services.SecurityModule,0,0,0,0,0,0,0,3,3
tynamo_tapestry-security.org.tynamo.security.services.SecurityFilterChainFactory,0,0,0,0,0,0,0,1,1
spotify_futures-extra.com.spotify.futures.CompletableFuturesExtra,1,0,0,1,0,8,0,0,10
spotify_futures-extra.com.spotify.futures.ConcurrencyLimiter,8,0,0,4,0,1,0,0,13
GluuFederation_oxAuth.org.gluu.oxauth.model.jwt.JwtClaims,0,0,0,0,0,0,0,0,0
GluuFederation_oxAuth.org.gluu.oxauth.claims.Audience,0,0,0,0,0,0,0,0,0
GluuFederation_oxAuth.org.gluu.oxauth.model.crypto.binding.TokenBindingMessage,0,0,0,0,0,0,0,0,0
GluuFederation_oxAuth.org.gluu.oxauth.model.uma.JsonLogic,2,0,0,0,0,0,0,0,2
GluuFederation_oxAuth.org.gluu.oxauth.model.uma.JsonLogicNodeParser,1,0,0,1,0,0,0,0,2
GluuFederation_oxAuth.org.gluu.oxauth.model.authorize.CodeVerifier,0,0,0,0,0,0,0,0,0
GluuFederation_oxAuth.org.gluu.oxauth.model.authorize.JwtAuthorizationRequest,0,0,0,0,0,0,0,3,3
GluuFederation_oxAuth.org.gluu.oxauth.model.util.CertUtils,1,0,0,0,0,0,0,0,1
GluuFederation_oxAuth.org.gluu.oxauth.model.util.JwtUtil,7,0,0,4,0,3,0,1,15
GluuFederation_oxAuth.org.gluu.oxauth.model.util.HashUtil,3,0,0,0,0,0,0,0,3
GluuFederation_oxAuth.org.gluu.oxauth.client.RegisterRequest,58,0,0,58,0,2,0,0,118
GluuFederation_oxAuth.org.gluu.oxauth.client.OpenIdConnectDiscoveryRequest,34,0,0,34,0,0,0,0,68
GluuFederation_oxAuth.org.gluu.oxauth.client.OpenIdConnectDiscoveryClient,3,0,0,3,0,0,0,0,6
GluuFederation_oxAuth.org.gluu.oxauth.client.RegisterResponse,28,0,0,28,0,0,0,9,65
GluuFederation_oxAuth.org.gluu.oxauth.model.util.StringUtils,642,0,0,642,0,105,0,1,1390
GluuFederation_oxAuth.org.gluu.oxauth.client.service.ClientFactory,1,0,0,1,0,0,0,0,2
GluuFederation_oxAuth.org.gluu.oxauth.client.BaseRequest,6,0,0,6,0,3,0,0,15
GluuFederation_oxAuth.org.gluu.oxauth.client.AuthorizationRequest,4,0,0,4,0,2,0,0,10
GluuFederation_oxAuth.org.gluu.oxauth.client.RegisterClient,7,0,0,7,0,0,0,0,14
GluuFederation_oxAuth.org.gluu.oxauth.client.model.JwtState,15,0,0,15,0,0,0,0,30
GluuFederation_oxAuth.org.gluu.oxauth.model.util.URLPatternList,1,0,0,0,0,0,0,0,1
GluuFederation_oxAuth.org.gluu.oxauth.client.GluuConfigurationClient,1,0,0,1,0,0,0,0,2
GluuFederation_oxAuth.org.gluu.oxauth.client.model.SoftwareStatement,2,0,0,2,0,0,0,0,4
GluuFederation_oxAuth.org.gluu.oxauth.client.EndSessionClient,2,0,0,2,0,0,0,0,4
GluuFederation_oxAuth.org.gluu.oxauth.client.JwkClient,9,0,0,3,0,6,0,0,18
GluuFederation_oxAuth.org.gluu.oxauth.client.ClientInfoClient,2,0,0,2,0,0,0,0,4
GluuFederation_oxAuth.org.gluu.oxauth.model.crypto.OxAuthCryptoProvider,3,0,0,0,0,3,0,0,6
GluuFederation_oxAuth.org.gluu.oxauth.client.UserInfoClient,2,0,0,2,0,0,0,0,4
GluuFederation_oxAuth.org.gluu.oxauth.client.UserInfoRequest,2,0,0,0,0,2,0,0,4
GluuFederation_oxAuth.org.gluu.oxauth.client.ClientInfoRequest,1,0,0,0,0,1,0,0,2
GluuFederation_oxAuth.org.gluu.oxauth.util.ServerUtil,2,0,0,2,0,2,0,0,6
GluuFederation_oxAuth.org.gluu.oxauth.client.EndSessionRequest,1,0,0,0,0,1,0,0,2
GluuFederation_oxAuth.org.gluu.oxauth.client.TokenRequest,1,0,0,1,0,1,0,0,3
GluuFederation_oxAuth.org.gluu.oxauth.model.util.Base64Util,1,0,0,0,0,1,0,0,2
GluuFederation_oxAuth.org.gluu.oxauth.model.jwt.JwtClaimSet,3,0,0,0,0,3,0,0,6
GluuFederation_oxAuth.org.gluu.oxauth.client.uma.UmaClientFactory,0,0,0,0,0,1,0,0,1
GluuFederation_oxAuth.org.gluu.oxauth.client.uma.UmaMetadataService,0,0,0,0,0,0,0,0,0
GluuFederation_oxAuth.org.gluu.oxauth.model.uma.UmaPermission,1,0,0,1,0,1,0,0,3
GluuFederation_oxAuth.org.gluu.oxauth.client.model.authorize.JwtAuthorizationRequest,0,0,0,0,0,0,0,14,14
GluuFederation_oxAuth.org.gluu.oxauth.model.jwt.JwtHeader,0,0,0,0,0,0,0,27,27
GluuFederation_oxAuth.org.gluu.oxauth.model.json.JsonApplier,0,0,0,0,0,0,0,0,0
GluuFederation_oxAuth.org.oxauth.persistence.model.ClientAttributes,0,0,0,0,0,0,0,0,0
GluuFederation_oxAuth.org.gluu.oxauth.model.error.ErrorMessages,0,0,0,0,0,0,0,0,0
GluuFederation_oxAuth.org.gluu.oxauth.model.jwk.JSONWebKeySet,0,0,0,0,0,1,0,1,2
GluuFederation_oxAuth.org.gluu.oxauth.model.config.BaseDnConfiguration,0,0,0,0,0,0,0,1,1
GluuFederation_oxAuth.org.gluu.oxauth.client.AuthorizationResponse,0,0,0,0,0,0,0,1,1
GluuFederation_oxAuth.org.gluu.oxauth.service.ScopeService,8,0,0,7,0,0,0,0,15
GluuFederation_oxAuth.org.gluu.oxauth.service.fido.u2f.RawRegistrationService,1,0,0,1,0,0,0,0,2
GluuFederation_oxAuth.org.gluu.oxauth.crypto.signature.SignatureVerification,0,0,0,0,0,0,0,0,0
GluuFederation_oxAuth.org.gluu.oxauth.service.fido.u2f.RawAuthenticationService,0,0,0,0,0,0,0,0,0
GluuFederation_oxAuth.org.gluu.oxauth.model.common.CIBAGrant,2,0,0,1,0,0,0,1,4
GluuFederation_oxAuth.org.gluu.oxauth.service.GrantService,0,0,0,0,0,0,0,1,1
GluuFederation_oxAuth.org.gluu.oxauth.service.ClientService,1,0,0,1,0,0,0,0,2
GluuFederation_oxAuth.org.gluu.oxauth.service.CleanerTimer,9,0,0,9,0,3,0,0,21
GluuFederation_oxAuth.org.gluu.oxauth.model.config.ConfigurationFactory,1,0,0,0,0,1,0,0,2
GluuFederation_oxAuth.org.gluu.oxauth.uma.service.UmaResourceService,1,0,0,1,0,0,0,0,2
GluuFederation_oxAuth.org.gluu.oxauth.service.SessionIdService,3,0,0,3,0,0,0,0,6
GluuFederation_oxAuth.org.gluu.oxauth.service.common.EncryptionService,0,0,0,0,0,0,0,1,1
GluuFederation_oxAuth.org.gluu.oxauth.model.crypto.KeyFactory,6,0,0,6,0,0,0,0,12
GluuFederation_oxAuth.org.oxauth.persistence.model.configuration.oxIDPAuthConf,0,0,0,0,0,0,0,1,1
RentTheRunway2_alchemy.io.rtr.alchemy.identities.AttributesMap,4,0,0,3,0,0,0,1,8
RentTheRunway2_alchemy.io.rtr.alchemy.identities.Identity,1,0,0,1,0,0,0,0,2
RentTheRunway2_alchemy.io.rtr.alchemy.identities.IdentityBuilder,1,0,0,1,0,0,0,0,2
RentTheRunway2_alchemy.io.rtr.alchemy.caching.CachingContext,0,0,0,0,0,0,0,5,5
RentTheRunway2_alchemy.io.rtr.alchemy.caching.PeriodicStaleCheckingCacheStrategy,0,0,0,0,0,0,0,3,3
RentTheRunway2_alchemy.io.rtr.alchemy.models.Experiments,5,0,0,5,0,0,0,14,24
RentTheRunway2_alchemy.io.rtr.alchemy.filtering.FilterExpression,1,0,0,0,0,0,0,0,1
RentTheRunway2_alchemy.io.rtr.alchemy.models.Treatment,0,0,0,0,0,0,0,0,0
RentTheRunway2_alchemy.io.rtr.alchemy.models.TreatmentOverride,0,0,0,0,0,0,0,0,0
RentTheRunway2_alchemy.io.rtr.alchemy.models.Allocations,3,0,0,3,0,0,0,0,6
RentTheRunway2_alchemy.io.rtr.alchemy.models.Experiment,15,0,0,15,0,0,0,2,32
RentTheRunway2_alchemy.io.rtr.alchemy.db.Ordering,2,0,0,2,0,0,0,0,4
RentTheRunway2_alchemy.io.rtr.alchemy.dto.requests.UpdateExperimentRequest,1,0,0,1,0,0,0,0,2
RentTheRunway2_alchemy.io.rtr.alchemy.service.resources.BaseResource,0,0,0,0,0,0,0,0,0
RentTheRunway2_alchemy.io.rtr.alchemy.dto.models.TreatmentDto,1,0,0,0,0,0,0,0,1
RentTheRunway2_alchemy.io.rtr.alchemy.dto.requests.UpdateTreatmentRequest,1,0,0,1,0,0,0,0,2
RentTheRunway2_alchemy.io.rtr.alchemy.dto.requests.TreatmentOverrideRequest,1,0,0,1,0,0,0,0,2
RentTheRunway2_alchemy.io.rtr.alchemy.mapping.Mappers,1,0,0,0,0,0,0,0,1
RentTheRunway2_alchemy.io.rtr.alchemy.client.AlchemyClient,16,0,0,14,0,1,0,0,31
RentTheRunway2_alchemy.io.rtr.alchemy.db.mongo.RevisionManager,2,0,0,1,0,0,0,2,5
Accla_d4m_api_java.edu.mit.ll.graphulo_ndsi.NDSIIngester,0,0,0,0,0,0,0,1,1
Accla_d4m_api_java.edu.mit.ll.graphulo_ocean.OceanPipeKmers,0,0,0,0,0,1,0,0,1
Accla_d4m_api_java.edu.mit.ll.graphulo_ocean.GenomicEncoder,4,0,0,3,0,0,0,0,7
Accla_d4m_api_java.edu.mit.ll.graphulo.reducer.EdgeBFSReducer,1,0,0,1,0,0,0,0,2
Accla_d4m_api_java.edu.mit.ll.graphulo.reducer.SingleBFSReducer,1,0,0,1,0,0,0,0,2
Accla_d4m_api_java.edu.mit.ll.graphulo.simplemult.MathTwoScalar,2,0,0,2,0,0,0,0,4
Accla_d4m_api_java.edu.mit.ll.graphulo.util.TripleFileWriter,1,0,0,0,0,0,0,0,1
Accla_d4m_api_java.edu.mit.ll.graphulo.reducer.GatherReducer,1,0,0,1,0,0,0,0,2
Accla_d4m_api_java.edu.mit.ll.graphulo.util.SerializationUtil,1,0,0,0,0,0,0,0,1
Accla_d4m_api_java.edu.mit.ll.graphulo.util.GraphuloUtil,22,0,0,15,0,0,0,0,37
Accla_d4m_api_java.edu.mit.ll.graphulo.DynamicIteratorSetting,5,0,0,5,0,0,0,0,10
Accla_d4m_api_java.edu.mit.ll.graphulo.Graphulo,21,0,0,14,0,0,0,4,39
Accla_d4m_api_java.edu.mit.ll.graphulo.tricount.FixedIntegerLexicoder,0,0,0,0,0,0,0,0,0
Accla_d4m_api_java.edu.mit.ll.graphulo.util.PeekingIterator2,1,1,0,1,0,0,0,0,3
Accla_d4m_api_java.edu.mit.ll.graphulo.util.RangeSet,1,0,0,1,0,0,0,0,2
Accla_d4m_api_java.edu.mit.ll.graphulo.util.DoubletonIterator,1,0,0,1,0,0,0,0,2
Accla_d4m_api_java.edu.mit.ll.graphulo.skvi.TopColPerRowIterator,1,0,0,1,0,0,0,0,2
Accla_d4m_api_java.edu.mit.ll.graphulo.util.IteratorAdapter,2,0,0,2,0,0,0,0,4
Accla_d4m_api_java.edu.mit.ll.graphulo.skvi.D4mRangeFilter,1,0,0,1,0,0,0,0,2
Accla_d4m_api_java.edu.mit.ll.graphulo.skvi.ktruss.SumConditionTimestampIterator,1,0,0,1,0,0,0,0,2
Accla_d4m_api_java.edu.mit.ll.graphulo.skvi.ktruss.KTrussFilterIterator,3,0,0,3,0,0,0,0,6
Accla_d4m_api_java.edu.mit.ll.graphulo.SCCGraphulo,1,0,0,1,0,0,0,0,2
Accla_d4m_api_java.edu.mit.ll.graphulo.skvi.SmallLargeRowFilter,0,0,0,0,0,0,0,0,0
Accla_d4m_api_java.edu.mit.ll.graphulo.util.MemMatrixUtil,2,0,0,2,0,0,0,0,4
Accla_d4m_api_java.edu.mit.ll.d4m.db.cloud.D4mParentQuery,10,0,0,10,0,0,0,5,25
Accla_d4m_api_java.edu.mit.ll.d4m.db.cloud.accumulo.AccumuloTableOperations,0,0,0,0,0,0,0,1,1
Accla_d4m_api_java.edu.mit.ll.d4m.db.cloud.D4mDbTableOperations,0,0,0,0,0,0,0,1,1
Accla_d4m_api_java.edu.mit.ll.d4m.db.cloud.accumulo.AccumuloConnection,1,0,0,1,0,0,0,0,2
Accla_d4m_api_java.edu.mit.ll.cloud.connection.ConnectionProperties,2,0,0,2,0,0,0,1,5
Accla_d4m_api_java.edu.mit.ll.d4m.db.cloud.accumulo.D4mDbQueryAccumulo,0,0,0,0,0,0,0,2,2
Accla_d4m_api_java.edu.mit.ll.d4m.db.cloud.D4mDbInsert,1,0,0,1,0,0,0,0,2
Accla_d4m_api_java.edu.mit.ll.graphulo.simplemult.ConstantTwoScalar,0,0,0,0,0,0,0,1,1
esigate_esigate.org.esigate.util.Parameter,0,0,0,0,0,0,0,0,0
esigate_esigate.org.esigate.test.PropertiesBuilder,0,0,0,0,0,0,0,0,0
esigate_esigate.org.esigate.vars.VariablesResolver,1,0,0,1,0,0,0,0,2
esigate_esigate.org.esigate.DriverFactory,1,0,0,1,0,0,0,0,2
esigate_esigate.org.esigate.parser.future.FutureAppendableAdapter,0,0,0,0,0,0,0,0,0
esigate_esigate.org.esigate.test.conn.SequenceResponse,1,0,0,1,0,0,0,0,2
esigate_esigate.org.esigate.test.conn.UriResponse,1,0,0,1,0,0,0,0,2
esigate_esigate.org.esigate.extension.surrogate.http.SurrogateCapabilitiesHeader,1,0,0,1,0,0,0,0,2
codelibs_elasticsearch-taste.org.codelibs.elasticsearch.taste.model.ElasticsearchDataModel,0,0,0,0,0,0,0,1,1
la-team_light-admin.org.lightadmin.core.config.LightAdminWebApplicationInitializer,0,0,0,0,0,0,0,1,1
la-team_light-admin.org.lightadmin.core.config.domain.unit.ConfigurationUnitsConverter,0,0,0,0,0,0,0,0,0
la-team_light-admin.org.lightadmin.api.config.management.rmi.GlobalConfigurationManagementService,1,0,0,1,0,0,0,0,2
la-team_light-admin.org.lightadmin.core.config.management.jmx.LightAdminConfigurationMonitoringServiceMBean,0,0,0,0,0,0,0,0,0
la-team_light-admin.org.lightadmin.core.config.domain.context.DefaultScreenContextConfigurationUnitBuilder,1,0,0,1,0,0,0,0,2
la-team_light-admin.org.lightadmin.core.config.domain.unit.ConfigurationUnitBuilder,1,0,0,1,0,0,0,1,3
la-team_light-admin.org.lightadmin.core.config.domain.filter.DefaultFiltersConfigurationUnitBuilder,1,0,0,1,0,0,0,2,4
la-team_light-admin.org.lightadmin.core.config.domain.configuration.DefaultEntityMetadataConfigurationUnitBuilder,3,0,0,3,0,0,0,0,6
la-team_light-admin.org.lightadmin.core.config.domain.configuration.support.EntityNameExtractorFactory,0,0,0,0,0,0,0,0,0
la-team_light-admin.org.lightadmin.core.config.domain.unit.ConfigurationUnits,0,0,0,0,0,0,0,0,0
la-team_light-admin.org.lightadmin.core.config.bootstrap.scanning.TypeFilterClassScanner,1,0,0,0,0,0,0,0,1
la-team_light-admin.org.lightadmin.core.config.bootstrap.parsing.validation.CustomFieldMetadataValidator,0,0,0,0,0,0,0,0,0
la-team_light-admin.org.lightadmin.core.config.LightAdminConfiguration,5,0,0,5,0,0,0,0,10
apache_struts-examples.org.apache.examples.struts.actions.data.OrderController,3,0,0,2,0,0,0,0,5
apache_struts-examples.org.apache.examples.struts.actions.IndexController,1,0,0,0,0,0,0,0,1
buschmais_extended-objects.com.buschmais.xo.api.bootstrap.XO,3,0,0,3,0,0,0,1,7
buschmais_extended-objects.com.buschmais.xo.api.XOManagerFactory,4,0,0,2,0,0,0,1,7
buschmais_extended-objects.com.buschmais.xo.api.XOTransaction,83,0,0,74,0,3,0,0,160
buschmais_extended-objects.com.buschmais.xo.api.metadata.reflection.SetPropertyMethod,3,0,0,0,0,2,0,0,5
buschmais_extended-objects.com.buschmais.xo.impl.transaction.TransactionalResultIterator,1,0,0,1,0,0,0,2,4
buschmais_extended-objects.com.buschmais.xo.impl.XOTransactionImpl,2,0,0,2,0,0,0,0,4
kontalk_tigase-server.tigase.disteventbus.impl.EventsNameMap,1,0,0,1,0,0,0,0,2
kontalk_tigase-server.tigase.disteventbus.impl.LocalEventBus,1,0,0,1,0,1,0,0,3
kontalk_tigase-server.tigase.disteventbus.component.NodeNameUtil,2,0,0,0,0,0,0,0,2
kontalk_tigase-server.tigase.server.Packet,19,0,0,17,0,0,0,0,36
kontalk_tigase-server.tigase.server.websocket.WebSocketHixie76,0,0,0,0,0,0,0,0,0
kontalk_tigase-server.tigase.server.websocket.WebSocketHybi,2,0,0,0,0,0,0,0,2
kontalk_tigase-server.tigase.server.xmppserver.proc.Dialback,4,0,0,4,0,0,0,0,8
kontalk_tigase-server.tigase.db.comp.ConfigRepository,0,0,0,0,0,0,0,0,0
kontalk_tigase-server.tigase.vhosts.filter.CustomDomainFilter,1,0,0,1,0,0,0,0,2
kontalk_tigase-server.tigase.cluster.ClusterConnectionSelector,2,0,0,2,0,0,0,0,4
kontalk_tigase-server.tigase.cluster.api.ClusterElement,1,0,0,0,0,0,0,0,1
kontalk_tigase-server.tigase.monitor.tasks.ConnectionsTask,1,0,0,0,0,0,0,0,1
kontalk_tigase-server.tigase.kernel.core.RegistrarKernel,1,0,0,1,0,0,0,0,2
kontalk_tigase-server.tigase.kernel.core.Kernel,4,0,0,4,0,2,0,0,10
kontalk_tigase-server.tigase.kernel.core.BeanConfigBuilder,2,0,0,2,0,0,0,0,4
kontalk_tigase-server.tigase.auth.mechanisms.AbstractSaslSCRAM,9,0,0,2,0,12,0,1,24
kontalk_tigase-server.tigase.auth.mechanisms.SaslANONYMOUS,1,0,0,1,0,1,0,0,3
kontalk_tigase-server.tigase.auth.mechanisms.SaslPLAIN,13,0,0,13,0,13,0,0,39
kontalk_tigase-server.tigase.util.DataTypes,1,0,0,0,0,0,0,0,1
kontalk_tigase-server.tigase.stats.MaxDailyCounterQueue,2,0,0,0,0,0,0,0,2
kontalk_tigase-server.tigase.stats.StatisticsList,1,0,0,1,0,0,0,0,2
kontalk_tigase-server.tigase.xmpp.impl.VCardXMPPProcessorAbstract,2,0,0,0,0,0,0,0,2
kontalk_tigase-server.tigase.xmpp.impl.MessageCarbons,2,0,0,2,0,0,0,0,4
kontalk_tigase-server.tigase.xmpp.impl.JabberIqPrivacy,4,0,0,4,0,0,0,0,8
kontalk_tigase-server.tigase.xmpp.impl.roster.RosterFactory,1,0,0,1,0,0,0,0,2
kontalk_tigase-server.tigase.xmpp.impl.JabberIqRegister,0,0,0,0,0,0,0,0,0
kontalk_tigase-server.tigase.xmpp.impl.BindResource,1,0,0,1,0,0,0,0,2
kontalk_tigase-server.tigase.xmpp.impl.C2SDeliveryErrorProcessor,2,0,0,2,0,0,0,0,4
kontalk_tigase-server.tigase.xmpp.impl.MobileV3,3,0,0,3,0,0,0,0,6
kontalk_tigase-server.tigase.xmpp.impl.MessageAmp,3,0,0,3,0,0,0,0,6
kontalk_tigase-server.tigase.xmpp.impl.OfflineMessages,5,0,0,5,0,0,0,0,10
kontalk_tigase-server.tigase.xmpp.impl.Message,4,0,0,4,0,0,0,0,8
kontalk_tigase-server.tigase.xmpp.impl.DomainFilter,1,0,0,1,0,0,0,0,2
kontalk_tigase-server.tigase.xmpp.XMPPResourceConnection,1,0,0,0,0,0,0,0,1
kontalk_tigase-server.tigase.xmpp.impl.annotation.AnnotatedXMPPProcessor,1,0,0,1,0,0,0,0,2
kontalk_tigase-server.tigase.xmpp.ProcessorFactory,1,0,0,1,0,0,0,0,2
kontalk_tigase-server.tigase.xmpp.impl.roster.RosterElement,1,0,0,1,0,0,0,0,2
kontalk_tigase-server.tigase.db.UserRepository,1,0,0,1,0,0,0,0,2
cternes_openkeepass.de.slackspace.openkeepass.crypto.Decrypter,0,0,0,0,0,0,0,0,0
cternes_openkeepass.de.slackspace.openkeepass.crypto.Sha256,0,0,0,0,0,0,0,0,0
cternes_openkeepass.de.slackspace.openkeepass.util.ByteUtils,0,0,0,0,0,0,0,0,0
cternes_openkeepass.de.slackspace.openkeepass.crypto.Aes,0,0,0,0,0,0,0,0,0
cternes_openkeepass.de.slackspace.openkeepass.crypto.Salsa20,1,0,0,1,0,0,0,0,2
cternes_openkeepass.de.slackspace.openkeepass.crypto.RandomGenerator,2,0,0,0,0,0,0,0,2
cternes_openkeepass.de.slackspace.openkeepass.domain.Meta,2,0,0,2,0,0,0,0,4
cternes_openkeepass.de.slackspace.openkeepass.domain.KeePassFile,7,0,0,7,0,0,0,0,14
cternes_openkeepass.de.slackspace.openkeepass.parser.KeePassDatabaseXmlParser,0,0,0,0,0,0,0,0,0
cternes_openkeepass.de.slackspace.openkeepass.parser.KeyFileXmlParser,0,0,0,0,0,0,0,0,0
cternes_openkeepass.de.slackspace.openkeepass.parser.TagParser,0,0,0,0,0,0,0,0,0
cternes_openkeepass.de.slackspace.openkeepass.util.StringUtils,0,0,0,0,0,0,0,0,0
cternes_openkeepass.de.slackspace.openkeepass.util.StreamUtils,2,0,0,2,0,0,0,0,4
cternes_openkeepass.de.slackspace.openkeepass.parser.SimpleXmlParser,0,0,0,0,0,0,0,0,0
cternes_openkeepass.de.slackspace.openkeepass.domain.Attachment,1,0,0,1,0,0,0,0,2
cternes_openkeepass.de.slackspace.openkeepass.domain.CustomIconBuilder,3,0,0,3,0,0,0,0,6
cternes_openkeepass.de.slackspace.openkeepass.domain.CustomIcons,1,0,0,1,0,0,0,0,2
cternes_openkeepass.de.slackspace.openkeepass.domain.Key,0,0,0,0,0,0,0,0,0
cternes_openkeepass.de.slackspace.openkeepass.domain.KeyFile,0,0,0,0,0,0,0,0,0
cternes_openkeepass.de.slackspace.openkeepass.domain.AttachmentValue,0,0,0,0,0,0,0,0,0
cternes_openkeepass.de.slackspace.openkeepass.domain.EntryBuilder,10,0,0,10,0,0,0,3,23
cternes_openkeepass.de.slackspace.openkeepass.domain.TimesBuilder,4,0,0,4,0,0,0,0,8
cternes_openkeepass.de.slackspace.openkeepass.domain.Entry,2,0,0,1,0,0,0,0,3
cternes_openkeepass.de.slackspace.openkeepass.domain.CustomIcon,1,0,0,1,0,0,0,0,2
cternes_openkeepass.de.slackspace.openkeepass.domain.PropertyValue,0,0,0,0,0,0,0,0,0
cternes_openkeepass.de.slackspace.openkeepass.domain.Property,1,0,0,1,0,0,0,0,2
cternes_openkeepass.de.slackspace.openkeepass.domain.Times,0,0,0,0,0,0,0,0,0
cternes_openkeepass.de.slackspace.openkeepass.domain.BinaryBuilder,2,0,0,2,0,0,0,0,4
cternes_openkeepass.de.slackspace.openkeepass.domain.Binaries,1,0,0,1,0,0,0,0,2
cternes_openkeepass.de.slackspace.openkeepass.domain.MetaBuilder,8,0,0,8,0,0,0,0,16
cternes_openkeepass.de.slackspace.openkeepass.domain.Binary,1,0,0,1,0,0,0,0,2
cternes_openkeepass.de.slackspace.openkeepass.domain.Group,1,0,0,1,0,0,0,0,2
cternes_openkeepass.de.slackspace.openkeepass.domain.KeePassHeader,3,0,0,3,0,0,0,0,6
cternes_openkeepass.de.slackspace.openkeepass.domain.zipper.GroupZipper,2,0,0,2,0,0,0,6,10
cternes_openkeepass.de.slackspace.openkeepass.domain.GroupBuilder,1,0,0,1,0,0,0,0,2
cternes_openkeepass.de.slackspace.openkeepass.KeePassDatabase,14,0,0,14,0,0,0,0,28
cternes_openkeepass.de.slackspace.openkeepass.domain.KeePassFileBuilder,2,0,0,2,0,0,0,0,4
cternes_openkeepass.de.slackspace.openkeepass.domain.CustomIconsBuilder,2,0,0,2,0,0,0,0,4
cternes_openkeepass.de.slackspace.openkeepass.domain.BinariesBuilder,2,0,0,2,0,0,0,0,4
cternes_openkeepass.de.slackspace.openkeepass.processor.IconEnricher,1,0,0,1,0,0,0,0,2
cternes_openkeepass.de.slackspace.openkeepass.processor.BinaryEnricher,1,0,0,1,0,0,0,0,2
castlabs_dashencrypt.com.castlabs.dash.helpers.ManifestHelper,1,0,0,0,0,0,0,0,1
castlabs_dashencrypt.com.castlabs.dash.helpers.LanguageHelper,1,0,0,0,0,0,0,0,1
castlabs_dashencrypt.com.castlabs.dash.dashfragmenter.cmdlines.trackoptions.InputOutputSelector,1,0,0,0,0,0,0,0,1
castlabs_dashencrypt.com.castlabs.dash.dashfragmenter.representation.ManifestOptimizer,2,0,0,2,0,0,0,0,4
castlabs_dashencrypt.com.castlabs.dash.dashfragmenter.Main,0,0,0,0,0,0,0,0,0
ewolff_user-registration.com.ewolff.user_registration.service.RegistrationService,2,0,0,1,0,0,0,0,3
ewolff_user-registration.com.ewolff.user_registration.domain.User,0,0,0,0,0,0,0,0,0
esig_dss.eu.europa.esig.xades.XAdESUtils,2,0,0,1,0,0,0,0,3
esig_dss.eu.europa.esig.xades.XAdES319132Utils,1,0,0,0,0,0,0,0,1
esig_dss.eu.europa.esig.xades.XAdES111Utils,1,0,0,0,0,0,0,0,1
esig_dss.eu.europa.esig.xades.XAdES122Utils,1,0,0,0,0,0,0,0,1
esig_dss.eu.europa.esig.xmldsig.XSDAbstractUtils,10,0,0,2,0,1,0,0,13
esig_dss.eu.europa.esig.dss.utils.Utils,151,3,0,56,0,4,0,2,216
esig_dss.eu.europa.esig.dss.model.TimestampBinary,6,1,0,2,0,0,0,0,9
esig_dss.eu.europa.esig.dss.alert.status.MessageStatus,2,0,0,1,0,0,0,0,3
esig_dss.eu.europa.esig.dss.model.x509.Token,12,1,0,4,0,0,0,0,17
esig_dss.eu.europa.esig.dss.diagnostic.DiagnosticData,88,21,0,88,0,8,0,0,205
esig_dss.eu.europa.esig.dss.simplereport.SimpleReport,13,1,0,13,0,0,0,0,27
esig_dss.eu.europa.esig.dss.diagnostic.FoundRevocationsProxy,2,1,0,2,0,0,0,0,5
esig_dss.eu.europa.esig.dss.model.Policy,0,0,0,0,0,0,0,8,8
esig_dss.eu.europa.esig.dss.model.SignaturePolicyStore,5,0,0,5,0,0,0,0,10
esig_dss.eu.europa.esig.dss.policy.ValidationPolicyXmlDefiner,2,0,0,0,0,0,0,0,2
esig_dss.eu.europa.esig.dss.policy.DateUtils,0,0,0,0,0,0,0,0,0
esig_dss.eu.europa.esig.dss.policy.ValidationPolicyFacade,4,0,0,4,0,0,0,0,8
esig_dss.eu.europa.esig.dss.model.SignatureValue,7,0,0,6,0,2,0,0,15
esig_dss.eu.europa.esig.dss.model.DigestDocument,1,0,0,1,0,0,0,0,2
esig_dss.eu.europa.esig.dss.model.ToBeSigned,4,0,0,3,0,0,0,1,8
esig_dss.eu.europa.esig.dss.model.BLevelParameters,0,0,0,0,0,0,0,3,3
esig_dss.eu.europa.esig.dss.model.SignerLocation,0,0,0,0,0,0,0,0,0
esig_dss.eu.europa.esig.dss.model.Digest,3,0,0,2,0,0,0,0,5
esig_dss.eu.europa.esig.dss.model.MimeType,7,0,0,1,0,0,0,0,8
esig_dss.eu.europa.esig.dss.model.FileDocument,4,0,0,1,0,0,0,0,5
esig_dss.eu.europa.esig.dss.model.InMemoryDocument,4,0,0,4,0,0,0,0,8
esig_dss.eu.europa.esig.dss.model.x509.CertificateToken,21,0,0,12,0,0,0,0,33
esig_dss.eu.europa.esig.dss.model.identifier.Identifier,2,0,0,0,0,0,0,0,2
esig_dss.eu.europa.esig.dss.model.identifier.MultipleDigestIdentifier,1,0,0,1,0,0,0,0,2
esig_dss.eu.europa.esig.dss.model.x509.QcStatements,6,0,0,4,0,0,0,0,10
esig_dss.eu.europa.esig.dss.model.x509.X500PrincipalHelper,4,0,0,4,0,0,0,0,8
esig_dss.eu.europa.esig.trustedlist.jaxb.tsl.NonEmptyMultiLangURIListType,3,0,0,0,0,0,0,0,3
esig_dss.eu.europa.esig.dss.jaxb.common.AbstractJaxbFacade,1,0,0,1,0,0,0,0,2
esig_dss.eu.europa.esig.trustedlist.jaxb.tsl.TSPServiceType,1,0,0,1,0,0,0,0,2
esig_dss.eu.europa.esig.trustedlist.TrustedListFacade,2,0,0,2,0,0,0,0,4
esig_dss.eu.europa.esig.dss.diagnostic.jaxb.XmlDiagnosticData,4,0,0,2,0,0,0,0,6
esig_dss.eu.europa.esig.dss.model.CommonDocument,8,0,0,7,0,0,0,1,16
esig_dss.eu.europa.esig.dss.jaxb.common.XmlDefinerUtils,3,0,0,3,0,0,0,1,7
esig_dss.eu.europa.esig.dss.model.DSSDocument,24,0,0,14,0,5,0,2,45
esig_dss.eu.europa.esig.validationreport.ValidationReportUtils,1,0,0,0,0,0,0,0,1
esig_dss.eu.europa.esig.validationreport.ValidationReportFacade,1,0,0,1,0,0,0,0,2
esig_dss.eu.europa.esig.validationreport.parsers.UriBasedEnumParser,8,0,0,8,0,0,0,0,16
esig_dss.eu.europa.esig.dss.jaxb.common.SchemaFactoryBuilder,1,0,0,1,0,0,0,0,2
esig_dss.eu.europa.esig.dss.jaxb.common.TransformerFactoryBuilder,0,0,0,0,0,0,0,0,0
esig_dss.eu.europa.esig.dss.jaxb.parsers.SignatureFormatParser,1,0,0,1,0,0,0,0,2
esig_dss.eu.europa.esig.dss.jaxb.parsers.CertificateStatusParser,0,0,0,0,0,0,0,0,0
esig_dss.eu.europa.esig.dss.jaxb.parsers.SignatureQualificationParser,1,0,0,1,0,0,0,0,2
esig_dss.eu.europa.esig.dss.jaxb.parsers.TimestampQualificationParser,1,0,0,1,0,0,0,0,2
esig_dss.eu.europa.esig.dss.jaxb.parsers.KeyUsageBitParser,1,0,0,1,0,0,0,0,2
esig_dss.eu.europa.esig.dss.jaxb.parsers.DateParser,2,0,0,2,0,0,0,0,4
esig_dss.eu.europa.esig.dss.jaxb.parsers.EncryptionAlgorithmParser,2,0,0,1,0,0,0,0,3
esig_dss.eu.europa.esig.dss.jaxb.parsers.EndorsementTypeParser,1,0,0,1,0,0,0,0,2
esig_dss.eu.europa.esig.dss.jaxb.parsers.ObjectIdentifierQualifierParser,2,0,0,1,0,0,0,0,3
esig_dss.eu.europa.esig.dss.diagnostic.DiagnosticDataXmlDefiner,3,0,0,0,0,0,0,0,3
esig_dss.eu.europa.esig.dss.diagnostic.DiagnosticDataFacade,260,55,0,257,0,0,0,0,572
esig_dss.eu.europa.esig.dss.diagnostic.jaxb.XmlRelatedRevocation,1,0,0,1,0,0,0,0,2
esig_dss.eu.europa.esig.dss.diagnostic.jaxb.XmlOrphanRevocation,1,0,0,1,0,0,0,0,2
esig_dss.eu.europa.esig.dss.diagnostic.jaxb.XmlRelatedCertificate,1,0,0,1,0,0,0,0,2
esig_dss.eu.europa.esig.dss.diagnostic.jaxb.XmlOrphanCertificate,1,0,0,1,0,0,0,0,2
esig_dss.eu.europa.esig.dss.simplecertificatereport.SimpleCertificateReportXmlDefiner,3,0,0,0,0,0,0,0,3
esig_dss.eu.europa.esig.dss.detailedreport.DetailedReportXmlDefiner,4,0,0,0,0,0,0,0,4
esig_dss.eu.europa.esig.dss.simplereport.SimpleReportXmlDefiner,4,0,0,0,0,0,0,0,4
esig_dss.eu.europa.esig.jws.AbstractJWSUtils,4,0,0,2,0,0,0,0,6
esig_dss.eu.europa.esig.dss.detailedreport.DetailedReport,4,1,0,4,0,0,0,0,9
esig_dss.eu.europa.esig.trustedlist.TrustedListUtils,1,0,0,0,0,0,0,0,1
esig_dss.eu.europa.esig.trustedlist.parsers.AssertParser,2,0,0,2,0,0,0,0,4
esig_dss.eu.europa.esig.dss.simplecertificatereport.SimpleCertificateReportFacade,1,0,0,1,0,0,0,0,2
esig_dss.eu.europa.esig.xmldsig.XmlDSigUtils,2,0,0,1,0,0,0,0,3
esig_dss.eu.europa.esig.dss.simplereport.SimpleReportFacade,0,0,0,0,0,0,0,0,0
esig_dss.eu.europa.esig.dss.detailedreport.DetailedReportFacade,1,0,0,1,0,0,0,0,2
esig_dss.eu.europa.esig.trustedlist.jaxb.tsl.ObjectFactory,0,0,0,0,0,0,0,0,0
esig_dss.eu.europa.esig.dss.simplecertificatereport.SimpleCertificateReport,1,0,0,1,0,0,0,0,2
esig_dss.eu.europa.esig.dss.utils.apache.impl.ApacheCommonsUtils,1,0,0,1,0,0,0,0,2
esig_dss.eu.europa.esig.asic.manifest.ASiCManifestUtils,2,0,0,2,0,0,0,0,4
esig_dss.eu.europa.esig.dss.policy.jaxb.ConstraintsParameters,1,0,0,1,0,0,0,0,2
esig_dss.eu.europa.esig.dss.diagnostic.jaxb.XmlCertificateRevocation,7,0,0,7,0,0,0,0,14
esig_dss.eu.europa.esig.dss.diagnostic.jaxb.XmlCertificate,5,0,0,5,0,0,0,0,10
esig_dss.eu.europa.esig.dss.diagnostic.TrustedServiceWrapper,0,0,0,0,0,0,0,4,4
esig_dss.eu.europa.esig.dss.policy.jaxb.LevelConstraint,117,0,0,117,0,0,0,0,234
esig_dss.eu.europa.esig.dss.diagnostic.jaxb.XmlDigestMatcher,8,0,0,8,0,0,0,0,16
esig_dss.eu.europa.esig.dss.diagnostic.jaxb.XmlBasicSignature,2,0,0,2,0,0,0,0,4
esig_dss.eu.europa.esig.dss.diagnostic.jaxb.XmlCertificateRef,16,0,0,16,0,0,0,0,32
esig_dss.eu.europa.esig.dss.diagnostic.jaxb.XmlAbstractToken,1,0,0,1,0,0,0,0,2
esig_dss.eu.europa.esig.dss.diagnostic.jaxb.XmlSigningCertificate,1,0,0,1,0,0,0,0,2
esig_dss.eu.europa.esig.dss.diagnostic.jaxb.XmlSignature,65,0,0,65,0,0,0,0,130
esig_dss.eu.europa.esig.dss.diagnostic.jaxb.XmlModificationDetection,9,0,0,9,0,0,0,0,18
esig_dss.eu.europa.esig.dss.diagnostic.jaxb.XmlContainerInfo,8,0,0,8,0,0,0,0,16
esig_dss.eu.europa.esig.dss.diagnostic.jaxb.XmlTimestamp,9,0,0,9,0,0,0,0,18
esig_dss.eu.europa.esig.dss.diagnostic.jaxb.XmlSignerRole,4,0,0,4,0,0,0,0,8
esig_dss.eu.europa.esig.dss.diagnostic.jaxb.XmlTSAGeneralName,7,0,0,7,0,0,0,0,14
esig_dss.eu.europa.esig.dss.diagnostic.jaxb.XmlStructuralValidation,2,0,0,2,0,0,0,0,4
esig_dss.eu.europa.esig.dss.diagnostic.jaxb.XmlCommitmentTypeIndication,2,0,0,2,0,0,0,0,4
esig_dss.eu.europa.esig.dss.diagnostic.jaxb.XmlPSD2QcInfo,6,0,0,6,0,0,0,0,12
esig_dss.eu.europa.esig.dss.diagnostic.jaxb.XmlQcSSCD,2,0,0,2,0,0,0,0,4
esig_dss.eu.europa.esig.dss.diagnostic.jaxb.XmlOID,10,0,0,10,0,0,0,0,20
esig_dss.eu.europa.esig.dss.diagnostic.jaxb.XmlQcCompliance,2,0,0,2,0,0,0,0,4
esig_dss.eu.europa.esig.dss.policy.jaxb.MultiValuesConstraint,6,0,0,6,0,0,0,0,12
esig_dss.eu.europa.esig.dss.diagnostic.jaxb.XmlQcEuLimitValue,5,0,0,5,0,0,0,0,10
esig_dss.eu.europa.esig.dss.diagnostic.jaxb.XmlQcStatements,3,0,0,3,0,0,0,0,6
esig_dss.eu.europa.esig.dss.diagnostic.jaxb.XmlLangAndValue,2,0,0,2,0,0,0,0,4
esig_dss.eu.europa.esig.dss.diagnostic.jaxb.XmlRoleOfPSP,4,0,0,4,0,0,0,0,8
esig_dss.eu.europa.esig.dss.policy.jaxb.TimeConstraint,3,0,0,3,0,0,0,0,6
esig_dss.eu.europa.esig.dss.diagnostic.jaxb.XmlPolicy,4,0,0,4,0,0,0,0,8
esig_dss.eu.europa.esig.dss.diagnostic.jaxb.XmlPolicyDigestAlgoAndValue,2,0,0,2,0,0,0,0,4
esig_dss.eu.europa.esig.dss.diagnostic.jaxb.XmlDigestAlgoAndValue,2,0,0,2,0,0,0,0,4
esig_dss.eu.europa.esig.dss.detailedreport.jaxb.XmlConclusion,23,0,0,23,0,0,0,0,46
esig_dss.eu.europa.esig.saml.SoapEnvelopeUtils,1,0,0,1,0,0,0,0,2
esig_dss.eu.europa.esig.saml.XMLEncUtils,1,0,0,1,0,0,0,0,2
esig_dss.eu.europa.esig.saml.SAMLAssertionUtils,1,0,0,1,0,0,0,0,2
CorfuDB_CorfuDB.org.corfudb.common.util.CompatibilityVectorUtils,1,0,0,0,0,0,0,1,2
CorfuDB_CorfuDB.org.corfudb.common.metrics.micrometer.registries.LoggingMeterRegistryWithHistogramSupport,0,0,0,0,0,0,0,0,0
CorfuDB_CorfuDB.org.corfudb.common.util.ObservableValue,2,0,0,0,0,2,0,0,4
druid-io_druid.org.apache.druid.rpc.DiscoveryServiceLocator,3,0,0,3,0,0,0,0,6
druid-io_druid.org.apache.druid.rpc.ServiceLocations,4,0,0,4,0,0,0,0,8
druid-io_druid.org.apache.druid.rpc.StandardRetryPolicy,9,0,0,1,0,0,0,0,10
druid-io_druid.org.apache.druid.java.util.http.client.Request,4,0,0,4,0,1,0,0,9
druid-io_druid.org.apache.druid.rpc.ServiceLocator,0,0,0,0,0,0,0,0,0
druid-io_druid.org.apache.druid.rpc.ServiceClientImpl,3,0,0,1,0,0,0,0,4
druid-io_druid.org.apache.druid.rpc.RequestBuilder,7,0,0,7,0,0,0,0,14
druid-io_druid.org.apache.druid.rpc.indexing.SpecificTaskServiceLocator,2,0,0,2,0,0,0,0,4
druid-io_druid.org.apache.druid.server.SegmentManager,3,0,0,1,0,0,0,2,6
druid-io_druid.org.apache.druid.server.RequestLogLine,1,0,0,1,0,0,0,0,2
druid-io_druid.org.apache.druid.server.JettyUtils,0,0,0,0,0,0,0,0,0
druid-io_druid.org.apache.druid.query.Druids,53,4,0,48,0,9,0,304,418
druid-io_druid.org.apache.druid.query.groupby.GroupByQuery,23,0,0,21,0,1,4,290,339
druid-io_druid.org.apache.druid.query.topn.TopNQueryBuilder,15,0,0,10,0,1,0,120,146
druid-io_druid.org.apache.druid.server.QueryResource,14,0,0,9,0,1,0,0,24
druid-io_druid.org.apache.druid.server.router.ConsistentHasher,0,0,0,0,0,0,0,0,0
druid-io_druid.org.apache.druid.query.DefaultQueryConfig,2,0,0,2,0,0,0,2,6
druid-io_druid.org.apache.druid.server.QueryLifecycle,2,0,0,2,0,0,0,0,4
druid-io_druid.org.apache.druid.server.DruidNode,9,0,0,8,0,0,0,0,17
druid-io_druid.org.apache.druid.segment.join.BroadcastTableJoinableFactory,3,0,0,3,0,0,0,0,6
druid-io_druid.org.apache.druid.segment.join.JoinConditionAnalysis,11,0,0,11,0,0,0,1,23
druid-io_druid.org.apache.druid.query.context.ResponseContext,14,0,0,14,0,0,0,0,28
druid-io_druid.org.apache.druid.server.ClientInfoResource,0,0,0,0,0,0,0,0,0
druid-io_druid.org.apache.druid.query.Query,1,0,0,1,0,1,0,0,3
druid-io_druid.org.apache.druid.query.QueryCapacityExceededException,2,0,0,2,0,0,0,0,4
druid-io_druid.org.apache.druid.server.QueryScheduler,7,0,0,7,0,0,0,0,14
druid-io_druid.org.apache.druid.server.router.RendezvousHasher,0,0,0,0,0,0,0,0,0
druid-io_druid.org.apache.druid.server.router.QueryHostFinder,0,0,0,0,0,0,0,1,1
druid-io_druid.org.apache.druid.server.AsyncQueryForwardingServlet,7,0,0,6,0,0,0,0,13
druid-io_druid.org.apache.druid.java.util.common.Intervals,131,15,0,107,0,10,1,26,290
druid-io_druid.org.apache.druid.server.router.ManualTieredBrokerSelectorStrategy,5,0,0,0,0,0,0,0,5
druid-io_druid.org.apache.druid.server.router.TieredBrokerHostSelector,2,0,0,2,0,0,0,0,4
druid-io_druid.org.apache.druid.js.JavaScriptConfig,10,5,0,5,0,1,0,9,30
druid-io_druid.org.apache.druid.server.router.CoordinatorRuleManager,0,0,0,0,0,0,0,2,2
druid-io_druid.org.apache.druid.server.http.DataSourcesResource,30,0,0,27,0,0,0,0,57
druid-io_druid.org.apache.druid.server.coordinator.CoordinatorDynamicConfig,4,0,0,4,0,0,0,4,12
druid-io_druid.org.apache.druid.server.http.IntervalsResource,4,0,0,4,0,0,0,0,8
druid-io_druid.org.apache.druid.server.http.CoordinatorRedirectInfo,2,0,0,2,0,0,0,0,4
druid-io_druid.org.apache.druid.server.http.ServersResource,0,0,0,0,0,0,0,0,0
druid-io_druid.org.apache.druid.server.http.CompactionResource,3,0,0,3,0,0,0,0,6
druid-io_druid.org.apache.druid.server.http.RulesResource,6,0,0,6,0,0,0,0,12
druid-io_druid.org.apache.druid.server.http.OverlordProxyServlet,0,0,0,0,0,0,0,0,0
druid-io_druid.org.apache.druid.server.http.LookupCoordinatorResource,32,0,0,28,0,0,0,0,60
druid-io_druid.org.apache.druid.server.http.CoordinatorCompactionConfigsResource,5,0,0,3,0,0,0,0,8
druid-io_druid.org.apache.druid.server.http.CoordinatorResource,2,0,0,2,0,0,0,0,4
druid-io_druid.org.apache.druid.server.security.PreResponseAuthorizationCheckFilter,0,0,0,0,0,0,0,4,4
druid-io_druid.org.apache.druid.server.security.SecuritySanityCheckFilter,0,0,0,0,0,0,0,2,2
druid-io_druid.org.apache.druid.server.metrics.SegmentRowCountDistribution,0,0,0,0,0,0,0,0,0
druid-io_druid.org.apache.druid.server.metrics.TaskCountStatsMonitor,1,0,0,0,0,0,0,0,1
druid-io_druid.org.apache.druid.server.metrics.SegmentStatsMonitor,0,0,0,0,0,0,0,0,0
druid-io_druid.org.apache.druid.server.metrics.WorkerTaskCountStatsMonitor,1,0,0,0,0,0,0,0,1
druid-io_druid.org.apache.druid.initialization.Initialization,12,0,0,12,0,0,0,0,24
druid-io_druid.org.apache.druid.server.metrics.MetricsModule,0,0,0,0,0,0,0,0,0
druid-io_druid.org.apache.druid.server.metrics.HistoricalMetricsMonitor,1,0,0,1,0,0,0,0,2
druid-io_druid.org.apache.druid.server.metrics.TaskSlotCountStatsMonitor,1,0,0,0,0,0,0,0,1
druid-io_druid.org.apache.druid.server.metrics.QueryCountStatsMonitor,1,0,0,0,0,0,0,0,1
druid-io_druid.org.apache.druid.java.util.common.DateTimes,45,0,0,35,0,0,0,59,139
druid-io_druid.org.apache.druid.server.QueryLaningStrategy,4,0,0,0,0,0,0,0,4
druid-io_druid.org.apache.druid.server.scheduling.HiLoQueryLaningStrategy,1,0,0,0,0,0,0,0,1
druid-io_druid.org.apache.druid.server.coordination.SegmentLoadDropHandler,4,0,0,4,0,0,0,0,8
druid-io_druid.org.apache.druid.server.coordination.ChangeRequestHistory,5,0,0,4,0,0,0,0,9
druid-io_druid.org.apache.druid.segment.loading.DataSegmentPusher,0,0,0,0,0,0,0,0,0
druid-io_druid.org.apache.druid.server.security.AllowHttpMethodsResourceFilter,0,0,0,0,0,0,0,3,3
druid-io_druid.org.apache.druid.server.security.Authenticator,0,0,0,0,0,0,0,4,4
druid-io_druid.org.apache.druid.server.security.AuthValidator,0,0,0,0,0,0,0,8,8
druid-io_druid.org.apache.druid.server.security.NoopEscalator,0,0,0,0,0,0,0,0,0
druid-io_druid.org.apache.druid.server.security.AuthorizationUtils,1,0,0,1,0,0,0,0,2
druid-io_druid.org.apache.druid.server.security.ForbiddenException,2,0,0,0,0,0,0,0,2
druid-io_druid.org.apache.druid.server.initialization.JdbcAccessSecurityConfig,2,0,0,2,0,0,0,0,4
druid-io_druid.org.apache.druid.java.util.http.client.response.StatusResponseHandler,0,0,0,0,0,0,1,1,2
druid-io_druid.org.apache.druid.server.initialization.IndexerZkConfig,2,0,0,2,0,0,0,0,4
druid-io_druid.org.apache.druid.server.initialization.ServerConfig,2,0,0,1,0,0,0,4,7
druid-io_druid.org.apache.druid.server.initialization.jetty.JettyServerModule,1,0,0,1,0,0,0,0,2
druid-io_druid.org.apache.druid.server.lookup.cache.LookupNodeDiscovery,1,0,0,1,0,0,0,0,2
druid-io_druid.org.apache.druid.server.lookup.cache.LookupExtractorFactoryMapContainer,3,0,0,0,0,0,0,0,3
druid-io_druid.org.apache.druid.query.lookup.LookupExtractorFactoryContainer,2,0,0,0,0,0,0,0,2
druid-io_druid.org.apache.druid.server.lookup.cache.LookupCoordinatorManagerConfig,2,0,0,2,0,0,0,0,4
druid-io_druid.org.apache.druid.java.util.common.StringUtils,35,1,0,21,0,15,0,22,94
druid-io_druid.org.apache.druid.server.http.HostAndPortWithScheme,0,0,0,0,0,0,0,0,0
druid-io_druid.org.apache.druid.server.lookup.cache.LookupCoordinatorManager,4,0,0,2,0,0,0,5,11
druid-io_druid.org.apache.druid.server.coordinator.LoadQueuePeon,4,0,0,3,0,0,0,0,7
druid-io_druid.org.apache.druid.server.coordinator.duty.RunRules,12,0,0,12,0,0,0,2,26
druid-io_druid.org.apache.druid.server.coordinator.BalancerStrategy,8,0,0,8,0,0,0,0,16
druid-io_druid.org.apache.druid.server.coordinator.DruidCoordinatorConfig,2,0,0,2,0,0,0,0,4
druid-io_druid.org.apache.druid.server.coordinator.ReservoirSegmentSampler,1,1,0,1,0,0,0,0,3
druid-io_druid.org.apache.druid.server.coordinator.DruidCoordinator,4,0,0,4,0,0,0,1,9
druid-io_druid.org.apache.druid.server.coordinator.DataSourceCompactionConfig,14,0,0,14,0,0,0,0,28
druid-io_druid.org.apache.druid.segment.writeout.TmpFileSegmentWriteOutMediumFactory,3,0,0,3,0,0,0,0,6
druid-io_druid.org.apache.druid.server.coordinator.CoordinatorStats,7,0,0,7,0,0,0,0,14
druid-io_druid.org.apache.druid.common.config.NullHandling,63,46,0,12,0,2,0,64,187
druid-io_druid.org.apache.druid.client.ImmutableDruidDataSource,1,0,0,1,0,0,0,0,2
druid-io_druid.org.apache.druid.server.coordinator.AutoCompactionSnapshot,1,0,0,1,0,0,0,0,2
druid-io_druid.org.apache.druid.data.input.impl.DimensionsSpec,36,0,0,36,0,0,0,6,78
druid-io_druid.org.apache.druid.server.coordinator.CostBalancerStrategy,1,0,0,0,0,0,0,1,2
druid-io_druid.org.apache.druid.server.coordinator.ServerHolder,2,0,0,1,0,0,0,0,3
druid-io_druid.org.apache.druid.server.coordinator.DruidCluster,3,0,0,2,0,0,0,0,5
druid-io_druid.org.apache.druid.server.coordinator.cost.SegmentsCostCache,0,0,0,0,0,0,0,0,0
druid-io_druid.org.apache.druid.server.coordinator.rules.ForeverLoadRule,1,0,0,0,0,0,0,0,1
druid-io_druid.org.apache.druid.server.coordinator.rules.BroadcastDistributionRule,4,0,0,4,0,0,0,0,8
druid-io_druid.org.apache.druid.server.coordinator.rules.IntervalLoadRule,1,0,0,1,0,0,0,0,2
druid-io_druid.org.apache.druid.server.coordinator.rules.LoadRule,10,0,0,10,0,0,0,0,20
druid-io_druid.org.apache.druid.server.coordinator.rules.PeriodLoadRule,6,0,0,6,0,0,0,0,12
druid-io_druid.org.apache.druid.server.coordinator.rules.PeriodDropRule,3,0,0,3,0,0,0,0,6
druid-io_druid.org.apache.druid.server.coordinator.rules.PeriodDropBeforeRule,1,0,0,1,0,0,0,0,2
druid-io_druid.org.apache.druid.server.coordinator.duty.NewestSegmentFirstIterator,0,0,0,0,0,0,0,0,0
druid-io_druid.org.apache.druid.server.coordinator.duty.KillAuditLog,0,0,0,0,0,0,0,2,2
druid-io_druid.org.apache.druid.server.coordinator.duty.UnloadUnusedSegments,1,0,0,1,0,0,0,0,2
druid-io_druid.org.apache.druid.server.coordinator.duty.KillSupervisors,0,0,0,0,0,0,0,2,2
druid-io_druid.org.apache.druid.server.coordinator.DruidCoordinatorRuntimeParams,2,0,0,2,0,0,0,0,4
druid-io_druid.org.apache.druid.server.coordinator.duty.KillDatasourceMetadata,0,0,0,0,0,0,0,3,3
druid-io_druid.org.apache.druid.server.coordinator.duty.NewestSegmentFirstPolicy,21,2,0,21,0,0,0,6,50
druid-io_druid.org.apache.druid.server.coordinator.duty.KillCompactionConfig,3,0,0,3,0,0,0,1,7
druid-io_druid.org.apache.druid.server.coordinator.duty.MarkAsUnusedOvershadowedSegments,0,0,0,0,0,0,0,1,1
druid-io_druid.org.apache.druid.server.coordinator.duty.CompactSegments,5,0,0,5,0,0,0,0,10
druid-io_druid.org.apache.druid.discovery.DruidLeaderClient,9,0,0,9,0,0,0,2,20
druid-io_druid.org.apache.druid.indexer.TaskLocation,3,0,0,1,0,0,0,0,4
druid-io_druid.org.apache.druid.server.coordinator.duty.KillRules,0,0,0,0,0,0,0,2,2
druid-io_druid.org.apache.druid.server.coordinator.duty.KillSupervisorsCustomDuty,0,0,0,0,0,0,0,1,1
druid-io_druid.org.apache.druid.guice.JsonConfigProvider,6,0,0,6,0,0,0,0,12
druid-io_druid.org.apache.druid.server.log.FileRequestLogger,1,0,0,1,0,0,0,0,2
druid-io_druid.org.apache.druid.server.log.RequestLogger,0,0,0,0,0,0,0,3,3
druid-io_druid.org.apache.druid.server.log.FilteredRequestLoggerProvider,2,0,0,1,0,0,0,0,3
druid-io_druid.org.apache.druid.server.log.LoggingRequestLogger,5,0,0,3,0,0,0,1,9
druid-io_druid.org.apache.druid.server.log.DefaultRequestLogEvent,0,0,0,0,0,0,0,0,0
druid-io_druid.org.apache.druid.server.audit.SQLAuditManager,1,0,0,1,0,0,0,0,2
druid-io_druid.org.apache.druid.jackson.JacksonModule,0,0,0,0,0,0,0,3,3
druid-io_druid.org.apache.druid.curator.ExhibitorConfig,2,0,0,2,0,0,0,0,4
druid-io_druid.org.apache.druid.curator.CuratorConfig,2,0,0,2,0,0,0,0,4
druid-io_druid.org.apache.druid.curator.announcement.Announcer,3,0,0,3,0,0,0,0,6
druid-io_druid.org.apache.druid.curator.discovery.ServerDiscoverySelector,5,0,0,5,0,0,0,2,12
druid-io_druid.org.apache.druid.curator.inventory.CuratorInventoryManager,1,0,0,1,0,0,0,0,2
druid-io_druid.org.apache.druid.segment.loading.OmniDataSegmentKiller,6,0,0,0,0,0,0,2,8
druid-io_druid.org.apache.druid.timeline.DataSegment,29,1,0,27,0,0,0,3,60
druid-io_druid.org.apache.druid.segment.loading.LocalDataSegmentPusher,3,0,0,3,0,0,0,0,6
druid-io_druid.org.apache.druid.segment.loading.StorageLocationSelectorStrategy,10,0,0,10,0,0,0,0,20
druid-io_druid.org.apache.druid.segment.loading.SegmentLocalCacheLoader,1,0,0,1,0,0,0,0,2
druid-io_druid.org.apache.druid.segment.loading.LocalDataSegmentKiller,2,0,0,0,0,0,0,0,2
druid-io_druid.org.apache.druid.utils.CompressionUtils,9,0,0,3,0,5,0,4,21
druid-io_druid.org.apache.druid.segment.loading.OmniDataSegmentMover,2,0,0,0,0,0,0,1,3
druid-io_druid.org.apache.druid.segment.loading.LocalFileTimestampVersionFinder,5,0,0,0,0,0,0,0,5
druid-io_druid.org.apache.druid.segment.loading.StorageLocation,4,0,0,4,0,0,0,1,9
druid-io_druid.org.apache.druid.segment.loading.SegmentLocalCacheManager,13,0,0,13,0,0,0,2,28
druid-io_druid.org.apache.druid.storage.hdfs.HdfsFileTimestampVersionFinder,5,0,0,0,0,0,0,0,5
druid-io_druid.org.apache.druid.segment.loading.TombstoneSegmentizerFactory,1,0,0,1,0,0,0,0,2
druid-io_druid.org.apache.druid.segment.writeout.OffHeapMemorySegmentWriteOutMediumFactory,1,0,0,1,0,0,0,11,13
druid-io_druid.org.apache.druid.segment.LookupSegmentWrangler,1,0,0,0,0,0,0,1,2
druid-io_druid.org.apache.druid.segment.InlineSegmentWrangler,1,0,0,0,0,0,0,1,2
druid-io_druid.org.apache.druid.segment.VirtualColumns,16,0,0,14,0,0,0,5,35
druid-io_druid.org.apache.druid.segment.SegmentUtils,2,2,0,2,0,0,0,1,7
druid-io_druid.org.apache.druid.segment.RowBasedStorageAdapter,17,1,0,16,0,0,0,2,36
druid-io_druid.org.apache.druid.segment.incremental.IncrementalIndex,30,8,0,30,0,3,0,5,76
druid-io_druid.org.apache.druid.segment.IntIteratorUtils,1,0,0,0,0,0,0,2,3
druid-io_druid.org.apache.druid.segment.NestedDataColumnIndexer,1,1,0,1,0,0,0,0,3
druid-io_druid.org.apache.druid.segment.IndexSpec,4,0,0,3,0,0,0,0,7
druid-io_druid.org.apache.druid.segment.DictionaryMergingIterator,1,0,0,0,0,0,0,0,1
druid-io_druid.org.apache.druid.segment.QueryableIndexCursorSequenceBuilder,1,0,0,0,0,1,0,0,2
druid-io_druid.org.apache.druid.segment.DimensionSelector,2,0,0,2,0,0,0,4,8
druid-io_druid.org.apache.druid.segment.DimensionDictionarySelector,6,0,0,2,0,0,0,0,8
druid-io_druid.org.apache.druid.segment.IdLookup,2,0,0,2,0,0,0,0,4
druid-io_druid.org.apache.druid.segment.IndexMerger,7,0,0,3,0,0,0,0,10
druid-io_druid.org.apache.druid.segment.LongWrappingDimensionSelector,1,1,0,1,0,0,0,0,3
druid-io_druid.org.apache.druid.segment.DoubleWrappingDimensionSelector,1,1,0,1,0,0,0,0,3
druid-io_druid.org.apache.druid.segment.FloatWrappingDimensionSelector,1,1,0,1,0,0,0,0,3
druid-io_druid.org.apache.druid.segment.IntListUtils,0,0,0,0,0,0,0,0,0
druid-io_druid.org.apache.druid.segment.DimensionHandlerUtils,9,0,0,5,0,0,0,1,15
druid-io_druid.org.apache.druid.query.filter.ValueMatcher,1,0,0,1,0,0,0,0,2
druid-io_druid.org.apache.druid.segment.RowBasedColumnSelectorFactory,9,0,0,9,0,0,0,0,18
druid-io_druid.org.apache.druid.segment.IdMapping,2,0,0,2,0,0,0,0,4
druid-io_druid.org.apache.druid.segment.IndexIO,4,1,0,4,0,0,0,0,9
druid-io_druid.org.apache.druid.segment.BitmapOffset,1,0,0,1,0,0,0,0,2
druid-io_druid.org.apache.druid.math.expr.ExprMacroTable,2,1,0,2,0,0,0,0,5
druid-io_druid.org.apache.druid.segment.ReferenceCountingCloseableObject,1,0,0,1,0,1,0,0,3
druid-io_druid.org.apache.druid.segment.ReferenceCountingSegment,1,0,0,1,0,0,0,1,3
druid-io_druid.org.apache.druid.segment.incremental.AppendableIndexBuilder,10,3,0,10,0,1,0,2,26
druid-io_druid.org.apache.druid.segment.ColumnSelectorColumnIndexSelector,2,0,0,1,0,0,0,0,3
druid-io_druid.org.apache.druid.segment.Metadata,2,0,0,1,0,0,0,0,3
druid-io_druid.org.apache.druid.segment.QueryableIndexIndexableAdapter,1,0,0,1,0,0,0,0,2
druid-io_druid.org.apache.druid.segment.QueryableIndex,0,0,0,0,0,0,0,0,0
druid-io_druid.org.apache.druid.segment.realtime.RealtimeMetricsMonitor,1,0,0,1,0,0,0,0,2
druid-io_druid.org.apache.druid.segment.realtime.FireDepartmentMetrics,0,0,0,0,0,0,0,0,0
druid-io_druid.org.apache.druid.segment.realtime.FireHydrant,6,0,0,6,0,0,0,1,13
druid-io_druid.org.apache.druid.segment.realtime.FireDepartment,1,0,0,1,0,0,0,0,2
druid-io_druid.org.apache.druid.segment.realtime.plumber.ServerTimeRejectionPolicyFactory,1,0,0,1,0,0,0,0,2
druid-io_druid.org.apache.druid.segment.realtime.plumber.IntervalStartVersioningPolicy,0,0,0,0,0,0,0,0,0
druid-io_druid.org.apache.druid.segment.realtime.plumber.Sink,2,0,0,2,0,0,0,0,4
druid-io_druid.org.apache.druid.segment.realtime.plumber.MessageTimeRejectionPolicyFactory,1,0,0,1,0,0,0,0,2
druid-io_druid.org.apache.druid.segment.realtime.plumber.CustomVersioningPolicy,1,0,0,0,0,0,0,0,1
druid-io_druid.org.apache.druid.segment.realtime.appenderator.SegmentIdWithShardSpec,2,0,0,1,0,0,0,0,3
druid-io_druid.org.apache.druid.segment.realtime.appenderator.AppenderatorPlumber,1,0,0,1,0,0,0,0,2
druid-io_druid.org.apache.druid.segment.realtime.appenderator.StreamAppenderatorDriver,6,0,0,6,0,0,0,0,12
druid-io_druid.org.apache.druid.segment.realtime.appenderator.SegmentPublisherHelper,5,0,0,5,0,0,0,1,11
druid-io_druid.org.apache.druid.segment.realtime.appenderator.BatchAppenderatorDriver,3,0,0,3,0,0,0,0,6
druid-io_druid.org.apache.druid.segment.realtime.appenderator.Appenderator,18,0,0,18,0,0,0,0,36
druid-io_druid.org.apache.druid.segment.realtime.appenderator.StreamAppenderator,9,0,0,9,0,0,0,0,18
druid-io_druid.org.apache.druid.segment.realtime.appenderator.Committed,3,0,0,2,0,0,0,0,5
druid-io_druid.org.apache.druid.segment.realtime.appenderator.UnifiedIndexerAppenderatorsManager,1,0,0,1,0,0,0,0,2
druid-io_druid.org.apache.druid.segment.realtime.appenderator.BatchAppenderator,4,0,0,4,0,0,0,0,8
druid-io_druid.org.apache.druid.segment.realtime.firehose.PrefetchSqlFirehoseFactory,0,0,0,0,0,0,0,3,3
druid-io_druid.org.apache.druid.segment.realtime.firehose.CombiningFirehoseFactory,2,0,0,2,0,0,0,0,4
druid-io_druid.org.apache.druid.segment.realtime.firehose.InlineFirehoseFactory,3,0,0,3,0,0,0,0,6
druid-io_druid.org.apache.druid.segment.realtime.firehose.ServiceAnnouncingChatHandlerProvider,1,0,0,1,0,0,0,0,2
druid-io_druid.org.apache.druid.segment.realtime.firehose.InlineFirehose,4,0,0,3,0,1,0,1,9
druid-io_druid.org.apache.druid.segment.realtime.firehose.SqlFirehose,0,0,0,0,0,0,0,0,0
druid-io_druid.org.apache.druid.segment.realtime.firehose.IngestSegmentFirehose,1,1,0,1,0,0,0,0,3
druid-io_druid.org.apache.druid.server.metrics.EventReceiverFirehoseRegister,1,0,0,1,0,0,0,0,2
druid-io_druid.org.apache.druid.data.input.impl.AbstractTextFilesFirehoseFactory,1,0,0,1,0,0,0,0,2
druid-io_druid.org.apache.druid.segment.join.LookupJoinableFactory,2,0,0,1,0,0,0,1,4
druid-io_druid.org.apache.druid.segment.join.InlineJoinableFactory,2,0,0,1,0,0,0,1,4
druid-io_druid.org.apache.druid.segment.join.JoinableFactoryWrapper,7,0,0,7,0,0,0,2,16
druid-io_druid.org.apache.druid.segment.join.JoinPrefixUtils,1,0,0,0,0,0,0,7,8
druid-io_druid.org.apache.druid.segment.join.MapJoinableFactory,0,0,0,0,0,0,0,1,1
druid-io_druid.org.apache.druid.segment.join.filter.JoinFilterAnalyzer,3,0,0,3,0,0,0,0,6
druid-io_druid.org.apache.druid.segment.join.JoinableClause,0,0,0,0,0,0,0,1,1
druid-io_druid.org.apache.druid.segment.join.HashJoinSegment,4,0,0,4,0,0,0,0,8
druid-io_druid.org.apache.druid.segment.column.ColumnCapabilities,4,0,0,4,0,0,0,0,8
druid-io_druid.org.apache.druid.segment.join.HashJoinSegmentStorageAdapter,3,0,0,3,0,0,0,39,45
druid-io_druid.org.apache.druid.segment.indexing.DataSchema,5,0,0,5,0,0,0,3,13
druid-io_druid.org.apache.druid.segment.indexing.RealtimeTuningConfig,2,0,0,2,0,1,0,1,6
druid-io_druid.org.apache.druid.segment.indexing.granularity.GranularitySpec,0,0,0,0,0,0,0,0,0
druid-io_druid.org.apache.druid.segment.handoff.CoordinatorBasedSegmentHandoffNotifier,6,0,0,6,0,0,0,0,12
druid-io_druid.org.apache.druid.discovery.DruidNodeDiscoveryProvider,2,0,0,2,0,0,0,1,5
druid-io_druid.org.apache.druid.indexer.HadoopDruidIndexerJob,1,0,0,1,0,0,0,0,2
druid-io_druid.org.apache.druid.indexer.Bucket,3,0,0,1,0,0,0,0,4
druid-io_druid.org.apache.druid.data.input.impl.TimestampSpec,1,0,0,1,0,0,0,0,2
druid-io_druid.org.apache.druid.indexer.JobHelper,7,0,0,2,0,1,0,0,10
druid-io_druid.org.apache.druid.indexer.DeterminePartitionsJob,1,0,0,1,0,0,0,0,2
druid-io_druid.org.apache.druid.indexer.InputRowSerde,3,1,0,3,0,0,0,0,7
druid-io_druid.org.apache.druid.indexer.HadoopIngestionSpec,8,0,0,7,0,8,0,0,23
druid-io_druid.org.apache.druid.indexer.HadoopDruidIndexerConfig,22,0,0,22,0,0,0,0,44
druid-io_druid.org.apache.druid.indexer.hadoop.WindowedDataSegment,3,0,0,3,0,0,0,0,6
druid-io_druid.org.apache.druid.indexer.path.DatasourcePathSpec,2,0,0,1,0,0,0,0,3
druid-io_druid.org.apache.druid.indexer.Utils,5,0,0,3,0,0,0,0,8
druid-io_druid.org.apache.druid.indexer.DetermineHashedPartitionsJob,1,0,0,1,0,0,0,0,2
druid-io_druid.org.apache.druid.indexer.HadoopTuningConfig,1,0,0,1,0,0,0,2,4
druid-io_druid.org.apache.druid.indexer.HadoopDruidDetermineConfigurationJob,2,0,0,2,0,0,0,0,4
druid-io_druid.org.apache.druid.indexer.SortableBytes,1,0,0,1,0,0,0,0,2
druid-io_druid.org.apache.druid.indexer.MetadataStorageUpdaterJob,0,0,0,0,0,0,0,1,1
druid-io_druid.org.apache.druid.indexer.Property,3,0,0,3,0,0,0,0,6
druid-io_druid.org.apache.druid.indexer.TaskStatusPlus,1,0,0,1,0,0,0,0,2
druid-io_druid.org.apache.druid.guice.ExtensionsLoader,5,0,0,0,0,0,0,0,5
druid-io_druid.org.apache.druid.initialization.ServerInjectorBuilder,6,0,0,1,0,0,0,0,7
druid-io_druid.org.apache.druid.server.emitter.ComposingEmitterModule,0,0,0,0,0,0,0,1,1
druid-io_druid.org.apache.druid.query.RetryQueryRunner,3,0,0,3,0,0,0,0,6
druid-io_druid.org.apache.druid.query.ResultLevelCachingQueryRunner,5,0,0,5,0,1,0,0,11
druid-io_druid.org.apache.druid.query.QueryException,27,1,0,19,0,12,0,0,59
druid-io_druid.org.apache.druid.query.TableDataSource,2,0,0,0,0,0,0,1,3
druid-io_druid.org.apache.druid.query.GlobalTableDataSource,0,0,0,0,0,0,0,0,0
druid-io_druid.org.apache.druid.query.DataSource,1,0,0,1,0,0,0,1,3
druid-io_druid.org.apache.druid.query.ResultGranularTimestampComparator,2,0,0,0,0,0,0,0,2
druid-io_druid.org.apache.druid.query.TimewarpOperator,1,0,0,1,0,0,0,0,2
druid-io_druid.org.apache.druid.query.QueryPlus,0,0,0,0,0,0,0,0,0
druid-io_druid.org.apache.druid.query.UnionDataSource,1,0,0,0,0,0,0,1,2
druid-io_druid.org.apache.druid.query.Queries,0,0,0,0,0,0,0,0,0
druid-io_druid.org.apache.druid.query.LookupDataSource,1,0,0,0,0,0,0,1,2
druid-io_druid.org.apache.druid.query.QueryDataSource,2,0,0,0,0,0,0,1,3
druid-io_druid.org.apache.druid.query.JoinDataSource,2,0,0,0,0,0,0,2,4
druid-io_druid.org.apache.druid.query.DruidProcessingConfig,3,0,0,3,0,0,0,1,7
druid-io_druid.org.apache.druid.query.DefaultQueryMetrics,2,0,0,2,0,0,0,0,4
druid-io_druid.org.apache.druid.query.PrioritizedExecutorService,1,0,0,1,0,0,0,3,5
druid-io_druid.org.apache.druid.query.InlineDataSource,11,0,0,4,0,0,0,3,18
druid-io_druid.org.apache.druid.query.QueryContext,8,0,0,5,0,0,0,0,13
druid-io_druid.org.apache.druid.query.QueryContexts,2,0,0,1,0,0,0,1,4
druid-io_druid.org.apache.druid.query.groupby.GroupByQueryConfig,14,2,0,14,0,0,0,9,39
druid-io_druid.org.apache.druid.math.expr.ExpressionProcessing,1,0,0,1,0,0,0,4,6
druid-io_druid.org.apache.druid.query.ForwardingQueryProcessingPool,0,0,0,0,0,0,0,0,0
druid-io_druid.org.apache.druid.java.util.common.guava.Sequence,42,1,0,41,0,2,0,20,106
druid-io_druid.org.apache.druid.query.lookup.LookupIntrospectionResource,0,0,0,0,0,0,0,0,0
druid-io_druid.org.apache.druid.query.lookup.LookupSnapshotTaker,3,0,0,3,0,0,0,0,6
druid-io_druid.org.apache.druid.query.lookup.LookupReferencesManager,5,0,0,5,0,0,0,5,15
druid-io_druid.org.apache.druid.query.lookup.MapLookupExtractorFactory,2,0,0,1,0,0,0,0,3
druid-io_druid.org.apache.druid.query.lookup.LookupListeningAnnouncerConfig,0,0,0,0,0,0,0,0,0
druid-io_druid.org.apache.druid.query.lookup.RegisteredLookupExtractionFn,2,0,0,2,0,0,0,0,4
druid-io_druid.org.apache.druid.query.lookup.LookupExtractorFactoryContainerProvider,0,0,0,0,0,0,0,1,1
druid-io_druid.org.apache.druid.query.lookup.NamespaceLookupExtractorFactory,9,0,0,6,0,1,0,0,16
druid-io_druid.org.apache.druid.query.lookup.LookupExtractorFactory,1,0,0,1,0,0,0,0,2
druid-io_druid.org.apache.druid.server.lookup.namespace.cache.CacheScheduler,6,0,0,4,0,0,0,0,10
druid-io_druid.org.apache.druid.query.lookup.LookupUtils,0,0,0,0,0,0,0,0,0
druid-io_druid.org.apache.druid.query.lookup.KafkaLookupExtractorFactory,12,0,0,8,0,1,0,0,21
druid-io_druid.org.apache.druid.query.lookup.LookupExtractor,0,0,0,0,0,0,0,0,0
druid-io_druid.org.apache.druid.timeline.SegmentId,8,0,0,8,0,0,0,0,16
druid-io_druid.org.apache.druid.segment.RowBasedSegment,0,0,0,0,0,0,0,0,0
druid-io_druid.org.apache.druid.segment.StorageAdapter,2,0,0,2,0,0,0,0,4
druid-io_druid.org.apache.druid.segment.CursorFactory,0,0,0,0,0,0,0,0,0
druid-io_druid.org.apache.druid.query.lookup.LookupExtractionFn,3,2,0,3,0,0,0,0,8
druid-io_druid.org.apache.druid.query.extraction.FunctionalExtraction,4,4,0,3,0,0,0,0,11
druid-io_druid.org.apache.druid.query.lookup.LookupConfig,1,0,0,1,0,0,0,0,2
druid-io_druid.org.apache.druid.discovery.DataNodeService,2,0,0,0,0,0,0,0,2
druid-io_druid.org.apache.druid.guice.DruidProcessingModule,0,0,0,0,0,0,0,2,2
druid-io_druid.org.apache.druid.guice.BrokerProcessingModule,0,0,0,0,0,0,0,2,2
druid-io_druid.org.apache.druid.java.util.common.lifecycle.Lifecycle,6,0,0,6,0,3,0,0,15
druid-io_druid.org.apache.druid.guice.ExtensionsConfig,2,0,0,2,0,0,0,0,4
druid-io_druid.org.apache.druid.query.metadata.SegmentMetadataQueryConfig,1,0,0,1,0,0,0,0,2
druid-io_druid.org.apache.druid.metadata.MetadataStorageTablesConfig,2,0,0,2,0,0,0,0,4
druid-io_druid.org.apache.druid.guice.GuiceInjectors,0,0,0,0,0,0,0,2,2
druid-io_druid.org.apache.druid.server.security.AuthConfig,2,0,0,2,0,0,0,1,5
druid-io_druid.org.apache.druid.indexing.overlord.SegmentPublishResult,0,0,0,0,0,0,0,0,0
druid-io_druid.org.apache.druid.indexing.overlord.TaskLockbox,26,0,0,26,0,0,0,3,55
druid-io_druid.org.apache.druid.indexing.common.task.NoopTask,5,3,0,5,0,0,0,4,17
druid-io_druid.org.apache.druid.indexing.overlord.PortFinder,1,0,0,1,0,0,0,0,2
druid-io_druid.org.apache.druid.indexing.overlord.RemoteTaskRunnerFactory,0,0,0,0,0,0,0,0,0
druid-io_druid.org.apache.druid.indexer.TaskStatus,8,0,0,8,0,0,0,0,16
druid-io_druid.org.apache.druid.client.cache.MapCache,3,0,0,3,0,0,0,0,6
druid-io_druid.org.apache.druid.indexing.overlord.ImmutableWorkerInfo,1,0,0,1,0,0,0,0,2
druid-io_druid.org.apache.druid.indexing.overlord.WorkerTaskRunnerQueryAdapter,4,0,0,0,0,0,0,0,4
druid-io_druid.org.apache.druid.indexing.overlord.SingleTaskBackgroundRunner,3,0,0,3,0,1,0,0,7
druid-io_druid.org.apache.druid.indexing.overlord.IndexerMetadataStorageAdapter,0,0,0,0,0,0,0,1,1
druid-io_druid.org.apache.druid.indexing.overlord.ThreadingTaskRunner,1,0,0,1,0,1,0,0,3
druid-io_druid.org.apache.druid.indexing.overlord.RemoteTaskRunner,28,0,0,28,0,0,0,1,57
druid-io_druid.org.apache.druid.indexing.overlord.ForkingTaskRunner,5,0,0,5,0,0,0,0,10
druid-io_druid.org.apache.druid.indexing.overlord.TaskQueue,11,0,0,11,0,1,0,0,23
druid-io_druid.org.apache.druid.indexing.overlord.supervisor.SupervisorStatus,1,0,0,0,0,0,0,0,1
druid-io_druid.org.apache.druid.indexing.overlord.supervisor.SupervisorResource,22,0,0,22,0,0,0,0,44
druid-io_druid.org.apache.druid.indexing.overlord.supervisor.SupervisorManager,4,0,0,4,0,0,0,8,16
druid-io_druid.org.apache.druid.client.DruidServerConfig,1,0,0,1,0,0,0,0,2
druid-io_druid.org.apache.druid.java.util.common.concurrent.Execs,0,0,0,0,0,1,0,1,2
druid-io_druid.org.apache.druid.hll.HyperLogLogCollector,22,3,0,22,0,0,5,2,54
druid-io_druid.org.apache.druid.client.BrokerServerView,6,0,0,6,0,0,0,0,12
druid-io_druid.org.apache.druid.client.BrokerSegmentWatcherConfig,1,0,0,1,0,0,0,0,2
druid-io_druid.org.apache.druid.client.DirectDruidClient,2,0,0,2,0,0,0,0,4
druid-io_druid.org.apache.druid.client.CoordinatorServerView,2,0,0,2,0,0,0,0,4
druid-io_druid.org.apache.druid.client.BrokerInternalQueryConfig,1,0,0,0,0,0,0,0,1
druid-io_druid.org.apache.druid.query.planning.DataSourceAnalysis,18,0,0,17,0,0,0,0,35
druid-io_druid.org.apache.druid.client.HttpServerInventoryViewConfig,2,0,0,2,0,0,0,0,4
druid-io_druid.org.apache.druid.query.timeseries.TimeseriesQuery,0,0,0,0,0,0,0,0,0
druid-io_druid.org.apache.druid.client.cache.CacheConfig,2,0,0,2,0,0,0,0,4
druid-io_druid.org.apache.druid.client.cache.ByteCountingLRUMap,1,0,0,1,0,0,0,1,3
druid-io_druid.org.apache.druid.client.cache.HybridCache,1,0,0,1,0,0,0,0,2
druid-io_druid.org.apache.druid.client.cache.CaffeineCache,7,0,0,7,0,0,0,0,14
druid-io_druid.org.apache.druid.client.cache.CachePopulatorStats,2,0,0,0,0,0,0,0,2
druid-io_druid.org.apache.druid.client.cache.MemcachedCache,2,0,0,2,0,0,0,0,4
druid-io_druid.org.apache.druid.client.cache.MemcacheClientPool,1,0,0,0,0,0,0,0,1
druid-io_druid.org.apache.druid.client.cache.AbstractRedisCache,3,0,0,3,0,0,0,0,6
druid-io_druid.org.apache.druid.client.cache.RedisCacheFactory,0,0,0,0,0,0,0,5,5
druid-io_druid.org.apache.druid.client.cache.RedisCacheConfig,1,0,0,0,0,0,0,0,1
druid-io_druid.org.apache.druid.client.indexing.HttpIndexingServiceClient,2,0,0,2,0,2,0,1,7
druid-io_druid.org.apache.druid.client.indexing.ClientCompactionIntervalSpec,0,0,0,0,0,0,0,0,0
druid-io_druid.org.apache.druid.client.indexing.ClientCompactionTaskTransformSpec,1,0,0,1,0,0,0,0,2
druid-io_druid.org.apache.druid.client.indexing.ClientKillUnusedSegmentsTaskQuery,0,0,0,0,0,0,0,0,0
druid-io_druid.org.apache.druid.client.selector.RandomServerSelectorStrategy,1,0,0,1,0,0,0,0,2
druid-io_druid.org.apache.druid.client.selector.ServerSelector,0,0,0,0,0,0,0,0,0
druid-io_druid.org.apache.druid.metadata.SQLMetadataRuleManager,7,0,0,7,0,0,0,1,15
druid-io_druid.org.apache.druid.metadata.IndexerSQLMetadataStorageCoordinator,28,0,0,28,0,0,1,0,57
druid-io_druid.org.apache.druid.metadata.SQLMetadataStorageActionHandler,10,0,0,9,0,0,0,0,19
druid-io_druid.org.apache.druid.metadata.BasicDataSourceExt,2,0,0,2,0,0,0,0,4
druid-io_druid.org.apache.druid.metadata.SqlSegmentsMetadataManager,12,0,0,12,0,0,0,2,26
druid-io_druid.org.apache.druid.metadata.SQLMetadataSupervisorManager,8,0,0,8,0,0,0,0,16
druid-io_druid.org.apache.druid.metadata.EnvironmentVariableDynamicConfigProvider,2,0,0,0,0,0,0,0,2
druid-io_druid.org.apache.druid.metadata.MapStringDynamicConfigProvider,1,0,0,0,0,0,0,0,1
druid-io_druid.org.apache.druid.metadata.DefaultPasswordProvider,0,0,0,0,0,0,0,0,0
druid-io_druid.org.apache.druid.metadata.PasswordProvider,0,0,0,0,0,0,0,0,0
druid-io_druid.org.apache.druid.metadata.EnvironmentVariablePasswordProvider,1,0,0,0,0,0,0,0,1
druid-io_druid.org.apache.druid.metadata.MetadataStorageConnectorConfig,2,0,0,2,0,0,0,0,4
druid-io_druid.org.apache.druid.data.input.impl.HttpInputSourceConfig,1,0,0,0,0,0,0,0,1
druid-io_druid.org.apache.druid.metadata.input.SqlInputSource,1,0,0,1,0,0,0,2,4
druid-io_druid.org.apache.druid.metadata.input.SqlEntity,0,0,0,0,0,1,0,0,1
druid-io_druid.org.apache.druid.server.coordination.BatchDataSegmentAnnouncer,5,0,0,4,0,0,0,0,9
druid-io_druid.org.apache.druid.math.expr.Parser,23,1,0,23,0,0,0,13,60
druid-io_druid.org.apache.druid.math.expr.InputBindings,5,0,0,5,0,0,0,11,21
druid-io_druid.org.apache.druid.query.expression.IPv4AddressExprUtils,1,0,0,0,0,0,0,0,1
druid-io_druid.org.apache.druid.math.expr.ExprEval,8,1,0,7,0,1,0,23,40
druid-io_druid.org.apache.druid.query.expression.TimestampExtractExprMacro,0,0,0,0,0,0,0,0,0
druid-io_druid.org.apache.druid.query.expression.TimestampShiftExprMacro,0,0,0,0,0,0,0,1,1
druid-io_druid.org.apache.druid.query.dimension.DimensionSpec,1,0,0,1,0,0,0,0,2
druid-io_druid.org.apache.druid.java.util.common.Cacheable,5,0,0,2,0,0,0,0,7
druid-io_druid.org.apache.druid.query.extraction.ExtractionFn,1,0,0,1,0,0,0,0,2
druid-io_druid.org.apache.druid.query.dimension.ExtractionDimensionSpec,3,0,0,3,0,0,0,0,6
druid-io_druid.org.apache.druid.query.dimension.RegexFilteredDimensionSpec,1,0,0,1,0,0,0,0,2
druid-io_druid.org.apache.druid.query.dimension.ListFilteredDimensionSpec,5,0,0,3,0,0,0,0,8
druid-io_druid.org.apache.druid.query.dimension.PrefixFilteredDimensionSpec,1,0,0,1,0,0,0,0,2
druid-io_druid.org.apache.druid.indexing.overlord.supervisor.NoopSupervisorSpec,1,0,0,1,0,0,0,0,2
druid-io_druid.org.apache.druid.client.BatchServerInventoryView,3,0,0,3,0,1,0,0,7
druid-io_druid.org.apache.druid.java.util.common.parsers.Parser,14,0,0,7,0,2,0,5,28
druid-io_druid.org.apache.druid.emitter.statsd.StatsDEmitter,1,0,0,1,0,0,0,8,10
druid-io_druid.org.apache.druid.emitter.statsd.StatsDEmitterModule,0,0,0,0,0,0,0,0,0
druid-io_druid.org.apache.druid.data.input.aliyun.OssInputSource,0,0,0,0,0,0,0,0,0
druid-io_druid.org.apache.druid.data.input.impl.CloudObjectInputSource,5,0,0,5,0,0,0,2,12
druid-io_druid.org.apache.druid.storage.aliyun.OssDataSegmentMover,2,0,0,2,0,0,0,1,5
druid-io_druid.org.apache.druid.storage.aliyun.OssTaskLogs,0,0,0,0,0,0,0,4,4
druid-io_druid.org.apache.druid.storage.aliyun.OssDataSegmentKiller,0,0,0,0,0,0,0,2,2
druid-io_druid.org.apache.druid.segment.loading.OmniDataSegmentArchiver,2,0,0,0,0,0,0,0,2
druid-io_druid.org.apache.druid.storage.aliyun.OssTimestampVersionedDataFinder,0,0,0,0,0,0,0,0,0
druid-io_druid.org.apache.druid.storage.aliyun.OssDataSegmentArchiver,0,0,0,0,0,0,0,0,0
druid-io_druid.org.apache.druid.storage.aliyun.OssDataSegmentPuller,2,0,0,0,0,0,0,0,2
druid-io_druid.org.apache.druid.emitter.ambari.metrics.WhiteListBasedDruidToTimelineEventConverter,1,0,0,0,0,0,0,0,1
druid-io_druid.org.apache.druid.emitter.ambari.metrics.AmbariMetricsEmitter,1,0,0,1,0,0,0,0,2
druid-io_druid.org.apache.druid.emitter.prometheus.Metrics,1,0,0,1,0,0,0,0,2
druid-io_druid.org.apache.druid.emitter.prometheus.PrometheusEmitterModule,3,0,0,3,0,0,0,0,6
druid-io_druid.org.apache.druid.emitter.prometheus.PrometheusEmitter,1,0,0,1,0,0,0,1,3
druid-io_druid.org.apache.druid.query.movingaverage.PostAveragerAggregatorCalculator,1,0,0,1,0,0,0,0,2
druid-io_druid.org.apache.druid.query.movingaverage.RowBucketIterable,16,0,0,16,0,0,0,0,32
druid-io_druid.org.apache.druid.data.input.Row,6,0,0,5,0,0,0,9,20
druid-io_druid.org.apache.druid.query.movingaverage.MovingAverageIterable,9,0,0,9,0,0,0,0,18
druid-io_druid.org.apache.druid.query.movingaverage.averagers.AveragerFactory,1,0,0,0,0,0,0,0,1
druid-io_druid.org.apache.druid.query.movingaverage.averagers.BaseAverager,16,0,0,16,0,0,0,0,32
druid-io_druid.org.apache.druid.metadata.SQLMetadataConnector,2,0,0,0,0,0,0,0,2
druid-io_druid.org.apache.druid.metadata.storage.sqlserver.SQLServerConnector,0,0,0,0,0,0,0,0,0
druid-io_druid.org.apache.druid.emitter.opentsdb.OpentsdbSender,0,0,0,0,0,0,0,0,0
druid-io_druid.org.apache.druid.emitter.opentsdb.OpentsdbEmitterModule,0,0,0,0,0,0,0,0,0
druid-io_druid.org.apache.druid.emitter.opentsdb.EventConverter,4,0,0,3,0,0,0,0,7
druid-io_druid.org.apache.druid.query.aggregation.momentsketch.MomentSketchWrapper,1,0,0,1,0,0,0,0,2
druid-io_druid.org.apache.druid.query.aggregation.momentsketch.aggregator.MomentSketchQuantilePostAggregator,1,0,0,1,0,0,0,0,2
druid-io_druid.org.apache.druid.query.aggregation.PostAggregator,0,0,0,0,0,0,0,11,11
druid-io_druid.org.apache.druid.query.aggregation.momentsketch.aggregator.MomentSketchMinPostAggregator,1,0,0,1,0,0,0,0,2
druid-io_druid.org.apache.druid.query.aggregation.momentsketch.aggregator.MomentSketchMaxPostAggregator,1,0,0,1,0,0,0,0,2
druid-io_druid.org.apache.druid.emitter.kafka.KafkaEmitterModule,0,0,0,0,0,0,0,0,0
druid-io_druid.org.apache.druid.indexing.materializedview.MaterializedViewSupervisor,2,0,0,2,0,0,0,0,4
druid-io_druid.org.apache.druid.indexing.materializedview.MaterializedViewSupervisorSpec,3,0,0,3,0,1,0,0,7
druid-io_druid.org.apache.druid.storage.cloudfiles.CloudFilesDataSegmentPusher,0,0,0,0,0,0,0,0,0
druid-io_druid.org.apache.druid.storage.cloudfiles.CloudFilesByteSource,0,0,0,0,0,0,0,0,0
druid-io_druid.org.apache.druid.storage.cloudfiles.CloudFilesObjectApiProxy,1,0,0,1,0,0,0,0,2
druid-io_druid.org.apache.druid.emitter.dropwizard.DropwizardEmitterConfig,1,0,0,1,0,0,0,0,2
druid-io_druid.org.apache.druid.query.materializedview.MaterializedViewQueryQueryToolChest,0,0,0,0,0,0,0,0,0
druid-io_druid.org.apache.druid.query.materializedview.MaterializedViewUtils,0,0,0,0,0,0,0,0,0
druid-io_druid.org.apache.druid.query.materializedview.MaterializedViewQuery,1,0,0,1,0,0,0,0,2
druid-io_druid.org.apache.druid.emitter.opentelemetry.OpenTelemetryEmitter,2,0,0,0,0,0,0,0,2
druid-io_druid.org.apache.druid.emitter.graphite.GraphiteEmitterModule,0,0,0,0,0,0,0,0,0
druid-io_druid.org.apache.druid.emitter.graphite.WhiteListBasedConverter,1,0,0,1,0,0,0,0,2
druid-io_druid.org.apache.druid.emitter.graphite.GraphiteEmitter,0,0,0,0,0,0,0,0,0
druid-io_druid.org.apache.druid.segment.column.RowSignature,4,0,0,4,0,2,0,18,28
druid-io_druid.org.apache.druid.query.aggregation.TimestampAggregatorFactory,2,0,0,2,0,0,0,0,4
druid-io_druid.org.apache.druid.query.aggregation.TimestampMaxAggregatorFactory,1,0,0,1,0,0,0,0,2
druid-io_druid.org.apache.druid.query.aggregation.DoubleSumAggregator,2,0,0,1,0,0,0,0,3
druid-io_druid.org.apache.druid.query.aggregation.HistogramAggregatorFactory,1,0,0,0,0,0,0,0,1
druid-io_druid.org.apache.druid.query.aggregation.HistogramAggregator,1,0,0,0,0,0,0,0,1
druid-io_druid.org.apache.druid.query.aggregation.AggregatorFactory,17,0,0,14,0,0,0,1,32
druid-io_druid.org.apache.druid.query.aggregation.NullableNumericAggregatorFactory,8,0,0,8,0,0,0,0,16
druid-io_druid.org.apache.druid.query.aggregation.SimpleLongAggregatorFactory,4,0,0,4,0,0,0,0,8
druid-io_druid.org.apache.druid.query.aggregation.LongMaxAggregatorFactory,0,0,0,0,0,0,0,0,0
druid-io_druid.org.apache.druid.query.aggregation.SimpleDoubleAggregatorFactory,4,0,0,4,0,0,0,0,8
druid-io_druid.org.apache.druid.query.aggregation.DoubleMaxAggregatorFactory,0,0,0,0,0,0,0,0,0
druid-io_druid.org.apache.druid.query.aggregation.Histogram,0,0,0,0,0,0,0,0,0
druid-io_druid.org.apache.druid.query.aggregation.LongMinAggregatorFactory,0,0,0,0,0,0,0,0,0
druid-io_druid.org.apache.druid.query.aggregation.JavaScriptAggregator,3,0,0,3,0,0,0,0,6
druid-io_druid.org.apache.druid.query.aggregation.JavaScriptAggregatorFactory,1,0,0,1,0,0,0,0,2
druid-io_druid.org.apache.druid.query.aggregation.SimpleFloatAggregatorFactory,2,0,0,2,0,0,0,0,4
druid-io_druid.org.apache.druid.query.aggregation.FilteredAggregatorFactory,1,0,0,1,0,0,0,2,4
druid-io_druid.org.apache.druid.query.aggregation.ExpressionLambdaAggregatorFactory,14,0,0,11,0,0,0,2,27
druid-io_druid.org.apache.druid.query.aggregation.LongSumAggregator,2,0,0,1,0,0,0,0,3
druid-io_druid.org.apache.druid.query.aggregation.CountAggregator,2,0,0,2,0,0,0,0,4
druid-io_druid.org.apache.druid.query.aggregation.DoubleMinAggregatorFactory,0,0,0,0,0,0,0,0,0
druid-io_druid.org.apache.druid.query.aggregation.AggregatorUtil,1,0,0,0,0,0,0,0,1
druid-io_druid.org.apache.druid.query.aggregation.MetricManipulatorFns,3,0,0,3,0,0,0,0,6
druid-io_druid.org.apache.druid.query.aggregation.tdigestsketch.TDigestSketchModule,0,0,0,0,0,0,0,0,0
druid-io_druid.org.apache.druid.query.aggregation.tdigestsketch.TDigestSketchToQuantilePostAggregator,1,0,0,1,0,0,0,0,2
druid-io_druid.org.apache.druid.query.aggregation.tdigestsketch.TDigestSketchToQuantilesPostAggregator,1,0,0,1,0,0,0,0,2
druid-io_druid.org.apache.druid.indexing.overlord.autoscaling.gce.GceUtils,2,0,0,0,0,0,0,0,2
druid-io_druid.org.apache.druid.indexing.overlord.autoscaling.gce.GceModule,1,0,0,0,0,1,0,0,2
druid-io_druid.org.apache.druid.indexing.overlord.autoscaling.gce.GceAutoScaler,7,0,0,7,0,0,0,0,14
druid-io_druid.org.apache.druid.emitter.influxdb.InfluxdbEmitterConfig,0,0,0,0,0,0,0,0,0
druid-io_druid.org.apache.druid.emitter.influxdb.InfluxdbEmitter,0,0,0,0,0,0,0,0,0
druid-io_druid.org.apache.druid.emitter.influxdb.InfluxdbEmitterModule,0,0,0,0,0,0,0,0,0
druid-io_druid.org.apache.druid.data.input.thrift.ThriftInputRowParser,1,0,0,0,0,0,0,1,2
druid-io_druid.org.apache.druid.data.input.avro.AvroStreamInputFormat,0,0,0,0,0,0,0,0,0
druid-io_druid.org.apache.druid.data.input.AvroStreamInputRowParser,0,0,0,0,0,0,0,2,2
druid-io_druid.org.apache.druid.data.input.MapPopulator,0,0,0,0,0,0,0,0,0
druid-io_druid.org.apache.druid.data.input.MaxSizeSplitHintSpec,1,0,0,1,0,0,0,0,2
druid-io_druid.org.apache.druid.data.input.MapBasedRow,5,0,0,5,0,0,0,1,11
druid-io_druid.org.apache.druid.data.input.StringTuple,3,0,0,0,0,0,0,0,3
druid-io_druid.org.apache.druid.data.input.avro.AvroFlattenerMaker,1,0,0,0,0,0,0,0,1
druid-io_druid.org.apache.druid.data.input.avro.SchemaRegistryBasedAvroBytesDecoder,2,0,0,2,0,0,0,1,5
druid-io_druid.org.apache.druid.data.input.avro.InlineSchemasAvroBytesDecoder,1,0,0,0,0,0,0,0,1
druid-io_druid.org.apache.druid.data.input.InputEntityReader,7,0,0,7,0,0,0,0,14
druid-io_druid.org.apache.druid.data.input.avro.InlineSchemaAvroBytesDecoder,0,0,0,0,0,0,0,0,0
druid-io_druid.org.apache.druid.metadata.storage.mysql.MySQLMetadataStorageModule,1,0,0,0,0,0,0,0,1
druid-io_druid.org.apache.druid.metadata.storage.mysql.MySQLConnector,2,0,0,0,0,0,0,0,2
druid-io_druid.org.apache.druid.security.basic.authorization.endpoint.BasicAuthorizerResource,14,1,0,13,0,1,0,0,29
druid-io_druid.org.apache.druid.security.basic.authentication.endpoint.BasicAuthenticatorResource,5,0,0,4,0,0,0,0,9
druid-io_druid.org.apache.druid.security.basic.authorization.BasicRoleBasedAuthorizer,5,0,0,5,0,0,0,0,10
druid-io_druid.org.apache.druid.security.basic.authorization.db.updater.CoordinatorBasicAuthorizerMetadataStorageUpdater,8,0,0,8,0,0,0,15,31
druid-io_druid.org.apache.druid.security.basic.authentication.BasicHTTPAuthenticator,0,0,0,0,0,0,0,10,10
druid-io_druid.org.apache.druid.security.basic.authentication.db.updater.CoordinatorBasicAuthenticatorMetadataStorageUpdater,3,0,0,3,0,0,0,0,6
druid-io_druid.org.apache.druid.security.basic.authentication.db.cache.BasicAuthenticatorCacheManager,0,0,0,0,0,0,0,1,1
druid-io_druid.org.apache.druid.security.basic.authentication.validator.MetadataStoreCredentialsValidator,1,0,0,1,0,0,0,1,3
druid-io_druid.org.apache.druid.security.basic.authentication.validator.LDAPCredentialsValidator,1,0,0,0,0,0,0,1,2
druid-io_druid.org.apache.druid.security.basic.BasicAuthUtils,2,0,0,2,0,0,0,0,4
druid-io_druid.org.apache.druid.inputsource.hdfs.HdfsInputSourceConfig,0,0,0,0,0,0,0,0,0
druid-io_druid.org.apache.druid.storage.hdfs.HdfsDataSegmentPuller,3,0,0,3,0,0,0,0,6
druid-io_druid.org.apache.druid.storage.hdfs.HdfsDataSegmentPusher,0,0,0,0,0,0,0,0,0
druid-io_druid.org.apache.druid.storage.hdfs.HdfsDataSegmentKiller,4,0,0,1,0,0,0,2,7
druid-io_druid.org.apache.druid.firehose.hdfs.HdfsFirehoseFactory,0,0,0,0,0,0,0,0,0
druid-io_druid.org.apache.druid.tasklogs.TaskLogPusher,3,0,0,2,0,1,0,1,7
druid-io_druid.org.apache.druid.security.ranger.authorizer.RangerAuthorizer,1,0,0,1,0,0,0,0,2
druid-io_druid.org.apache.druid.server.lookup.namespace.cache.NamespaceExtractionCacheManager,1,0,0,1,0,0,0,2,4
druid-io_druid.org.apache.druid.server.lookup.namespace.StaticMapCacheGenerator,1,0,0,1,0,0,0,0,2
druid-io_druid.org.apache.druid.query.lookup.namespace.UriExtractionNamespace,3,0,0,3,0,0,0,0,6
druid-io_druid.org.apache.druid.query.lookup.namespace.StaticMapExtractionNamespace,1,0,0,1,0,0,0,0,2
druid-io_druid.org.apache.druid.indexing.overlord.autoscaling.ec2.EC2AutoScaler,3,0,0,1,0,0,0,0,4
druid-io_druid.org.apache.druid.indexing.overlord.autoscaling.ec2.EC2Module,0,0,0,0,0,0,0,0,0
druid-io_druid.org.apache.druid.indexing.overlord.autoscaling.ec2.EC2NodeData,1,0,0,1,0,0,0,0,2
druid-io_druid.org.apache.druid.indexing.worker.Worker,2,0,0,2,0,0,0,0,4
druid-io_druid.org.apache.druid.indexing.overlord.setup.JavaScriptWorkerSelectStrategy,3,0,0,0,0,0,0,0,3
druid-io_druid.org.apache.druid.indexing.overlord.setup.WorkerCategorySpec,1,0,0,1,0,0,0,0,2
druid-io_druid.org.apache.druid.indexing.overlord.setup.EqualDistributionWorkerSelectStrategy,2,0,0,2,0,0,0,0,4
druid-io_druid.org.apache.druid.indexing.overlord.setup.FillCapacityWorkerSelectStrategy,0,0,0,0,0,0,0,0,0
druid-io_druid.org.apache.druid.data.input.protobuf.ProtobufReader,0,0,0,0,0,0,0,4,4
druid-io_druid.org.apache.druid.data.input.protobuf.ProtobufInputRowParser,0,0,0,0,0,0,0,5,5
druid-io_druid.org.apache.druid.data.input.protobuf.ProtobufInputFormat,0,0,0,0,0,0,0,2,2
druid-io_druid.org.apache.druid.data.input.protobuf.SchemaRegistryBasedProtobufBytesDecoder,2,0,0,2,0,0,0,0,4
druid-io_druid.org.apache.druid.data.input.protobuf.FileBasedProtobufBytesDecoder,0,0,0,0,0,0,0,3,3
druid-io_druid.org.apache.druid.indexing.common.TaskInfoProvider,2,0,0,2,0,0,0,2,6
druid-io_druid.org.apache.druid.java.util.http.client.response.FullResponseHolder,34,0,0,32,0,2,0,6,74
druid-io_druid.org.apache.druid.java.util.http.client.response.StringFullResponseHolder,9,0,0,9,0,0,0,1,19
druid-io_druid.org.apache.druid.indexing.kinesis.KinesisIndexTask,2,0,0,2,0,0,0,0,4
druid-io_druid.org.apache.druid.indexing.seekablestream.SeekableStreamDataSourceMetadata,8,0,0,0,0,0,0,0,8
druid-io_druid.org.apache.druid.indexing.kinesis.KinesisIndexTaskTuningConfig,5,0,0,5,0,0,0,0,10
druid-io_druid.org.apache.druid.indexing.seekablestream.SeekableStreamIndexTaskIOConfig,5,0,0,5,0,0,0,0,10
druid-io_druid.org.apache.druid.indexing.kinesis.KinesisRecordSupplier,24,0,0,23,0,1,0,10,58
druid-io_druid.org.apache.druid.indexing.seekablestream.supervisor.SeekableStreamSupervisorSpec,15,0,0,15,0,0,0,0,30
druid-io_druid.org.apache.druid.indexing.kinesis.supervisor.KinesisSupervisor,3,0,0,3,0,0,0,0,6
druid-io_druid.org.apache.druid.indexing.seekablestream.supervisor.SeekableStreamSupervisorIOConfig,1,0,0,1,0,0,0,0,2
druid-io_druid.org.apache.druid.indexing.overlord.TaskRunner,0,0,0,0,0,0,0,2,2
druid-io_druid.org.apache.druid.indexing.kinesis.supervisor.KinesisSupervisorIOConfig,2,0,0,2,0,0,0,0,4
druid-io_druid.org.apache.druid.indexing.kinesis.supervisor.KinesisSupervisorTuningConfig,2,0,0,2,0,0,0,0,4
druid-io_druid.org.apache.druid.storage.google.GoogleInputDataConfig,2,0,0,2,0,0,0,0,4
druid-io_druid.org.apache.druid.storage.google.GoogleUtils,1,0,0,0,0,0,0,0,1
druid-io_druid.org.apache.druid.storage.google.GoogleTimestampVersionedDataFinder,0,0,0,0,0,0,0,0,0
druid-io_druid.org.apache.druid.storage.google.GoogleStorage,0,0,0,0,0,0,0,0,0
druid-io_druid.org.apache.druid.storage.google.GoogleTaskLogs,0,0,0,0,0,0,0,5,5
druid-io_druid.org.apache.druid.storage.google.GoogleByteSource,0,0,0,0,0,0,0,1,1
druid-io_druid.org.apache.druid.storage.google.GoogleDataSegmentPusher,2,0,0,2,0,0,0,0,4
druid-io_druid.org.apache.druid.storage.google.GoogleDataSegmentKiller,0,0,0,0,0,0,0,4,4
druid-io_druid.org.apache.druid.storage.azure.AzureStorageDruidModule,0,0,0,0,0,0,0,3,3
druid-io_druid.org.apache.druid.data.input.azure.AzureEntity,0,0,0,0,0,0,0,1,1
druid-io_druid.org.apache.druid.data.input.azure.AzureInputSource,1,0,0,1,0,0,0,0,2
druid-io_druid.org.apache.druid.storage.azure.AzureTaskLogs,0,0,0,0,0,0,0,6,6
druid-io_druid.org.apache.druid.storage.azure.AzureDataSegmentKiller,0,0,0,0,0,0,0,3,3
druid-io_druid.org.apache.druid.storage.azure.AzureCloudBlobHolderToCloudObjectLocationConverter,0,0,0,0,0,0,0,0,0
druid-io_druid.org.apache.druid.storage.azure.AzureByteSource,0,0,0,0,0,0,0,2,2
druid-io_druid.org.apache.druid.storage.azure.AzureCloudBlobIterator,1,0,0,1,0,0,0,0,2
druid-io_druid.org.apache.druid.storage.azure.AzureAccountConfig,4,0,0,4,0,0,0,0,8
druid-io_druid.org.apache.druid.storage.azure.AzureUtils,0,0,0,0,0,0,0,0,0
druid-io_druid.org.apache.druid.storage.azure.AzureDataSegmentConfig,1,0,0,1,0,0,0,0,2
druid-io_druid.org.apache.druid.storage.azure.AzureInputDataConfig,0,0,0,0,0,0,0,0,0
druid-io_druid.org.apache.druid.storage.azure.AzureStorage,1,0,0,0,0,0,0,0,1
druid-io_druid.org.apache.druid.storage.azure.AzureByteSourceFactory,1,0,0,0,0,0,0,0,1
druid-io_druid.org.apache.druid.data.input.impl.CloudObjectLocation,5,0,0,3,0,0,0,0,8
druid-io_druid.org.apache.druid.storage.azure.AzureCloudBlobIteratorFactory,1,0,0,0,0,0,0,0,1
druid-io_druid.org.apache.druid.storage.azure.AzureCloudBlobIterableFactory,1,0,0,0,0,0,0,0,1
druid-io_druid.org.apache.druid.storage.azure.blob.ListBlobItemHolderFactory,1,0,0,0,0,0,0,0,1
druid-io_druid.org.apache.druid.storage.azure.AzureDataSegmentPuller,2,0,0,2,0,0,0,0,4
druid-io_druid.org.apache.druid.storage.azure.AzureDataSegmentPusher,5,0,0,5,0,0,0,0,10
druid-io_druid.org.apache.druid.query.aggregation.variance.VarianceSerde,1,0,0,1,0,0,0,0,2
druid-io_druid.org.apache.druid.query.aggregation.variance.VarianceAggregatorFactory,8,0,0,1,0,0,0,1,10
druid-io_druid.org.apache.druid.query.aggregation.variance.VarianceLongVectorAggregator,7,0,0,6,0,0,0,0,13
druid-io_druid.org.apache.druid.query.aggregation.variance.VarianceAggregator,0,0,0,0,0,0,0,1,1
druid-io_druid.org.apache.druid.query.aggregation.variance.VarianceAggregatorCollector,1,0,0,1,0,0,0,1,3
druid-io_druid.org.apache.druid.query.aggregation.variance.VarianceFloatVectorAggregator,7,0,0,6,0,0,0,0,13
druid-io_druid.org.apache.druid.query.aggregation.variance.StandardDeviationPostAggregator,1,0,0,1,0,0,0,0,2
druid-io_druid.org.apache.druid.query.aggregation.variance.VarianceObjectVectorAggregator,3,0,0,2,0,0,0,0,5
druid-io_druid.org.apache.druid.query.aggregation.variance.VarianceDoubleVectorAggregator,7,0,0,6,0,0,0,0,13
druid-io_druid.org.apache.druid.query.aggregation.teststats.PvaluefromZscorePostAggregator,1,0,0,1,0,0,0,0,2
druid-io_druid.org.apache.druid.query.aggregation.teststats.ZtestPostAggregator,2,0,0,1,0,0,0,0,3
druid-io_druid.org.apache.druid.k8s.discovery.K8sDruidNodeAnnouncer,2,0,0,2,0,0,0,0,4
druid-io_druid.org.apache.druid.metadata.storage.postgresql.PostgreSQLConnector,0,0,0,0,0,0,0,0,0
druid-io_druid.org.apache.druid.data.input.s3.S3InputSource,0,0,0,0,0,0,0,0,0
druid-io_druid.org.apache.druid.common.aws.FileSessionCredentialsProvider,1,0,0,0,0,0,0,0,1
druid-io_druid.org.apache.druid.storage.s3.S3TaskLogs,0,0,0,0,0,0,0,4,4
druid-io_druid.org.apache.druid.storage.s3.S3TimestampVersionedDataFinder,0,0,0,0,0,0,0,0,0
druid-io_druid.org.apache.druid.storage.s3.S3DataSegmentPuller,2,0,0,2,0,0,0,0,4
druid-io_druid.org.apache.druid.storage.s3.S3DataSegmentKiller,0,0,0,0,0,0,0,2,2
druid-io_druid.org.apache.druid.storage.s3.S3DataSegmentArchiver,0,0,0,0,0,0,0,0,0
druid-io_druid.org.apache.druid.common.aws.AWSCredentialsConfig,4,0,0,4,0,0,0,0,8
druid-io_druid.org.apache.druid.storage.s3.S3InputDataConfig,0,0,0,0,0,0,0,0,0
druid-io_druid.org.apache.druid.storage.s3.S3DataSegmentMover,2,0,0,2,0,0,0,1,5
druid-io_druid.org.apache.druid.firehose.s3.StaticS3FirehoseFactory,1,0,0,1,0,0,0,0,2
druid-io_druid.org.apache.druid.query.aggregation.datasketches.hll.HllSketchToEstimatePostAggregator,1,0,0,1,0,0,0,0,2
druid-io_druid.org.apache.druid.query.aggregation.datasketches.hll.HllSketchUnionPostAggregator,1,0,0,1,0,0,0,0,2
druid-io_druid.org.apache.druid.query.aggregation.datasketches.hll.HllSketchToStringPostAggregator,1,0,0,1,0,0,0,0,2
druid-io_druid.org.apache.druid.query.aggregation.datasketches.hll.HllSketchAggregatorFactory,3,0,0,1,0,0,0,0,4
druid-io_druid.org.apache.druid.query.aggregation.datasketches.hll.HllSketchToEstimateWithBoundsPostAggregator,1,0,0,1,0,0,0,0,2
druid-io_druid.org.apache.druid.query.aggregation.datasketches.hll.HllSketchMergeAggregatorFactory,0,0,0,0,0,0,0,0,0
druid-io_druid.org.apache.druid.segment.vector.VectorCursor,0,0,0,0,0,0,0,1,1
druid-io_druid.org.apache.druid.query.aggregation.datasketches.theta.SketchHolder,3,0,0,2,0,0,0,0,5
druid-io_druid.org.apache.druid.query.aggregation.datasketches.theta.SketchAggregatorFactory,4,0,0,1,0,0,0,0,5
druid-io_druid.org.apache.druid.query.aggregation.Aggregator,10,0,0,10,0,0,0,1,21
druid-io_druid.org.apache.druid.query.aggregation.datasketches.theta.SketchAggregator,1,0,0,1,0,0,0,0,2
druid-io_druid.org.apache.druid.query.aggregation.datasketches.theta.SketchSetPostAggregator,1,0,0,1,0,0,0,0,2
druid-io_druid.org.apache.druid.query.aggregation.datasketches.theta.SketchModule,4,0,0,4,0,0,0,0,8
druid-io_druid.org.apache.druid.query.aggregation.datasketches.theta.SketchToStringPostAggregator,1,0,0,1,0,0,0,0,2
druid-io_druid.org.apache.druid.query.aggregation.datasketches.tuple.ArrayOfDoublesSketchToQuantilesSketchPostAggregator,1,0,0,1,0,0,0,0,2
druid-io_druid.org.apache.druid.query.aggregation.datasketches.tuple.ArrayOfDoublesSketchToEstimateAndBoundsPostAggregator,1,0,0,1,0,0,0,0,2
druid-io_druid.org.apache.druid.query.aggregation.datasketches.tuple.ArrayOfDoublesSketchToEstimatePostAggregator,1,0,0,1,0,0,0,0,2
druid-io_druid.org.apache.druid.query.aggregation.datasketches.tuple.ArrayOfDoublesSketchToStringPostAggregator,1,0,0,1,0,0,0,0,2
druid-io_druid.org.apache.druid.query.aggregation.datasketches.tuple.ArrayOfDoublesSketchTTestPostAggregator,1,0,0,1,0,0,0,1,3
druid-io_druid.org.apache.druid.query.aggregation.datasketches.tuple.ArrayOfDoublesSketchToVariancesPostAggregator,1,0,0,1,0,0,0,0,2
druid-io_druid.org.apache.druid.query.aggregation.datasketches.tuple.ArrayOfDoublesSketchSetOpPostAggregator,2,0,0,2,0,0,0,0,4
druid-io_druid.org.apache.druid.query.aggregation.datasketches.tuple.ArrayOfDoublesSketchToNumEntriesPostAggregator,1,0,0,1,0,0,0,0,2
druid-io_druid.org.apache.druid.query.aggregation.datasketches.tuple.ArrayOfDoublesSketchToMeansPostAggregator,1,0,0,1,0,0,0,0,2
druid-io_druid.org.apache.druid.query.aggregation.datasketches.quantiles.DoublesSketchToQuantilePostAggregator,1,0,0,1,0,0,0,0,2
druid-io_druid.org.apache.druid.query.aggregation.datasketches.quantiles.DoublesSketchToQuantilesPostAggregator,1,0,0,1,0,0,0,0,2
druid-io_druid.org.apache.druid.query.aggregation.datasketches.quantiles.DoublesSketchComplexMetricSerde,4,0,0,4,0,0,0,0,8
druid-io_druid.org.apache.druid.query.aggregation.datasketches.quantiles.DoublesSketchAggregatorFactory,3,0,0,1,0,0,0,0,4
druid-io_druid.org.apache.druid.query.aggregation.datasketches.quantiles.DoublesSketchToCDFPostAggregator,1,0,0,1,0,0,0,0,2
druid-io_druid.org.apache.druid.query.aggregation.datasketches.quantiles.DoublesSketchToStringPostAggregator,1,0,0,1,0,0,0,0,2
druid-io_druid.org.apache.druid.query.aggregation.datasketches.quantiles.DoublesSketchToRankPostAggregator,1,0,0,1,0,0,0,0,2
druid-io_druid.org.apache.druid.query.aggregation.datasketches.quantiles.DoublesSketchToHistogramPostAggregator,1,0,0,1,0,0,0,0,2
druid-io_druid.org.apache.druid.query.aggregation.datasketches.quantiles.DoublesSketchModule,0,0,0,0,0,0,0,0,0
druid-io_druid.org.apache.druid.server.lookup.LoadingLookup,2,2,0,2,0,0,0,2,8
druid-io_druid.org.apache.druid.server.lookup.cache.polling.PollingCache,1,0,0,0,0,0,0,1,2
druid-io_druid.org.apache.druid.server.lookup.PollingLookupFactory,0,0,0,0,0,0,0,0,0
druid-io_druid.org.apache.druid.server.lookup.LoadingLookupFactory,2,0,0,1,0,0,0,0,3
druid-io_druid.org.apache.druid.server.lookup.PollingLookup,1,0,0,0,0,0,0,1,2
druid-io_druid.org.apache.druid.server.lookup.cache.loading.LoadingCache,0,0,0,0,0,0,0,0,0
druid-io_druid.org.apache.druid.server.lookup.cache.loading.OnHeapLoadingCache,0,0,0,0,0,0,0,0,0
druid-io_druid.org.apache.druid.aws.rds.AWSRDSTokenPasswordProvider,1,0,0,1,0,0,0,0,2
druid-io_druid.org.apache.druid.query.aggregation.histogram.CustomBucketsPostAggregator,1,0,0,1,0,0,0,0,2
druid-io_druid.org.apache.druid.query.aggregation.histogram.FixedBucketsHistogramBufferAggregator,1,0,0,1,0,0,0,0,2
druid-io_druid.org.apache.druid.query.aggregation.histogram.FixedBucketsHistogramAggregator,1,0,0,1,0,0,0,0,2
druid-io_druid.org.apache.druid.query.aggregation.histogram.FixedBucketsHistogram,24,0,0,24,0,0,0,0,48
druid-io_druid.org.apache.druid.query.aggregation.histogram.MaxPostAggregator,2,0,0,2,0,0,0,0,4
druid-io_druid.org.apache.druid.query.aggregation.histogram.BucketsPostAggregator,1,0,0,1,0,0,0,0,2
druid-io_druid.org.apache.druid.query.aggregation.histogram.ApproximateHistogram,17,0,0,12,0,0,0,1,30
druid-io_druid.org.apache.druid.query.aggregation.histogram.MinPostAggregator,2,0,0,2,0,0,0,0,4
druid-io_druid.org.apache.druid.query.aggregation.histogram.ApproximateHistogramFoldingSerde,1,0,0,1,0,0,0,0,2
druid-io_druid.org.apache.druid.query.aggregation.histogram.EqualBucketsPostAggregator,1,0,0,1,0,0,0,0,2
druid-io_druid.org.apache.druid.query.aggregation.histogram.ApproximateHistogramAggregator,1,0,0,1,0,0,0,0,2
druid-io_druid.org.apache.druid.query.aggregation.histogram.QuantilesPostAggregator,1,0,0,1,0,0,0,1,3
druid-io_druid.org.apache.druid.query.aggregation.histogram.ArrayUtils,1,0,0,0,0,0,0,0,1
druid-io_druid.org.apache.druid.query.aggregation.histogram.ApproximateHistogramAggregatorFactory,4,0,0,3,0,0,0,0,7
druid-io_druid.org.apache.druid.query.aggregation.histogram.ApproximateHistogramFoldingAggregatorFactory,1,0,0,0,0,0,0,0,1
druid-io_druid.org.apache.druid.query.aggregation.histogram.QuantilePostAggregator,2,0,0,2,0,0,0,0,4
druid-io_druid.org.apache.druid.query.aggregation.histogram.ApproximateHistogramPostAggregator,0,0,0,0,0,0,0,0,0
druid-io_druid.org.apache.druid.data.input.kafkainput.KafkaInputFormat,5,1,0,5,0,0,0,0,11
druid-io_druid.org.apache.druid.data.input.kafkainput.KafkaHeaderFormat,0,0,0,0,0,0,0,0,0
druid-io_druid.org.apache.druid.indexing.kafka.KafkaRecordSupplier,9,0,0,8,0,0,0,0,17
druid-io_druid.org.apache.druid.indexing.seekablestream.SeekableStreamSamplerSpec,0,0,0,0,0,0,0,1,1
druid-io_druid.org.apache.druid.indexing.seekablestream.SeekableStreamIndexTaskTuningConfig,4,0,0,4,0,0,0,0,8
druid-io_druid.org.apache.druid.indexing.kafka.supervisor.KafkaSupervisorTuningConfig,3,0,0,3,0,0,0,0,6
druid-io_druid.org.apache.druid.indexing.kafka.supervisor.KafkaSupervisor,11,0,0,10,0,0,0,7,28
druid-io_druid.org.apache.druid.indexing.overlord.TaskMaster,11,0,0,11,0,1,0,8,31
druid-io_druid.org.apache.druid.indexing.kafka.supervisor.KafkaSupervisorIOConfig,4,0,0,4,0,0,0,0,8
druid-io_druid.org.apache.druid.indexing.kafka.KafkaConsumerConfigs,1,0,0,1,0,0,0,0,2
druid-io_druid.org.apache.druid.indexing.kafka.supervisor.KafkaSupervisorSpec,5,0,0,5,0,0,0,0,10
druid-io_druid.org.apache.druid.security.kerberos.DruidKerberosUtil,1,0,0,0,0,0,0,0,1
druid-io_druid.org.apache.druid.security.pac4j.OIDCConfig,1,0,0,1,0,0,0,0,2
druid-io_druid.org.apache.druid.security.pac4j.Pac4jCommonConfig,1,0,0,1,0,0,0,0,2
druid-io_druid.org.apache.druid.query.aggregation.bloom.BloomFilterAggregatorFactory,0,0,0,0,0,0,0,0,0
druid-io_druid.org.apache.druid.guice.BloomFilterSerializersModule,4,0,0,4,0,0,1,0,9
druid-io_druid.org.apache.druid.guice.BloomFilterExtensionModule,1,0,0,0,0,0,0,0,1
druid-io_druid.org.apache.druid.query.filter.BloomDimFilter,2,0,0,2,0,0,0,0,4
druid-io_druid.org.apache.druid.query.filter.BloomKFilter,9,0,0,9,0,0,2,8,28
druid-io_druid.org.apache.druid.query.filter.InDimFilter,4,2,0,3,0,0,0,0,9
druid-io_druid.org.apache.druid.query.filter.RegexDimFilter,3,0,0,1,0,0,0,0,4
druid-io_druid.org.apache.druid.query.filter.DimFilter,7,1,0,4,0,0,0,1,13
druid-io_druid.org.apache.druid.query.filter.SelectorDimFilter,2,0,0,0,0,0,0,0,2
druid-io_druid.org.apache.druid.query.filter.BoundDimFilter,1,0,0,0,0,0,0,0,1
druid-io_druid.org.apache.druid.query.filter.LikeDimFilter,1,0,0,1,0,0,0,0,2
druid-io_druid.org.apache.druid.query.filter.ExtractionDimFilter,1,0,0,1,0,0,0,0,2
druid-io_druid.org.apache.druid.query.filter.FalseDimFilter,0,0,0,0,0,0,0,0,0
druid-io_druid.org.apache.druid.query.filter.TrueDimFilter,0,0,0,0,0,0,0,0,0
druid-io_druid.org.apache.druid.query.filter.AndDimFilter,0,0,0,0,0,0,0,0,0
druid-io_druid.org.apache.druid.query.filter.JavaScriptDimFilter,3,0,0,3,0,0,0,0,6
druid-io_druid.org.apache.druid.query.filter.ColumnComparisonDimFilter,2,0,0,2,0,0,0,0,4
druid-io_druid.org.apache.druid.query.filter.SearchQueryDimFilter,3,0,0,3,0,0,0,0,6
druid-io_druid.org.apache.druid.indexing.seekablestream.SeekableStreamIndexTaskRunner,0,0,0,0,0,0,0,3,3
druid-io_druid.org.apache.druid.indexing.seekablestream.supervisor.autoscaler.AutoScalerConfig,1,0,0,1,0,0,0,0,2
druid-io_druid.org.apache.druid.data.input.InputSource,1,0,0,1,0,0,0,0,2
druid-io_druid.org.apache.druid.indexing.seekablestream.SeekableStreamEndSequenceNumbers,1,0,0,0,0,0,0,0,1
druid-io_druid.org.apache.druid.data.input.ColumnsFilter,0,0,0,0,0,0,0,1,1
druid-io_druid.org.apache.druid.indexing.seekablestream.common.RecordSupplier,1,0,0,1,0,0,0,0,2
druid-io_druid.org.apache.druid.indexing.seekablestream.supervisor.SeekableStreamSupervisor,6,0,0,6,0,0,0,0,12
druid-io_druid.org.apache.druid.indexing.overlord.supervisor.SupervisorStateManager,9,0,0,9,0,0,0,0,18
druid-io_druid.org.apache.druid.indexing.overlord.supervisor.SupervisorStateManagerConfig,1,0,0,1,0,0,0,0,2
druid-io_druid.org.apache.druid.segment.generator.GeneratorColumnSchema,0,0,0,0,0,0,0,0,0
druid-io_druid.org.apache.druid.indexing.input.GeneratorInputSource,2,0,0,2,0,0,0,0,4
druid-io_druid.org.apache.druid.indexing.input.InputRowSchemas,2,0,0,2,0,0,0,0,4
druid-io_druid.org.apache.druid.indexing.input.DruidSegmentReader,1,0,0,0,0,0,0,0,1
druid-io_druid.org.apache.druid.indexing.input.DruidSegmentInputFormat,0,0,0,0,0,0,0,0,0
druid-io_druid.org.apache.druid.indexing.input.DruidInputSource,3,0,0,3,0,0,0,0,6
druid-io_druid.org.apache.druid.indexing.common.RetryPolicyFactory,1,0,0,1,0,0,0,0,2
druid-io_druid.org.apache.druid.indexing.common.IndexTaskClient,0,0,0,0,0,0,0,1,1
druid-io_druid.org.apache.druid.indexing.common.RetryPolicy,1,0,0,1,0,0,0,0,2
druid-io_druid.org.apache.druid.indexing.common.TaskToolbox,0,0,0,0,0,0,0,0,0
druid-io_druid.org.apache.druid.indexing.common.TaskLock,1,0,0,1,0,0,0,0,2
druid-io_druid.org.apache.druid.indexing.common.task.CompactionTask,3,0,0,3,0,0,0,8,14
druid-io_druid.org.apache.druid.segment.incremental.RowIngestionMeters,4,0,0,0,0,4,0,0,8
druid-io_druid.org.apache.druid.indexing.common.task.FilteringCloseableInputRowIterator,0,0,0,0,0,0,0,0,0
druid-io_druid.org.apache.druid.indexing.common.task.SpecificSegmentsSpec,0,0,0,0,0,0,0,0,0
druid-io_druid.org.apache.druid.segment.realtime.appenderator.AppenderatorImpl,4,0,0,0,0,0,0,0,4
druid-io_druid.org.apache.druid.indexing.common.task.RealtimeIndexTask,0,0,0,0,0,0,0,0,0
druid-io_druid.org.apache.druid.indexing.common.task.CompactionInputSpec,2,0,0,1,0,0,0,0,3
druid-io_druid.org.apache.druid.java.util.common.granularity.Granularity,5,0,0,4,0,1,0,5,15
druid-io_druid.org.apache.druid.indexing.common.IngestionStatsAndErrorsTaskReport,1,0,0,0,0,0,0,0,1
druid-io_druid.org.apache.druid.indexing.common.task.SequenceNameFunction,1,0,0,1,0,0,0,1,3
druid-io_druid.org.apache.druid.indexing.common.task.HadoopTask,0,0,0,0,0,0,0,1,1
druid-io_druid.org.apache.druid.indexing.common.task.Tasks,1,1,0,1,0,0,0,0,3
druid-io_druid.org.apache.druid.indexing.common.task.AbstractTask,2,0,0,2,0,0,0,1,5
druid-io_druid.org.apache.druid.indexing.common.task.AbstractBatchIndexTask,0,0,0,0,0,0,0,0,0
druid-io_druid.org.apache.druid.indexing.common.task.IndexTask,0,0,0,0,0,0,0,1,1
druid-io_druid.org.apache.druid.indexing.common.task.TaskResource,1,0,0,1,0,0,0,0,2
druid-io_druid.org.apache.druid.timeline.partition.NoneShardSpec,3,0,0,2,0,0,0,0,5
druid-io_druid.org.apache.druid.indexing.common.task.ShardSpecs,1,0,0,1,0,0,0,0,2
druid-io_druid.org.apache.druid.indexing.common.task.Initialization,0,0,0,0,0,0,0,0,0
druid-io_druid.org.apache.druid.indexing.common.task.batch.parallel.ParallelIndexPhaseRunner,0,0,0,0,0,0,0,0,0
druid-io_druid.org.apache.druid.indexing.common.task.batch.parallel.SubTaskSpec,1,0,0,1,0,0,0,0,2
druid-io_druid.org.apache.druid.indexing.common.task.batch.parallel.TaskMonitor,2,0,0,2,0,0,0,0,4
druid-io_druid.org.apache.druid.indexing.common.task.batch.parallel.GenericPartitionStat,0,0,0,0,0,0,0,0,0
druid-io_druid.org.apache.druid.indexing.common.task.batch.parallel.ParallelIndexSupervisorTask,1,0,0,1,0,0,0,0,2
druid-io_druid.org.apache.druid.indexing.common.task.Task,1,0,0,1,0,0,0,0,2
druid-io_druid.org.apache.druid.indexing.common.task.batch.parallel.SinglePhaseSubTaskSpec,0,0,0,0,0,0,0,0,0
druid-io_druid.org.apache.druid.timeline.partition.ShardSpec,26,0,0,11,0,0,0,0,37
druid-io_druid.org.apache.druid.indexing.common.task.batch.parallel.DeepStorageShuffleClient,1,0,0,1,0,0,0,0,2
druid-io_druid.org.apache.druid.indexing.common.task.batch.parallel.GenericPartitionLocation,0,0,0,0,0,0,0,0,0
druid-io_druid.org.apache.druid.indexing.common.task.batch.parallel.DimensionCardinalityReport,2,0,0,2,0,0,0,0,4
druid-io_druid.org.apache.druid.indexing.common.task.batch.parallel.PartialHashSegmentGenerateTask,2,0,0,2,0,0,0,0,4
druid-io_druid.org.apache.druid.indexer.partitions.HashedPartitionsSpec,7,0,0,5,0,0,0,1,13
druid-io_druid.org.apache.druid.indexing.common.task.batch.parallel.ParallelIndexIngestionSpec,0,0,0,0,0,0,0,0,0
druid-io_druid.org.apache.druid.indexing.common.task.batch.parallel.ParallelIndexTuningConfig,0,0,0,0,0,0,0,0,0
druid-io_druid.org.apache.druid.indexing.common.task.batch.parallel.TombstoneHelper,2,0,0,2,0,0,0,0,4
druid-io_druid.org.apache.druid.indexing.common.task.batch.parallel.DeepStoragePartitionStat,0,0,0,0,0,0,0,0,0
druid-io_druid.org.apache.druid.indexing.common.task.batch.parallel.DeepStoragePartitionLocation,0,0,0,0,0,0,0,0,0
druid-io_druid.org.apache.druid.indexing.common.task.batch.parallel.distribution.StringSketchMerger,1,0,0,1,0,0,0,1,3
druid-io_druid.org.apache.druid.indexing.common.config.TaskStorageConfig,0,0,0,0,0,0,0,0,0
druid-io_druid.org.apache.druid.indexing.common.stats.TaskRealtimeMetricsMonitor,1,0,0,1,0,0,0,0,2
druid-io_druid.org.apache.druid.indexing.common.actions.SegmentAllocateAction,3,0,0,3,0,0,0,0,6
druid-io_druid.org.apache.druid.indexing.common.actions.TaskLocks,6,0,0,6,0,0,0,0,12
druid-io_druid.org.apache.druid.indexing.common.actions.SegmentTransactionalInsertAction,2,0,0,2,0,0,0,0,4
druid-io_druid.org.apache.druid.indexing.common.actions.TimeChunkLockTryAcquireAction,2,0,0,2,0,0,0,0,4
druid-io_druid.org.apache.druid.indexing.common.actions.SegmentInsertAction,0,0,0,0,0,0,0,0,0
druid-io_druid.org.apache.druid.indexing.common.actions.TimeChunkLockAcquireAction,2,0,0,2,0,0,0,0,4
druid-io_druid.org.apache.druid.indexing.common.actions.SurrogateAction,0,0,0,0,0,0,0,0,0
druid-io_druid.org.apache.druid.indexing.overlord.hrtr.WorkerHolder,1,0,0,1,0,0,0,0,2
druid-io_druid.org.apache.druid.indexing.overlord.hrtr.HttpRemoteTaskRunner,5,0,0,5,0,1,0,0,11
druid-io_druid.org.apache.druid.indexing.overlord.helpers.TaskLogAutoCleanerConfig,2,0,0,2,0,0,0,0,4
druid-io_druid.org.apache.druid.indexing.overlord.http.OverlordRedirectInfo,2,0,0,2,0,0,0,0,4
druid-io_druid.org.apache.druid.indexing.overlord.http.OverlordResource,27,0,0,26,0,0,0,3,56
druid-io_druid.org.apache.druid.indexing.overlord.http.security.TaskResourceFilter,1,0,0,1,0,0,0,0,2
druid-io_druid.org.apache.druid.indexing.overlord.http.security.SupervisorResourceFilter,1,0,0,1,0,0,0,0,2
druid-io_druid.org.apache.druid.indexing.overlord.config.ForkingTaskRunnerConfig,1,0,0,1,0,0,0,0,2
druid-io_druid.org.apache.druid.indexing.overlord.autoscaling.AutoScaler,14,0,0,14,0,0,0,0,28
druid-io_druid.org.apache.druid.java.util.emitter.EmittingLogger,2,0,0,2,0,0,0,0,4
druid-io_druid.org.apache.druid.indexing.overlord.autoscaling.PendingTaskBasedWorkerProvisioningConfig,5,0,0,5,0,0,0,0,10
druid-io_druid.org.apache.druid.indexing.overlord.sampler.IndexTaskSamplerSpec,1,0,0,1,0,0,0,0,2
druid-io_druid.org.apache.druid.indexing.overlord.sampler.InputSourceSampler,13,0,0,13,0,0,0,1,27
druid-io_druid.org.apache.druid.indexing.worker.http.WorkerResource,2,0,0,2,0,0,0,0,4
druid-io_druid.org.apache.druid.indexing.worker.shuffle.LocalIntermediaryDataManager,1,0,0,0,0,0,0,0,1
druid-io_druid.org.apache.druid.indexing.worker.shuffle.ShuffleMonitor,1,0,0,1,0,0,0,0,2
druid-io_druid.org.apache.druid.indexing.worker.shuffle.ShuffleResource,2,0,0,1,0,0,0,0,3
druid-io_druid.org.apache.druid.indexing.worker.shuffle.ShuffleMetrics,1,0,0,1,0,0,0,1,3
druid-io_druid.org.apache.druid.indexing.worker.shuffle.ShuffleDataSegmentPusher,1,1,0,1,0,0,0,0,3
druid-io_druid.org.apache.druid.indexing.worker.TaskAnnouncement,1,0,0,1,0,0,0,0,2
druid-io_druid.org.apache.druid.indexing.common.actions.TaskActionClient,0,0,0,0,0,0,0,0,0
druid-io_druid.org.apache.druid.indexing.firehose.IngestSegmentFirehoseFactory,1,1,0,1,0,0,0,0,3
druid-io_druid.org.apache.druid.data.input.Firehose,1,0,0,1,0,0,0,0,2
druid-io_druid.org.apache.druid.common.aws.AWSClientUtil,0,0,0,0,0,0,0,0,0
druid-io_druid.org.apache.druid.indexer.hadoop.DatasourceIngestionSpec,1,0,0,1,0,0,0,0,2
druid-io_druid.org.apache.druid.indexer.hadoop.DatasourceInputSplit,5,0,0,1,0,0,0,0,6
druid-io_druid.org.apache.druid.indexer.hadoop.DatasourceInputFormat,2,0,0,2,0,0,0,0,4
druid-io_druid.org.apache.druid.indexer.hadoop.DatasourceRecordReader,1,0,0,1,0,0,0,0,2
druid-io_druid.org.apache.druid.indexer.hadoop.FSSpideringIterator,1,0,0,1,0,2,0,0,4
druid-io_druid.org.apache.druid.indexer.path.StaticPathSpec,0,0,0,0,0,0,0,0,0
druid-io_druid.org.apache.druid.indexer.path.GranularUnprocessedPathSpec,0,0,0,0,0,0,0,0,0
druid-io_druid.org.apache.druid.indexer.path.MultiplePathSpec,0,0,0,0,0,0,0,1,1
druid-io_druid.org.apache.druid.indexer.path.GranularityPathSpec,0,0,0,0,0,0,0,0,0
druid-io_druid.org.apache.druid.indexer.partitions.DimensionRangePartitionsSpec,0,0,0,0,0,0,0,0,0
druid-io_druid.org.apache.druid.timeline.Overshadowable,0,0,0,0,0,0,0,0,0
druid-io_druid.org.apache.druid.timeline.LogicalSegment,0,0,0,0,0,0,0,0,0
druid-io_druid.org.apache.druid.timeline.SegmentWithOvershadowedStatus,1,0,0,1,0,0,0,0,2
druid-io_druid.org.apache.druid.cli.Main,0,0,0,0,0,0,0,1,1
druid-io_druid.org.apache.druid.query.QueryRunnerFactory,5,0,0,5,0,0,0,0,10
druid-io_druid.org.apache.druid.cli.DumpSegment,0,0,0,0,0,0,0,0,0
druid-io_druid.org.apache.druid.cli.PullDependencies,2,0,0,0,0,0,0,0,2
druid-io_druid.org.apache.druid.cli.Log4JShutdownPropertyChecker,1,0,0,0,0,0,0,0,1
druid-io_druid.org.apache.druid.cli.validate.DruidJsonValidator,0,0,0,0,0,0,0,0,0
druid-io_druid.org.apache.druid.guice.FirehoseModule,0,0,0,0,0,0,0,1,1
druid-io_druid.org.apache.druid.crypto.CryptoService,0,0,0,0,0,0,0,0,0
druid-io_druid.org.apache.druid.java.util.http.client.HttpClientConfig,4,0,0,4,0,1,1,2,12
druid-io_druid.org.apache.druid.java.util.http.client.HttpClientInit,1,0,0,1,0,0,0,0,2
druid-io_druid.org.apache.druid.java.util.http.client.io.AppendableByteArrayInputStream,6,1,0,5,0,1,0,0,13
druid-io_druid.org.apache.druid.java.util.http.client.response.SequenceInputStreamResponseHandler,3,0,0,3,0,0,0,0,6
druid-io_druid.org.apache.druid.java.util.http.client.response.InputStreamFullResponseHandler,1,0,0,1,0,0,0,0,2
druid-io_druid.org.apache.druid.java.util.http.client.response.ObjectOrErrorResponseHandler,3,0,0,3,0,0,0,0,6
druid-io_druid.org.apache.druid.java.util.http.client.pool.ResourceContainer,3,0,0,3,0,0,0,2,8
druid-io_druid.org.apache.druid.java.util.http.client.pool.ResourcePool,1,0,0,0,0,0,0,0,1
druid-io_druid.org.apache.druid.java.util.metrics.CgroupCpuSetMonitor,1,0,0,1,0,0,0,0,2
druid-io_druid.org.apache.druid.java.util.metrics.NoopSysMonitor,0,0,0,0,0,0,0,0,0
druid-io_druid.org.apache.druid.java.util.metrics.ProcFsReader,0,0,0,0,0,0,0,0,0
druid-io_druid.org.apache.druid.java.util.metrics.CpuAcctDeltaMonitor,1,0,0,1,0,1,0,0,3
druid-io_druid.org.apache.druid.java.util.metrics.CgroupCpuMonitor,2,0,0,1,0,0,0,0,3
druid-io_druid.org.apache.druid.java.util.metrics.Monitor,0,0,0,0,0,0,0,3,3
druid-io_druid.org.apache.druid.java.util.metrics.JvmPidDiscoverer,0,0,0,0,0,0,0,0,0
druid-io_druid.org.apache.druid.java.util.metrics.SigarPidDiscoverer,0,0,0,0,0,0,0,1,1
druid-io_druid.org.apache.druid.java.util.metrics.MonitorSchedulerConfig,0,0,0,0,0,0,0,3,3
druid-io_druid.org.apache.druid.java.util.metrics.SigarUtil,0,0,0,0,0,0,0,0,0
druid-io_druid.org.apache.druid.java.util.metrics.CgroupMemoryMonitor,1,0,0,0,0,0,0,0,1
druid-io_druid.org.apache.druid.java.util.metrics.AllocationMetricCollector,1,0,0,1,0,0,0,0,2
druid-io_druid.org.apache.druid.java.util.metrics.Monitors,0,0,0,0,0,0,0,2,2
druid-io_druid.org.apache.druid.java.util.metrics.cgroups.CpuAcct,2,0,0,0,0,1,0,0,3
druid-io_druid.org.apache.druid.java.util.metrics.cgroups.CgroupDiscoverer,0,0,0,0,0,0,0,0,0
druid-io_druid.org.apache.druid.java.util.metrics.cgroups.ProcCgroupDiscoverer,1,0,0,1,0,0,0,0,2
druid-io_druid.org.apache.druid.java.util.metrics.cgroups.Cpu,2,0,0,0,0,1,0,0,3
druid-io_druid.org.apache.druid.java.util.metrics.cgroups.Memory,2,0,0,0,0,1,0,0,3
druid-io_druid.org.apache.druid.java.util.metrics.cgroups.CpuSet,3,0,0,0,0,1,0,0,4
druid-io_druid.org.apache.druid.java.util.common.Numbers,5,0,0,1,0,0,0,8,14
druid-io_druid.org.apache.druid.java.util.common.granularity.IntervalsByGranularity,1,0,0,1,0,0,1,0,3
druid-io_druid.org.apache.druid.java.util.common.RetryUtils,1,0,0,0,0,1,0,0,2
druid-io_druid.org.apache.druid.java.util.common.ByteBufferUtils,3,0,0,2,0,0,0,1,6
druid-io_druid.org.apache.druid.java.util.common.FileUtils,4,0,0,2,0,0,0,3,9
druid-io_druid.org.apache.druid.java.util.common.URIs,3,0,0,0,0,0,0,0,3
druid-io_druid.org.apache.druid.java.util.common.StreamUtils,1,0,0,0,0,1,0,0,2
druid-io_druid.org.apache.druid.java.util.common.Triple,1,0,0,1,0,0,0,0,2
druid-io_druid.org.apache.druid.java.util.common.HumanReadableBytes,19,0,0,0,0,0,0,28,47
druid-io_druid.org.apache.druid.java.util.common.logger.Logger,0,0,0,0,0,0,1,4,5
druid-io_druid.org.apache.druid.java.util.common.io.NativeIO,0,0,0,0,0,0,0,0,0
druid-io_druid.org.apache.druid.java.util.common.io.smoosh.FileSmoosher,1,0,0,0,0,1,0,4,6
druid-io_druid.org.apache.druid.java.util.common.io.smoosh.SmooshedFileMapper,1,0,0,1,0,0,0,0,2
druid-io_druid.org.apache.druid.java.util.common.parsers.ParserUtils,2,0,0,0,0,0,0,0,2
druid-io_druid.org.apache.druid.java.util.common.parsers.TimestampParser,7,0,0,4,0,0,0,2,13
druid-io_druid.org.apache.druid.java.util.common.guava.Accumulators,4,0,0,4,0,3,0,0,11
druid-io_druid.org.apache.druid.java.util.common.guava.FunctionalIterator,0,0,0,0,0,0,0,0,0
druid-io_druid.org.apache.druid.java.util.common.guava.DelegatingYieldingAccumulator,0,0,0,0,0,0,0,2,2
druid-io_druid.org.apache.druid.java.util.common.guava.Yielder,4,0,0,3,0,0,0,0,7
druid-io_druid.org.apache.druid.java.util.common.guava.Sequences,3,0,0,1,0,3,0,2,9
druid-io_druid.org.apache.druid.java.util.common.guava.ExplodingSequence,3,0,0,0,0,3,0,0,6
druid-io_druid.org.apache.druid.java.util.common.guava.SimpleSequence,0,0,0,0,0,0,0,0,0
druid-io_druid.org.apache.druid.java.util.common.guava.FunctionalIterable,0,0,0,0,0,0,0,0,0
druid-io_druid.org.apache.druid.java.util.common.guava.Comparators,2,0,0,2,0,0,0,0,4
druid-io_druid.org.apache.druid.java.util.common.guava.YieldingAccumulator,0,0,0,0,0,1,0,0,1
druid-io_druid.org.apache.druid.java.util.common.concurrent.ScheduledExecutors,0,0,0,0,0,0,0,1,1
druid-io_druid.org.apache.druid.java.util.emitter.service.ServiceMetricEvent,1,0,0,1,0,0,0,0,2
druid-io_druid.org.apache.druid.java.util.emitter.service.AlertEvent,0,0,0,0,0,0,0,0,0
druid-io_druid.org.apache.druid.java.util.emitter.service.ServiceEventBuilder,1,0,0,1,0,0,0,0,2
druid-io_druid.org.apache.druid.java.util.emitter.core.HttpPostEmitter,6,0,0,2,0,1,0,1,10
druid-io_druid.org.apache.druid.java.util.emitter.core.Emitter,3,0,0,3,0,1,0,0,7
druid-io_druid.org.apache.druid.java.util.emitter.core.LoggingEmitterConfig,4,0,0,4,0,0,0,0,8
druid-io_druid.org.apache.druid.java.util.emitter.core.ComposingEmitter,0,0,0,0,0,0,0,4,4
druid-io_druid.org.apache.druid.java.util.emitter.core.ParametrizedUriEmitterConfig,2,0,0,2,0,0,0,0,4
druid-io_druid.org.apache.druid.java.util.emitter.core.HttpEmitterConfig,4,0,0,4,0,0,0,0,8
druid-io_druid.org.apache.druid.java.util.emitter.core.BaseHttpEmittingConfig,1,0,0,0,0,0,0,0,1
druid-io_druid.org.apache.druid.java.util.emitter.core.Emitters,1,0,0,0,0,0,0,0,1
druid-io_druid.org.apache.druid.utils.Throwables,0,0,0,0,0,0,0,0,0
druid-io_druid.org.apache.druid.utils.CloseableUtils,0,0,0,0,0,0,0,2,2
druid-io_druid.org.apache.druid.utils.CircularBuffer,1,0,0,1,0,0,0,0,2
druid-io_druid.org.apache.druid.utils.JvmUtils,1,0,0,1,0,1,0,0,3
druid-io_druid.org.apache.druid.data.input.impl.FlatTextInputFormat,0,0,0,0,0,0,0,0,0
druid-io_druid.org.apache.druid.data.input.impl.InputEntityIteratingReader,1,0,0,1,0,0,0,0,2
druid-io_druid.org.apache.druid.data.input.impl.JSONLowercaseParseSpec,0,0,0,0,0,0,0,0,0
druid-io_druid.org.apache.druid.data.input.impl.MapInputRowParser,4,0,0,4,0,0,0,4,12
druid-io_druid.org.apache.druid.data.input.impl.FileIteratingFirehose,0,0,0,0,0,0,0,0,0
druid-io_druid.org.apache.druid.data.input.impl.StringInputRowParser,0,0,0,0,0,0,0,2,2
druid-io_druid.org.apache.druid.data.input.impl.ParseSpec,1,0,0,1,0,0,0,0,2
druid-io_druid.org.apache.druid.data.input.impl.RegexParseSpec,1,0,0,1,0,0,0,0,2
druid-io_druid.org.apache.druid.data.input.impl.CsvInputFormat,2,0,0,2,0,0,0,0,4
druid-io_druid.org.apache.druid.data.input.impl.JSONParseSpec,3,0,0,3,0,0,0,0,6
druid-io_druid.org.apache.druid.data.input.impl.RetryingInputStream,4,0,0,0,0,0,0,0,4
druid-io_druid.org.apache.druid.data.input.impl.DelimitedParseSpec,1,0,0,1,0,0,0,0,2
druid-io_druid.org.apache.druid.data.input.impl.JavaScriptParseSpec,1,0,0,1,0,0,0,1,3
druid-io_druid.org.apache.druid.data.input.impl.DelimitedInputFormat,3,0,0,3,0,0,0,0,6
druid-io_druid.org.apache.druid.java.util.common.parsers.JSONPathSpec,1,0,0,1,0,0,0,0,2
druid-io_druid.org.apache.druid.data.input.InputRow,1,0,0,1,0,0,0,0,2
druid-io_druid.org.apache.druid.java.util.common.parsers.JSONPathFieldSpec,1,0,0,1,0,0,0,0,2
druid-io_druid.org.apache.druid.data.input.impl.HttpEntity,0,0,0,0,0,0,0,3,3
druid-io_druid.org.apache.druid.data.input.impl.CombiningInputSource,1,0,0,1,0,0,0,0,2
druid-io_druid.org.apache.druid.data.input.impl.RegexInputFormat,1,0,0,1,0,0,0,0,2
druid-io_druid.org.apache.druid.data.input.impl.LocalInputSource,1,0,0,1,0,0,0,0,2
druid-io_druid.org.apache.druid.data.input.impl.JsonInputFormat,0,0,0,0,0,0,0,0,0
druid-io_druid.org.apache.druid.data.input.impl.prefetch.PrefetchableTextFilesFirehoseFactory,0,2,0,0,0,0,0,7,9
druid-io_druid.org.apache.druid.data.input.impl.prefetch.JsonIterator,0,0,0,0,0,0,0,0,0
druid-io_druid.org.apache.druid.math.expr.Exprs,3,0,0,3,0,0,0,0,6
druid-io_druid.org.apache.druid.math.expr.ExpressionType,3,0,0,3,0,0,0,1,7
druid-io_druid.org.apache.druid.math.expr.ExpressionTypeConversion,3,0,0,0,0,0,0,3,6
druid-io_druid.org.apache.druid.math.expr.ExpressionTypeFactory,0,0,0,0,0,0,0,1,1
druid-io_druid.org.apache.druid.math.expr.SettableObjectBinding,1,0,0,1,0,0,0,0,2
druid-io_druid.org.apache.druid.math.expr.Expr,8,1,0,8,0,2,0,1,20
druid-io_druid.org.apache.druid.common.utils.SerializerUtils,0,0,0,0,0,0,0,0,0
druid-io_druid.org.apache.druid.common.utils.IdUtils,0,0,0,0,0,0,0,12,12
druid-io_druid.org.apache.druid.common.utils.IntArrayUtils,0,0,0,0,0,0,0,0,0
druid-io_druid.org.apache.druid.java.util.common.JodaUtils,0,0,0,0,0,0,0,0,0
druid-io_druid.org.apache.druid.common.utils.SocketUtil,1,0,0,0,0,0,0,0,1
druid-io_druid.org.apache.druid.common.utils.PropUtils,0,0,0,0,0,0,0,0,0
druid-io_druid.org.apache.druid.common.utils.ServletResourceUtils,1,0,0,0,0,0,0,0,1
druid-io_druid.org.apache.druid.common.exception.AllowedRegexErrorResponseTransformStrategy,0,0,0,0,0,0,0,0,0
druid-io_druid.org.apache.druid.common.config.JacksonConfigManager,2,0,0,0,0,0,0,1,3
druid-io_druid.org.apache.druid.common.config.ConfigManager,1,0,0,1,0,0,0,0,2
druid-io_druid.org.apache.druid.common.guava.GuavaUtils,1,0,0,0,0,0,0,0,1
druid-io_druid.org.apache.druid.timeline.partition.SingleDimensionRangeBucketShardSpec,0,0,0,0,0,0,0,0,0
druid-io_druid.org.apache.druid.timeline.partition.StringPartitionChunk,3,0,0,1,0,0,0,0,4
druid-io_druid.org.apache.druid.timeline.partition.NumberedPartialShardSpec,0,0,0,0,0,0,0,0,0
druid-io_druid.org.apache.druid.timeline.partition.BuildingSingleDimensionShardSpec,1,0,0,0,0,0,0,0,1
druid-io_druid.org.apache.druid.timeline.partition.OverwriteShardSpec,1,0,0,1,0,0,0,0,2
druid-io_druid.org.apache.druid.timeline.partition.BuildingNumberedShardSpec,0,0,0,0,0,0,0,0,0
druid-io_druid.org.apache.druid.timeline.partition.PartitionBoundaries,2,0,0,0,0,0,0,0,2
druid-io_druid.org.apache.druid.timeline.partition.HashBasedNumberedShardSpec,2,0,0,2,0,0,0,0,4
druid-io_druid.org.apache.druid.timeline.partition.PartitionChunk,2,0,0,2,0,0,0,0,4
druid-io_druid.org.apache.druid.timeline.partition.NumberedOverwritePartialShardSpec,0,0,0,0,0,0,0,0,0
druid-io_druid.org.apache.druid.timeline.partition.DimensionRangeBucketShardSpec,0,0,0,0,0,0,0,0,0
druid-io_druid.org.apache.druid.timeline.partition.SingleDimensionPartialShardSpec,0,0,0,0,0,0,0,0,0
druid-io_druid.org.apache.druid.timeline.partition.BuildingHashBasedNumberedShardSpec,0,0,0,0,0,0,0,0,0
druid-io_druid.org.apache.druid.timeline.partition.HashBucketShardSpec,0,0,0,0,0,0,0,0,0
druid-io_druid.org.apache.druid.timeline.partition.BuildingDimensionRangeShardSpec,0,0,0,0,0,0,0,0,0
druid-io_druid.org.apache.druid.timeline.partition.HashBasedNumberedPartialShardSpec,1,0,0,1,0,0,0,0,2
druid-io_druid.org.apache.druid.timeline.partition.TombstonePartitionedChunk,2,0,0,1,0,0,0,0,3
druid-io_druid.org.apache.druid.timeline.partition.TombstoneShardSpec,1,0,0,0,0,0,0,0,1
druid-io_druid.org.apache.druid.segment.column.ColumnTypeFactory,1,0,0,1,0,0,0,0,2
druid-io_druid.org.apache.druid.segment.column.BaseTypeSignature,7,0,0,5,0,0,0,1,13
druid-io_druid.org.apache.druid.segment.column.TypeStrategies,5,0,0,5,0,0,0,4,14
druid-io_druid.org.apache.druid.segment.column.ColumnType,0,0,0,0,0,0,0,1,1
druid-io_druid.org.apache.druid.segment.column.ColumnCapabilitiesImpl,1,0,0,1,0,0,0,32,34
druid-io_druid.org.apache.druid.segment.column.ColumnBuilder,0,0,0,0,0,0,0,0,0
druid-io_druid.org.apache.druid.query.cache.CacheKeyBuilder,4,0,0,4,0,0,0,2,10
druid-io_druid.org.apache.druid.concurrent.ConcurrentAwaitableCounter,1,0,0,1,0,1,0,0,3
druid-io_druid.org.apache.druid.concurrent.LifecycleLock,3,0,0,3,0,0,0,0,6
druid-io_druid.org.apache.druid.collections.StupidResourceHolder,0,0,0,0,0,0,0,0,0
druid-io_druid.org.apache.druid.collections.ResourceHolder,3,0,0,2,0,0,0,0,5
druid-io_druid.org.apache.druid.collections.CombiningIterator,0,0,0,0,0,0,0,0,0
druid-io_druid.org.apache.druid.collections.IntegerSet,3,0,0,3,0,0,0,0,6
druid-io_druid.org.apache.druid.collections.StupidPool,0,0,0,0,0,0,0,0,0
druid-io_druid.org.apache.druid.java.util.common.jackson.JacksonUtils,0,0,0,0,0,0,0,0,0
druid-io_druid.org.apache.druid.java.util.common.Either,4,0,0,4,0,0,0,0,8
druid-io_druid.org.apache.druid.extendedset.intset.ImmutableConciseSet,29,1,0,29,0,0,0,34,93
druid-io_druid.org.apache.druid.extendedset.intset.ConciseSet,1,0,0,1,0,0,0,24,26
druid-io_druid.org.apache.druid.testing.IntegrationTestingConfig,0,0,4,0,0,0,0,18,22
druid-io_druid.org.apache.druid.testing.utils.AbstractTestQueryHelper,1,0,0,0,0,1,0,2,4
druid-io_druid.org.apache.druid.testing.utils.ITRetryUtil,2,1,0,2,0,1,0,3,9
druid-io_druid.org.apache.druid.testing.utils.HttpUtil,0,0,0,0,0,0,0,5,5
druid-io_druid.org.apache.druid.testing.utils.StreamGenerator,0,0,0,0,0,1,0,1,2
druid-io_druid.org.apache.druid.server.coordinator.CoordinatorCompactionConfig,2,0,0,1,0,0,0,0,3
druid-io_druid.org.apache.druid.java.util.common.io.Closer,0,0,0,0,0,1,0,2,3
druid-io_druid.org.apache.druid.testing.utils.SqlTestQueryHelper,0,0,0,0,0,2,0,2,4
druid-io_druid.org.apache.druid.testing.utils.TestQueryHelper,1,0,0,1,0,0,0,0,2
druid-io_druid.org.apache.druid.sql.SqlLifecycleManager,8,0,0,6,0,0,0,0,14
druid-io_druid.org.apache.druid.sql.SqlRowTransformer,0,0,0,0,0,0,0,0,0
druid-io_druid.org.apache.druid.sql.SqlLifecycle,4,0,0,4,0,0,0,0,8
druid-io_druid.org.apache.druid.sql.calcite.schema.DruidSchema,20,0,0,18,0,0,0,1,39
druid-io_druid.org.apache.druid.sql.calcite.schema.NamedDruidSchema,0,0,0,0,0,0,0,0,0
druid-io_druid.org.apache.druid.sql.calcite.schema.RootSchemaProvider,1,0,0,1,0,0,0,0,2
druid-io_druid.org.apache.druid.sql.calcite.schema.NamedSystemSchema,0,0,0,0,0,0,0,0,0
druid-io_druid.org.apache.druid.sql.calcite.schema.DruidSchemaCatalog,1,0,0,0,0,0,0,0,1
druid-io_druid.org.apache.druid.sql.calcite.schema.NamedLookupSchema,0,0,0,0,0,0,0,0,0
druid-io_druid.org.apache.druid.sql.calcite.schema.SystemSchema,1,0,0,0,0,0,0,0,1
druid-io_druid.org.apache.druid.sql.calcite.schema.MetadataSegmentView,0,0,0,0,0,0,0,0,0
druid-io_druid.org.apache.druid.client.TimelineServerView,1,0,0,0,0,0,0,0,1
druid-io_druid.org.apache.druid.sql.calcite.external.ExternalTableScanRule,0,0,0,0,0,0,0,0,0
druid-io_druid.org.apache.druid.sql.calcite.expression.DruidExpression,0,0,0,0,0,0,0,11,11
druid-io_druid.org.apache.druid.sql.calcite.expression.builtin.RegexpExtractOperatorConversion,0,0,0,0,0,0,0,1,1
druid-io_druid.org.apache.druid.sql.calcite.expression.builtin.RegexpLikeOperatorConversion,0,0,0,0,0,0,0,2,2
druid-io_druid.org.apache.druid.sql.calcite.expression.builtin.StringFormatOperatorConversion,0,0,0,0,0,0,0,1,1
druid-io_druid.org.apache.druid.sql.calcite.expression.builtin.StrposOperatorConversion,0,0,0,0,0,0,0,1,1
druid-io_druid.org.apache.druid.sql.calcite.expression.builtin.ParseLongOperatorConversion,0,0,0,0,0,0,0,1,1
druid-io_druid.org.apache.druid.sql.calcite.expression.builtin.TruncateOperatorConversion,0,0,0,0,0,0,0,1,1
druid-io_druid.org.apache.druid.sql.calcite.expression.builtin.RoundOperatorConversion,0,0,0,0,0,0,0,5,5
druid-io_druid.org.apache.druid.sql.calcite.expression.builtin.DateTruncOperatorConversion,0,0,0,0,0,0,0,1,1
druid-io_druid.org.apache.druid.sql.calcite.expression.builtin.LPadOperatorConversion,0,0,0,0,0,0,0,1,1
druid-io_druid.org.apache.druid.sql.calcite.expression.SqlOperatorConversion,0,0,0,0,0,0,0,4,4
druid-io_druid.org.apache.druid.sql.calcite.expression.builtin.TimeFloorOperatorConversion,0,0,0,0,0,0,0,1,1
druid-io_druid.org.apache.druid.sql.calcite.expression.builtin.TimeCeilOperatorConversion,0,0,0,0,0,0,0,1,1
druid-io_druid.org.apache.druid.sql.calcite.expression.builtin.TimeShiftOperatorConversion,0,0,0,0,0,0,0,1,1
druid-io_druid.org.apache.druid.sql.calcite.expression.builtin.TimeExtractOperatorConversion,0,0,0,0,0,0,0,1,1
druid-io_druid.org.apache.druid.sql.calcite.expression.builtin.TimeParseOperatorConversion,0,0,0,0,0,0,0,1,1
druid-io_druid.org.apache.druid.sql.calcite.expression.builtin.TimeFormatOperatorConversion,0,0,0,0,0,0,0,1,1
druid-io_druid.org.apache.druid.sql.calcite.expression.DirectOperatorConversion,0,0,0,0,0,0,0,5,5
druid-io_druid.org.apache.druid.sql.calcite.expression.builtin.RightOperatorConversion,0,0,0,0,0,0,0,3,3
druid-io_druid.org.apache.druid.sql.calcite.expression.builtin.LeftOperatorConversion,0,0,0,0,0,0,0,3,3
druid-io_druid.org.apache.druid.sql.calcite.expression.builtin.RepeatOperatorConversion,0,0,0,0,0,0,0,2,2
druid-io_druid.org.apache.druid.sql.calcite.parser.DruidSqlParserImpl,0,0,0,0,0,0,0,0,0
druid-io_druid.org.apache.druid.sql.calcite.rel.DruidRels,17,0,0,17,0,0,0,0,34
druid-io_druid.org.apache.druid.sql.calcite.rel.DruidQuery,0,0,0,0,0,0,0,8,8
druid-io_druid.org.apache.druid.sql.calcite.filtration.Filtration,1,0,0,1,0,0,0,102,104
druid-io_druid.org.apache.druid.sql.calcite.rule.FilterJoinExcludePushToChildRule,1,0,0,0,0,0,0,0,1
druid-io_druid.org.apache.druid.sql.calcite.rule.DruidUnionDataSourceRule,0,0,0,0,0,0,0,0,0
druid-io_druid.org.apache.druid.sql.calcite.rule.DruidJoinRule,1,0,0,0,0,0,0,0,1
druid-io_druid.org.apache.druid.sql.calcite.planner.Calcites,2,0,0,0,0,0,0,0,2
druid-io_druid.org.apache.druid.sql.calcite.planner.OffsetLimit,0,0,0,0,0,0,0,0,0
druid-io_druid.org.apache.druid.sql.calcite.planner.DruidRexExecutor,5,0,0,4,0,0,0,0,9
druid-io_druid.org.apache.druid.sql.calcite.planner.PlannerContext,0,0,0,0,0,0,0,0,0
druid-io_druid.org.apache.druid.sql.http.SqlResource,7,0,0,7,0,0,0,0,14
druid-io_druid.org.apache.druid.sql.http.SqlQuery,3,0,0,3,0,0,0,0,6
druid-io_druid.org.apache.druid.sql.avatica.ErrorHandler,0,0,0,0,0,0,0,0,0
druid-io_druid.org.apache.druid.sql.avatica.DruidMeta,0,0,0,0,0,0,0,0,0
druid-io_druid.org.apache.druid.server.QueryStats,2,0,0,2,0,0,0,0,4
druid-io_druid.org.apache.druid.sql.avatica.AvaticaServerConfig,1,0,0,1,0,0,0,0,2
druid-io_druid.org.apache.druid.sql.avatica.DruidJdbcStatement,7,0,0,7,0,0,0,1,15
druid-io_druid.org.apache.druid.sql.avatica.AbstractDruidJdbcStatement,0,0,0,0,0,0,0,0,0
druid-io_druid.org.apache.druid.sql.avatica.DruidJdbcPreparedStatement,3,0,0,3,0,0,0,1,7
druid-io_druid.org.apache.druid.frame.write.FrameRowTooLargeException,0,0,0,0,0,0,0,0,0
druid-io_druid.org.apache.druid.frame.write.FrameWriters,4,0,0,4,0,0,0,0,8
druid-io_druid.org.apache.druid.frame.write.UnsupportedColumnTypeException,1,0,0,1,0,0,0,0,2
druid-io_druid.org.apache.druid.segment.serde.ComplexMetrics,4,0,0,3,0,0,0,0,7
druid-io_druid.org.apache.druid.frame.file.FrameFileHttpResponseHandler,6,0,0,6,0,0,0,0,12
druid-io_druid.org.apache.druid.frame.file.FrameFile,3,1,0,2,0,0,0,2,8
druid-io_druid.org.apache.druid.frame.read.FrameReader,0,0,0,0,0,0,0,0,0
druid-io_druid.org.apache.druid.frame.file.FrameFileWriter,1,0,0,1,0,1,0,0,3
druid-io_druid.org.apache.druid.frame.field.ComplexFieldReader,0,0,0,0,0,0,0,0,0
druid-io_druid.org.apache.druid.frame.field.StringFieldReader,6,0,0,6,0,0,0,0,12
druid-io_druid.org.apache.druid.frame.field.DoubleFieldReader,4,2,0,4,0,0,0,0,10
druid-io_druid.org.apache.druid.frame.field.FloatFieldReader,4,2,0,4,0,0,0,0,10
druid-io_druid.org.apache.druid.frame.field.LongFieldReader,4,2,0,4,0,0,0,0,10
druid-io_druid.org.apache.druid.frame.key.ClusterBy,0,0,0,0,0,0,0,0,0
druid-io_druid.org.apache.druid.frame.key.FrameComparisonWidgetImpl,1,0,0,1,0,0,0,0,2
druid-io_druid.org.apache.druid.frame.key.RowKeyReader,0,0,0,0,0,0,0,0,0
druid-io_druid.org.apache.druid.frame.processor.SuperSorterProgressTracker,4,0,0,1,0,0,0,0,5
druid-io_druid.org.apache.druid.frame.processor.SuperSorterProgressSnapshot,4,0,0,4,0,0,0,0,8
druid-io_druid.org.apache.druid.frame.processor.BlockingQueueOutputChannelFactory,2,0,0,2,0,0,0,0,4
druid-io_druid.org.apache.druid.frame.processor.ReturnOrAwait,1,0,0,1,0,0,0,0,2
druid-io_druid.org.apache.druid.frame.processor.FrameRowTooLargeException,0,0,0,0,0,0,0,0,0
druid-io_druid.org.apache.druid.frame.processor.OutputChannel,2,0,0,2,0,0,0,0,4
druid-io_druid.org.apache.druid.frame.channel.BlockingQueueFrameChannel,0,0,0,0,0,1,0,0,1
druid-io_druid.org.apache.druid.frame.processor.OutputChannels,3,0,0,3,0,0,0,0,6
druid-io_druid.org.apache.druid.frame.channel.ReadableConcatFrameChannel,0,0,0,0,0,0,0,0,0
druid-io_druid.org.apache.druid.frame.channel.ReadableInputStreamFrameChannel,6,0,0,5,0,0,0,0,11
druid-io_druid.org.apache.druid.segment.writeout.WriteOutBytes,0,0,0,0,0,0,0,1,1
druid-io_druid.org.apache.druid.segment.writeout.FileWriteOutBytes,4,0,0,3,0,1,0,1,9
druid-io_druid.org.apache.druid.segment.writeout.SegmentWriteOutMedium,3,0,0,3,0,0,0,0,6
druid-io_druid.org.apache.druid.segment.incremental.ParseExceptionHandler,3,0,0,2,0,1,0,0,6
druid-io_druid.org.apache.druid.segment.incremental.MutableRowIngestionMeters,0,0,0,0,0,0,0,0,0
druid-io_druid.org.apache.druid.segment.incremental.IncrementalIndexStorageAdapter,1,0,0,1,0,0,0,0,2
druid-io_druid.org.apache.druid.segment.incremental.IncrementalIndexAddResult,2,0,0,0,0,0,0,0,2
druid-io_druid.org.apache.druid.segment.vector.BitmapVectorOffset,1,1,0,1,0,0,0,2,5
druid-io_druid.org.apache.druid.collections.bitmap.WrappedRoaringBitmap,0,0,0,0,0,0,0,2,2
druid-io_druid.org.apache.druid.query.filter.ExpressionDimFilter,1,0,0,0,0,0,0,0,1
druid-io_druid.org.apache.druid.segment.filter.cnf.HiveCnfHelper,0,0,0,0,0,0,0,4,4
druid-io_druid.org.apache.druid.segment.filter.Filters,0,0,0,0,0,0,0,4,4
druid-io_druid.org.apache.druid.segment.filter.cnf.CalciteCnfHelper,0,0,0,0,0,0,0,2,2
druid-io_druid.org.apache.druid.segment.filter.TrueFilter,1,0,0,1,0,0,0,0,2
druid-io_druid.org.apache.druid.segment.filter.BoundFilter,1,0,0,1,0,0,0,0,2
druid-io_druid.org.apache.druid.segment.filter.ValueMatchers,2,0,0,2,0,0,0,0,4
druid-io_druid.org.apache.druid.segment.QueryableIndexStorageAdapter,1,0,0,1,0,0,0,0,2
druid-io_druid.org.apache.druid.query.dimension.DefaultDimensionSpec,2,1,0,1,0,0,0,0,4
druid-io_druid.org.apache.druid.segment.filter.PredicateValueMatcherFactory,1,1,0,1,0,0,0,0,3
druid-io_druid.org.apache.druid.query.filter.Filter,1,0,0,1,0,0,0,0,2
druid-io_druid.org.apache.druid.collections.bitmap.ImmutableBitmap,3,0,0,3,0,0,0,2,8
druid-io_druid.org.apache.druid.segment.data.ComparableList,4,0,0,0,0,0,0,0,4
druid-io_druid.org.apache.druid.segment.data.GenericIndexedWriter,0,0,0,0,0,0,0,1,1
druid-io_druid.org.apache.druid.segment.serde.Serializer,0,0,0,0,0,0,0,0,0
druid-io_druid.org.apache.druid.segment.data.IndexedInts,2,0,0,2,0,0,0,0,4
druid-io_druid.org.apache.druid.segment.data.CompressedColumnarIntsSupplier,2,1,0,2,0,0,0,0,5
druid-io_druid.org.apache.druid.segment.data.CompressedVSizeColumnarIntsSupplier,4,1,0,3,0,1,0,6,15
druid-io_druid.org.apache.druid.segment.data.ColumnarMultiInts,0,0,0,0,0,0,0,1,1
druid-io_druid.org.apache.druid.segment.data.FixedIndexed,3,0,0,3,0,0,0,0,6
druid-io_druid.org.apache.druid.segment.data.CompressedVSizeColumnarIntsSerializer,0,0,0,0,0,0,1,1,2
druid-io_druid.org.apache.druid.segment.data.ComparableStringArray,4,0,0,0,0,0,0,0,4
druid-io_druid.org.apache.druid.segment.data.ColumnCapacityExceededException,0,0,0,0,0,0,4,4,8
druid-io_druid.org.apache.druid.segment.column.LongsColumn,0,0,0,0,0,0,0,1,1
druid-io_druid.org.apache.druid.segment.column.FloatsColumn,0,0,0,0,0,0,0,1,1
druid-io_druid.org.apache.druid.segment.column.DoublesColumn,0,0,0,0,0,0,0,1,1
druid-io_druid.org.apache.druid.segment.data.VSizeColumnarMultiInts,0,0,0,0,0,0,0,0,0
druid-io_druid.org.apache.druid.segment.data.CompressedColumnarIntsSerializer,0,0,0,0,0,0,1,1,2
druid-io_druid.org.apache.druid.collections.bitmap.BitmapFactory,0,0,0,0,0,0,0,0,0
druid-io_druid.org.apache.druid.segment.data.VSizeColumnarInts,2,0,0,2,0,0,0,0,4
druid-io_druid.org.apache.druid.segment.data.BitmapSerde,1,0,0,0,0,0,0,0,1
druid-io_druid.org.apache.druid.segment.data.RoaringBitmapSerdeFactory,1,0,0,0,0,0,0,0,1
druid-io_druid.org.apache.druid.segment.data.ComparableIntArray,4,0,0,0,0,0,0,0,4
druid-io_druid.org.apache.druid.segment.join.table.IndexedTableJoinable,5,0,0,3,0,0,0,0,8
druid-io_druid.org.apache.druid.segment.join.table.RowBasedIndexBuilder,5,0,0,5,0,0,0,0,10
druid-io_druid.org.apache.druid.segment.join.table.BroadcastSegmentIndexedTable,0,0,0,0,0,0,0,2,2
druid-io_druid.org.apache.druid.segment.join.lookup.LookupJoinMatcher,4,0,0,4,0,0,0,0,8
druid-io_druid.org.apache.druid.segment.join.table.RowBasedIndexedTable,7,0,0,1,0,0,0,4,12
druid-io_druid.org.apache.druid.segment.join.lookup.LookupJoinable,2,0,0,0,0,0,1,0,3
druid-io_druid.org.apache.druid.segment.virtual.ListFilteredVirtualColumn,2,0,0,0,0,0,0,0,2
druid-io_druid.org.apache.druid.segment.virtual.ExpressionVirtualColumn,21,12,0,20,0,0,0,0,53
druid-io_druid.org.apache.druid.segment.virtual.ExpressionVectorValueSelector,3,0,0,3,0,0,0,0,6
druid-io_druid.org.apache.druid.segment.virtual.ExpressionSelectors,11,5,0,6,0,0,0,0,22
druid-io_druid.org.apache.druid.segment.virtual.VirtualizedColumnSelectorFactory,2,0,0,2,0,0,0,0,4
druid-io_druid.org.apache.druid.segment.ColumnSelector,2,0,0,2,0,0,0,0,4
druid-io_druid.org.apache.druid.segment.virtual.ExpressionVectorObjectSelector,0,0,0,0,0,0,0,0,0
druid-io_druid.org.apache.druid.segment.virtual.ExpressionPlan,6,0,0,5,0,0,0,0,11
druid-io_druid.org.apache.druid.segment.column.StringValueSetIndex,7,0,0,7,0,0,0,0,14
druid-io_druid.org.apache.druid.segment.column.LexicographicalRangeIndex,3,0,0,3,0,0,0,0,6
druid-io_druid.org.apache.druid.segment.column.DruidPredicateIndex,7,0,0,7,0,0,0,0,14
druid-io_druid.org.apache.druid.segment.column.NullValueIndex,4,0,0,4,0,0,0,0,8
druid-io_druid.org.apache.druid.segment.column.NumericRangeIndex,4,0,0,4,0,0,0,0,8
druid-io_druid.org.apache.druid.segment.column.DictionaryEncodedStringValueIndex,1,0,0,0,0,0,0,0,1
druid-io_druid.org.apache.druid.segment.nested.StructuredData,1,0,0,0,0,0,0,0,1
druid-io_druid.org.apache.druid.segment.nested.NestedPathFinder,3,0,0,3,0,0,0,10,16
druid-io_druid.org.apache.druid.segment.generator.DataGenerator,0,0,0,0,0,0,0,9,9
druid-io_druid.org.apache.druid.segment.generator.GeneratorSchemaInfo,1,0,0,1,0,0,0,0,2
druid-io_druid.org.apache.druid.segment.generator.RealRoundingDistribution,1,0,0,1,0,0,0,0,2
druid-io_druid.org.apache.druid.segment.serde.LargeColumnSupportedComplexColumnSerializer,0,0,0,0,0,0,0,0,0
druid-io_druid.org.apache.druid.segment.serde.DictionaryEncodedColumnPartSerde,1,0,0,1,0,0,0,0,2
druid-io_druid.org.apache.druid.segment.serde.NullColumnPartSerde,5,2,0,5,0,0,0,0,12
druid-io_druid.org.apache.druid.segment.transform.Transformer,9,0,0,8,0,0,1,0,18
druid-io_druid.org.apache.druid.segment.transform.TransformSpec,6,0,0,5,0,0,0,0,11
druid-io_druid.org.apache.druid.query.spec.QuerySegmentSpec,4,0,0,4,0,0,0,0,8
druid-io_druid.org.apache.druid.query.planning.PreJoinableClause,0,0,0,0,0,0,0,0,0
druid-io_druid.org.apache.druid.query.search.RegexSearchQuerySpec,1,0,0,0,0,0,0,0,1
druid-io_druid.org.apache.druid.query.search.SearchSortSpec,4,0,0,0,0,0,0,0,4
druid-io_druid.org.apache.druid.query.search.SearchBinaryFn,0,0,0,0,0,0,0,0,0
druid-io_druid.org.apache.druid.query.search.SearchHit,1,1,0,0,0,0,0,0,2
druid-io_druid.org.apache.druid.query.search.SearchQueryQueryToolChest,0,0,0,0,0,0,0,0,0
druid-io_druid.org.apache.druid.query.aggregation.constant.LongConstantAggregator,0,0,0,0,0,0,0,0,0
druid-io_druid.org.apache.druid.query.aggregation.constant.LongConstantBufferAggregator,0,0,0,0,0,0,0,0,0
druid-io_druid.org.apache.druid.query.aggregation.constant.LongConstantVectorAggregator,0,0,0,0,0,0,0,0,0
druid-io_druid.org.apache.druid.query.aggregation.last.DoubleLastAggregatorFactory,8,0,0,7,0,0,0,0,15
druid-io_druid.org.apache.druid.query.aggregation.last.FloatLastVectorAggregator,4,0,0,4,0,0,0,0,8
druid-io_druid.org.apache.druid.query.aggregation.last.DoubleLastVectorAggregator,4,0,0,4,0,0,0,0,8
druid-io_druid.org.apache.druid.query.aggregation.last.StringLastBufferAggregator,4,0,0,4,0,0,0,0,8
druid-io_druid.org.apache.druid.query.aggregation.last.LongLastAggregatorFactory,8,0,0,7,0,0,0,0,15
druid-io_druid.org.apache.druid.query.aggregation.last.StringLastVectorAggregator,4,0,0,4,0,0,0,0,8
druid-io_druid.org.apache.druid.query.aggregation.last.StringLastAggregatorFactory,1,0,0,1,0,0,0,0,2
druid-io_druid.org.apache.druid.query.aggregation.last.FloatLastAggregatorFactory,8,0,0,7,0,0,0,0,15
druid-io_druid.org.apache.druid.query.aggregation.last.LongLastVectorAggregator,4,0,0,4,0,0,0,0,8
druid-io_druid.org.apache.druid.query.aggregation.mean.DoubleMeanAggregatorFactory,3,0,0,3,0,0,0,0,6
druid-io_druid.org.apache.druid.segment.ColumnSelectorFactory,3,0,0,2,0,0,0,0,5
druid-io_druid.org.apache.druid.query.aggregation.cardinality.CardinalityAggregator,9,0,0,9,0,0,0,0,18
druid-io_druid.org.apache.druid.query.aggregation.post.DoubleGreatestPostAggregator,1,0,0,1,0,0,0,0,2
druid-io_druid.org.apache.druid.query.aggregation.post.LongGreatestPostAggregator,1,0,0,1,0,0,0,0,2
druid-io_druid.org.apache.druid.query.aggregation.post.DoubleLeastPostAggregator,1,0,0,1,0,0,0,0,2
druid-io_druid.org.apache.druid.query.aggregation.post.ConstantPostAggregator,2,0,0,1,0,0,0,0,3
druid-io_druid.org.apache.druid.query.aggregation.post.ExpressionPostAggregator,1,0,0,1,0,0,0,0,2
druid-io_druid.org.apache.druid.query.aggregation.post.ArithmeticPostAggregator,6,0,0,3,0,0,0,0,9
druid-io_druid.org.apache.druid.query.aggregation.post.JavaScriptPostAggregator,0,0,0,0,0,0,0,1,1
druid-io_druid.org.apache.druid.query.aggregation.post.LongLeastPostAggregator,1,0,0,1,0,0,0,0,2
druid-io_druid.org.apache.druid.query.aggregation.post.FinalizingFieldAccessPostAggregator,1,0,0,1,0,0,0,0,2
druid-io_druid.org.apache.druid.query.aggregation.post.FieldAccessPostAggregator,1,0,0,1,0,0,0,0,2
druid-io_druid.org.apache.druid.query.aggregation.any.LongAnyAggregatorFactory,8,0,0,5,0,0,0,0,13
druid-io_druid.org.apache.druid.query.aggregation.any.LongAnyVectorAggregator,3,0,0,0,0,0,0,0,3
druid-io_druid.org.apache.druid.query.aggregation.any.NumericAnyVectorAggregator,5,1,0,2,0,0,0,0,8
druid-io_druid.org.apache.druid.query.aggregation.any.StringAnyVectorAggregator,1,1,0,1,0,0,0,0,3
druid-io_druid.org.apache.druid.query.aggregation.any.DoubleAnyAggregatorFactory,8,0,0,5,0,0,0,0,13
druid-io_druid.org.apache.druid.query.aggregation.any.StringAnyAggregatorFactory,0,0,0,0,0,0,0,0,0
druid-io_druid.org.apache.druid.query.aggregation.any.FloatAnyAggregatorFactory,8,0,0,5,0,0,0,0,13
druid-io_druid.org.apache.druid.query.aggregation.any.DoubleAnyVectorAggregator,3,0,0,0,0,0,0,0,3
druid-io_druid.org.apache.druid.query.aggregation.any.StringAnyBufferAggregator,0,0,0,0,0,0,0,0,0
druid-io_druid.org.apache.druid.query.aggregation.any.FloatAnyVectorAggregator,3,0,0,0,0,0,0,0,3
druid-io_druid.org.apache.druid.query.aggregation.hyperloglog.HyperUniquesAggregatorFactory,3,0,0,3,0,0,0,0,6
druid-io_druid.org.apache.druid.query.aggregation.hyperloglog.HyperUniqueFinalizingPostAggregator,1,0,0,1,0,0,0,0,2
druid-io_druid.org.apache.druid.query.aggregation.first.DoubleFirstAggregatorFactory,9,0,0,7,0,0,0,0,16
druid-io_druid.org.apache.druid.query.aggregation.first.StringFirstBufferAggregator,4,0,0,4,0,0,0,0,8
druid-io_druid.org.apache.druid.query.aggregation.first.LongFirstAggregatorFactory,8,0,0,7,0,0,0,0,15
druid-io_druid.org.apache.druid.query.aggregation.first.FloatFirstAggregatorFactory,8,0,0,7,0,0,0,0,15
druid-io_druid.org.apache.druid.query.aggregation.first.StringFirstLastUtils,0,0,0,0,0,0,0,0,0
druid-io_druid.org.apache.druid.query.aggregation.first.StringFirstAggregatorFactory,0,0,0,0,0,0,0,0,0
druid-io_druid.org.apache.druid.query.extraction.RegexDimExtractionFn,1,0,0,1,0,0,0,0,2
druid-io_druid.org.apache.druid.query.extraction.SubstringDimExtractionFn,1,0,0,1,0,0,0,0,2
druid-io_druid.org.apache.druid.query.extraction.BucketExtractionFn,3,0,0,1,0,0,0,0,4
druid-io_druid.org.apache.druid.query.extraction.JavaScriptExtractionFn,2,0,0,2,0,0,0,0,4
druid-io_druid.org.apache.druid.query.extraction.SearchQuerySpecDimExtractionFn,1,0,0,1,0,0,0,0,2
druid-io_druid.org.apache.druid.query.extraction.MatchingDimExtractionFn,1,0,0,0,0,0,0,0,1
druid-io_druid.org.apache.druid.query.extraction.MapLookupExtractor,3,1,0,1,0,0,0,0,5
druid-io_druid.org.apache.druid.query.extraction.StringFormatExtractionFn,2,0,0,1,0,0,0,0,3
druid-io_druid.org.apache.druid.query.extraction.TimeFormatExtractionFn,6,0,0,3,0,0,0,0,9
druid-io_druid.org.apache.druid.query.extraction.StrlenExtractionFn,2,0,0,1,0,0,0,3,6
druid-io_druid.org.apache.druid.query.extraction.CascadeExtractionFn,5,0,0,1,0,0,0,0,6
druid-io_druid.org.apache.druid.query.extraction.TimeDimExtractionFn,3,0,0,1,0,0,0,0,4
druid-io_druid.org.apache.druid.query.filter.vector.VectorValueMatcherColumnProcessorFactory,8,3,0,8,0,0,0,0,19
druid-io_druid.org.apache.druid.query.filter.vector.VectorMatch,0,0,0,0,0,0,0,5,5
druid-io_druid.org.apache.druid.query.scan.ScanQueryLimitRowIterator,3,2,0,3,0,0,0,0,8
druid-io_druid.org.apache.druid.query.MetricsEmittingQueryRunner,1,0,0,1,0,0,0,0,2
druid-io_druid.org.apache.druid.query.context.DefaultResponseContext,1,0,0,1,0,1,0,0,3
druid-io_druid.org.apache.druid.query.scan.ScanQueryRunnerFactory,1,0,0,1,0,1,0,1,4
druid-io_druid.org.apache.druid.query.scan.ScanQuery,1,0,0,1,0,0,0,0,2
druid-io_druid.org.apache.druid.query.scan.ScanQueryQueryToolChest,0,0,0,0,0,0,0,0,0
druid-io_druid.org.apache.druid.segment.vector.VectorColumnSelectorFactory,1,0,0,1,0,0,0,0,2
druid-io_druid.org.apache.druid.query.scan.ScanQueryConfig,1,0,0,1,0,0,0,0,2
druid-io_druid.org.apache.druid.query.scan.ScanResultValue,1,0,0,1,0,0,0,0,2
druid-io_druid.org.apache.druid.query.scan.ScanResultValueTimestampComparator,0,0,0,0,0,0,0,0,0
druid-io_druid.org.apache.druid.query.timeboundary.TimeBoundaryQuery,0,0,0,0,0,0,0,0,0
druid-io_druid.org.apache.druid.query.timeboundary.TimeBoundaryQueryQueryToolChest,0,0,0,0,0,0,0,0,0
druid-io_druid.org.apache.druid.query.groupby.epinephelinae.ConcurrentGrouper,1,0,0,1,0,1,0,0,3
druid-io_druid.org.apache.druid.query.aggregation.CountAggregatorFactory,1,0,0,0,0,0,0,0,1
druid-io_druid.org.apache.druid.query.groupby.epinephelinae.HashVectorGrouper,4,0,0,4,0,0,0,1,9
druid-io_druid.org.apache.druid.query.groupby.epinephelinae.StreamingMergeSortedGrouper,0,0,0,0,0,0,0,1,1
druid-io_druid.org.apache.druid.query.groupby.epinephelinae.LimitedBufferHashGrouper,7,2,0,7,0,0,0,0,16
druid-io_druid.org.apache.druid.query.groupby.epinephelinae.GroupByQueryEngineV2,1,0,0,1,0,0,0,0,2
druid-io_druid.org.apache.druid.query.groupby.epinephelinae.ByteBufferMinMaxOffsetHeap,4,2,0,4,0,0,0,0,10
druid-io_druid.org.apache.druid.query.aggregation.AggregatorAdapters,1,0,0,1,0,0,0,0,2
druid-io_druid.org.apache.druid.query.groupby.epinephelinae.IntGrouper,0,0,0,0,0,0,0,0,0
druid-io_druid.org.apache.druid.query.groupby.epinephelinae.BufferArrayGrouper,0,0,0,0,0,0,0,0,0
druid-io_druid.org.apache.druid.query.groupby.epinephelinae.column.ArrayNumericGroupByColumnSelectorStrategy,2,0,0,0,0,0,0,0,2
druid-io_druid.org.apache.druid.segment.BaseObjectColumnValueSelector,6,0,0,6,0,0,0,0,12
druid-io_druid.org.apache.druid.query.groupby.epinephelinae.column.ArrayStringGroupByColumnSelectorStrategy,6,0,0,3,0,0,0,0,9
druid-io_druid.org.apache.druid.query.groupby.epinephelinae.column.StringGroupByColumnSelectorStrategy,4,0,0,1,0,0,0,0,5
druid-io_druid.org.apache.druid.query.groupby.epinephelinae.collection.HashTableUtils,2,0,0,0,0,0,0,0,2
druid-io_druid.org.apache.druid.query.groupby.epinephelinae.collection.MemoryOpenHashTable,3,1,0,2,0,0,0,0,6
druid-io_druid.org.apache.druid.query.groupby.having.DimensionSelectorHavingSpec,2,0,0,0,0,0,0,0,2
druid-io_druid.org.apache.druid.query.groupby.having.HavingSpecMetricComparator,4,0,0,0,0,0,0,0,4
druid-io_druid.org.apache.druid.query.groupby.having.DimFilterHavingSpec,2,0,0,2,0,0,0,0,4
druid-io_druid.org.apache.druid.query.groupby.having.GreaterThanHavingSpec,1,0,0,0,0,0,0,0,1
druid-io_druid.org.apache.druid.query.groupby.having.LessThanHavingSpec,1,0,0,0,0,0,0,0,1
druid-io_druid.org.apache.druid.query.groupby.having.EqualToHavingSpec,1,0,0,0,0,0,0,0,1
druid-io_druid.org.apache.druid.query.groupby.having.AndHavingSpec,1,0,0,0,0,0,0,0,1
druid-io_druid.org.apache.druid.query.groupby.having.OrHavingSpec,1,0,0,0,0,0,0,0,1
druid-io_druid.org.apache.druid.query.groupby.having.NotHavingSpec,1,0,0,0,0,0,0,0,1
druid-io_druid.org.apache.druid.query.groupby.GroupByQueryQueryToolChest,10,0,0,10,0,0,0,0,20
druid-io_druid.org.apache.druid.query.BaseQuery,0,0,0,0,0,0,0,0,0
druid-io_druid.org.apache.druid.query.groupby.DefaultGroupByQueryMetrics,1,0,0,1,0,0,0,0,2
druid-io_druid.org.apache.druid.query.groupby.ResultRow,1,0,0,1,0,0,0,0,2
druid-io_druid.org.apache.druid.query.groupby.GroupByQueryRunnerFactory,5,0,0,1,0,1,0,0,7
druid-io_druid.org.apache.druid.query.groupby.orderby.LimitSpec,1,0,0,1,0,0,0,0,2
druid-io_druid.org.apache.druid.query.groupby.orderby.DefaultLimitSpec,0,0,0,0,0,0,0,1,1
druid-io_druid.org.apache.druid.query.DefaultGenericQueryMetricsFactory,2,0,0,2,0,0,0,0,4
druid-io_druid.org.apache.druid.query.timeseries.TimeseriesBinaryFn,0,0,0,0,0,0,0,0,0
druid-io_druid.org.apache.druid.query.timeseries.DefaultTimeseriesQueryMetrics,1,0,0,1,0,0,0,0,2
druid-io_druid.org.apache.druid.query.timeseries.TimeseriesQueryQueryToolChest,3,0,0,3,0,0,0,0,6
druid-io_druid.org.apache.druid.query.topn.PooledTopNAlgorithm,0,0,0,0,0,0,0,2,2
druid-io_druid.org.apache.druid.query.topn.DefaultTopNQueryMetrics,1,0,0,1,0,0,0,0,2
druid-io_druid.org.apache.druid.query.topn.TopNBinaryFn,0,0,0,0,0,0,0,0,0
druid-io_druid.org.apache.druid.query.topn.DimValHolder,1,0,0,0,0,0,0,0,1
druid-io_druid.org.apache.druid.query.topn.TopNQuery,0,0,0,0,0,0,0,0,0
druid-io_druid.org.apache.druid.query.topn.TopNQueryQueryToolChest,2,0,0,2,0,0,0,0,4
druid-io_druid.org.apache.druid.query.monomorphicprocessing.StringRuntimeShape,0,0,0,0,0,0,0,0,0
druid-io_druid.org.apache.druid.query.metadata.metadata.SegmentAnalysis,6,0,0,1,0,0,0,0,7
druid-io_druid.org.apache.druid.query.metadata.metadata.SegmentMetadataQuery,4,0,0,4,0,0,0,0,8
druid-io_druid.org.apache.druid.query.metadata.SegmentAnalyzer,1,0,0,1,0,0,0,0,2
druid-io_druid.org.apache.druid.query.metadata.SegmentMetadataQueryQueryToolChest,1,0,0,1,0,0,0,0,2
druid-io_druid.org.apache.druid.query.metadata.metadata.ColumnAnalysis,7,0,0,6,0,0,0,0,13
druid-io_druid.org.apache.druid.collections.bitmap.ConciseBitmapFactory,0,0,0,0,0,0,0,0,0
druid-io_druid.org.apache.druid.collections.bitmap.RoaringBitmapFactory,0,0,0,0,0,0,0,0,0
druid-io_druid.org.apache.druid.collections.bitmap.WrappedBitSetBitmap,1,0,0,1,0,0,0,1,3
druid-io_druid.org.apache.druid.collections.bitmap.WrappedImmutableBitSetBitmap,0,0,0,0,0,0,0,0,0
druid-io_druid.org.apache.druid.collections.bitmap.WrappedConciseBitmap,0,0,0,0,0,0,0,1,1
druid-io_druid.org.apache.druid.collections.spatial.RTree,1,0,0,1,0,0,0,0,2
druid-io_druid.org.apache.druid.collections.spatial.ImmutableRTree,15,0,0,15,0,0,0,0,30
druid-io_druid.org.apache.druid.collections.spatial.search.RectangularBound,1,0,0,0,0,0,0,0,1
druid-io_druid.org.apache.druid.collections.spatial.search.RadiusBound,1,0,0,0,0,0,0,0,1
druid-io_druid.org.apache.druid.collections.spatial.search.PolygonBound,2,0,0,2,0,0,0,0,4
druid-io_druid.org.apache.druid.collections.spatial.Node,2,0,0,2,0,0,0,0,4
google_google-auth-library-java.com.google.auth.http.HttpCredentialsAdapter,1,0,0,1,0,0,0,0,2
google_google-auth-library-java.com.google.auth.oauth2.DownscopedCredentials,4,0,0,3,0,0,0,0,7
google_google-auth-library-java.com.google.auth.oauth2.ClientId,7,0,0,7,0,0,0,1,15
google_google-auth-library-java.com.google.auth.oauth2.JwtClaims,5,0,0,5,0,0,0,0,10
google_google-auth-library-java.com.google.auth.oauth2.ExternalAccountCredentials,12,0,0,12,0,0,0,5,29
google_google-auth-library-java.com.google.auth.oauth2.AwsCredentials,15,0,0,10,0,0,0,0,25
google_google-auth-library-java.com.google.auth.oauth2.IdTokenCredentials,1,0,0,1,0,0,0,0,2
google_google-auth-library-java.com.google.auth.oauth2.AppEngineCredentials,5,0,0,4,0,0,0,0,9
google_google-auth-library-java.com.google.auth.oauth2.OAuth2Credentials,15,0,0,14,0,5,0,0,34
google_google-auth-library-java.com.google.auth.oauth2.TokenVerifier,5,0,0,0,0,0,0,0,5
google_google-auth-library-java.com.google.auth.oauth2.OAuthException,12,0,0,12,0,0,0,0,24
google_google-auth-library-java.com.google.auth.oauth2.GoogleCredentials,9,0,0,9,0,0,0,0,18
google_google-auth-library-java.com.google.auth.oauth2.PluggableAuthCredentials,6,0,0,6,0,0,0,0,12
google_google-auth-library-java.com.google.auth.oauth2.ImpersonatedCredentials,21,0,0,16,0,0,0,0,37
google_google-auth-library-java.com.google.auth.oauth2.ExecutableResponse,5,0,0,5,0,0,0,0,10
google_google-auth-library-java.com.google.auth.oauth2.PluggableAuthException,8,0,0,0,0,0,0,0,8
google_google-auth-library-java.com.google.auth.oauth2.AccessToken,5,0,0,2,0,0,0,0,7
google_google-auth-library-java.com.google.auth.oauth2.ServiceAccountCredentials,36,0,0,34,0,0,0,3,73
google_google-auth-library-java.com.google.auth.oauth2.OAuth2CredentialsWithRefresh,1,0,0,1,0,0,0,1,3
google_google-auth-library-java.com.google.auth.oauth2.PluggableAuthHandler,6,1,0,3,0,0,0,0,10
google_google-auth-library-java.com.google.auth.oauth2.OAuth2Utils,2,0,0,2,0,0,0,0,4
google_google-auth-library-java.com.google.auth.oauth2.AwsRequestSigner,14,0,0,14,0,0,0,0,28
google_google-auth-library-java.com.google.auth.oauth2.CloudShellCredentials,4,0,0,4,0,1,0,0,9
google_google-auth-library-java.com.google.auth.oauth2.UserAuthorizer,8,0,0,8,0,0,0,0,16
google_google-auth-library-java.com.google.auth.oauth2.ServiceAccountJwtAccessCredentials,13,0,0,13,0,0,0,6,32
google_google-auth-library-java.com.google.auth.oauth2.JwtCredentials,1,0,0,1,0,0,0,6,8
google_google-auth-library-java.com.google.auth.oauth2.DefaultCredentialsProvider,6,0,0,4,0,0,0,0,10
google_google-auth-library-java.com.google.auth.oauth2.ComputeEngineCredentials,22,0,0,14,0,0,0,0,36
google_google-auth-library-java.com.google.auth.oauth2.IdentityPoolCredentials,6,0,0,4,0,0,0,0,10
google_google-auth-library-java.com.google.auth.oauth2.StsRequestHandler,6,0,0,6,0,0,0,0,12
google_google-auth-library-java.com.google.auth.oauth2.IdToken,4,0,0,4,0,0,0,0,8
google_google-auth-library-java.com.google.auth.oauth2.CredentialAccessBoundary,2,0,0,1,0,0,0,0,3
google_google-auth-library-java.com.google.auth.oauth2.UserCredentials,19,0,0,19,0,0,0,1,39
google_google-auth-library-java.com.google.auth.appengine.AppEngineCredentials,5,0,0,5,0,0,0,0,10
andrewgaul_modernizer-maven-plugin.org.gaul.modernizer_maven_plugin.Modernizer,6,0,0,6,0,0,0,0,12
andrewgaul_modernizer-maven-plugin.org.gaul.modernizer_maven_plugin.Utils,0,0,0,0,0,0,0,0,0
tiagobento_watertemplate-engine.org.watertemplate.Template,5,0,0,0,0,0,0,0,5
tiagobento_watertemplate-engine.org.watertemplate.interpreter.parser.TokenStream,2,0,0,1,0,0,0,2,5
tiagobento_watertemplate-engine.org.watertemplate.interpreter.parser.AbstractSyntaxTree,7,0,0,0,0,0,0,0,7
protostuff_protostuff.io.protostuff.LinkedBuffer,5,0,0,3,0,2,0,0,10
protostuff_protostuff.io.protostuff.Schema,1,0,0,0,0,0,0,3,4
protostuff_protostuff.io.protostuff.ByteString,1,0,0,1,0,0,0,0,2
protostuff_protostuff.io.protostuff.UnsignedNumberUtil,0,0,0,0,0,0,0,0,0
protostuff_protostuff.io.protostuff.ListAdapter,1,0,0,1,0,0,0,0,2
protostuff_protostuff.io.protostuff.LinkBuffer,4,0,0,4,0,0,0,0,8
protostuff_protostuff.io.protostuff.ProtobufOutput,12,0,0,0,0,0,0,0,12
protostuff_protostuff.io.protostuff.parser.Annotation,1,0,0,1,0,0,0,0,2
protostuff_protostuff.io.protostuff.parser.ProtoUtil,3,0,0,0,0,0,0,0,3
protostuff_protostuff.io.protostuff.parser.Field,1,0,0,0,0,0,0,0,1
protostuff_protostuff.io.protostuff.runtime.RuntimeSchema,18,0,0,12,0,0,0,0,30
protostuff_protostuff.io.protostuff.runtime.HasSchema,0,0,0,0,0,0,0,0,0
protostuff_protostuff.io.protostuff.compiler.Formatter,4,0,0,0,0,0,0,0,4
spotify_docker-client.com.spotify.docker.client.UnixConnectionSocketFactory,2,0,0,0,0,0,0,0,2
spotify_docker-client.com.spotify.docker.client.npipe.NpipeConnectionSocketFactory,2,0,0,1,0,0,0,0,3
spotify_docker-client.com.spotify.docker.client.DockerHost,8,0,0,8,0,0,0,0,16
spotify_docker-client.com.spotify.docker.client.ImageRef,4,0,0,3,0,0,0,0,7
spotify_docker-client.com.spotify.docker.client.CompressedDirectory,1,0,0,1,0,0,0,0,2
spotify_docker-client.com.spotify.docker.client.DefaultDockerClient,92,22,0,89,0,9,0,15,227
spotify_docker-client.com.spotify.docker.client.messages.HostConfig,5,0,0,5,0,0,0,0,10
spotify_docker-client.com.spotify.docker.client.messages.RegistryConfigs,1,0,0,1,0,0,0,0,2
spotify_docker-client.com.spotify.docker.client.messages.swarm.SwarmJoin,0,0,0,0,0,0,0,1,1
spotify_docker-client.com.spotify.docker.client.messages.swarm.TaskSpec,2,0,0,2,0,0,0,0,4
spotify_docker-client.com.spotify.docker.client.LogStream,0,0,0,0,0,0,0,0,0
spotify_docker-client.com.spotify.docker.client.messages.swarm.Preference,1,0,0,1,0,0,0,0,2
spotify_docker-client.com.spotify.docker.client.messages.swarm.ConfigSpec,1,0,0,1,0,0,0,0,2
spotify_docker-client.com.spotify.docker.client.DockerConfigReader,5,0,0,3,0,0,0,1,9
spotify_docker-client.com.spotify.docker.client.DockerCertificates,2,0,0,0,0,0,0,0,2
spotify_docker-client.com.spotify.docker.client.SystemCredentialHelperDelegate,0,0,0,0,0,0,0,0,0
spotify_docker-client.com.spotify.docker.client.DefaultLogStream,1,0,0,1,0,0,0,0,2
spotify_docker-client.com.spotify.docker.client.messages.ProgressMessage,3,0,0,1,0,0,0,0,4
spotify_docker-client.com.spotify.docker.client.LogMessage,0,0,0,0,0,0,0,2,2
spotify_docker-client.com.spotify.docker.client.messages.RegistryAuth,5,0,0,5,0,0,0,5,15
spotify_docker-client.com.spotify.docker.client.auth.RegistryAuthSupplier,0,0,0,0,0,0,0,0,0
spotify_docker-client.com.spotify.docker.client.auth.FixedRegistryAuthSupplier,1,0,0,1,0,0,0,0,2
spotify_docker-client.com.spotify.docker.client.auth.ConfigFileRegistryAuthSupplier,4,0,0,0,0,0,0,0,4
spotify_docker-client.com.spotify.docker.client.auth.gcr.ContainerRegistryAuthSupplier,3,0,0,3,0,0,0,1,7
spotify_docker-client.com.spotify.docker.client.messages.ContainerState,1,0,0,1,0,0,0,0,2
spotify_docker-client.com.spotify.docker.client.messages.ContainerConfig,1,0,0,1,0,0,0,0,2
spotify_docker-client.com.spotify.docker.client.messages.Container,0,0,0,0,0,0,0,0,0
spotify_docker-client.com.spotify.docker.client.messages.Info,1,0,0,0,0,0,0,0,1
spotify_docker-client.com.spotify.docker.client.messages.ImageInfo,0,0,0,0,0,0,0,0,0
spotify_docker-client.com.spotify.docker.client.messages.Event,0,0,0,0,0,0,0,0,0
spotify_docker-client.com.spotify.docker.client.messages.Ipam,2,0,0,2,0,0,0,0,4
spotify_docker-client.com.spotify.docker.client.messages.swarm.ServiceSpec,1,0,0,1,0,0,0,0,2
spotify_docker-client.com.spotify.docker.client.messages.swarm.Driver,2,0,0,2,0,0,0,0,4
spotify_docker-client.com.spotify.docker.client.messages.swarm.SwarmInit,1,0,0,1,0,0,0,0,2
spotify_docker-client.com.spotify.docker.client.messages.swarm.DnsConfig,2,0,0,2,0,0,0,0,4
spotify_docker-client.com.spotify.docker.client.messages.swarm.ContainerSpec,1,0,0,1,0,0,0,0,2
spotify_docker-client.com.spotify.docker.client.DockerClient,0,0,0,0,0,0,0,2,2
mjsax_aeolus.de.hub.cs.dbis.aeolus.testUtils.TestSpoutOutputCollector,0,0,0,0,0,0,0,0,0
mjsax_aeolus.de.hub.cs.dbis.aeolus.testUtils.TestOutputCollector,0,0,0,0,0,0,0,0,0
mjsax_aeolus.de.hub.cs.dbis.aeolus.testUtils.TestDeclarer,1,0,0,1,0,0,0,0,2
mjsax_aeolus.de.hub.cs.dbis.aeolus.testUtils.TimestampOrderChecker,2,0,0,2,0,0,0,6,10
mjsax_aeolus.de.hub.cs.dbis.aeolus.testUtils.ForwardBolt,3,0,0,3,0,0,0,2,8
mjsax_aeolus.de.hub.cs.dbis.aeolus.testUtils.ResultBolt,1,0,0,1,0,0,0,1,3
mjsax_aeolus.de.hub.cs.dbis.aeolus.testUtils.IncSpout,2,0,0,0,0,0,0,0,2
mjsax_aeolus.de.hub.cs.dbis.aeolus.testUtils.RandomSpout,6,0,0,3,0,0,0,0,9
mjsax_aeolus.de.hub.cs.dbis.aeolus.bolts.ForwardBolt,3,0,0,3,0,0,0,2,8
mjsax_aeolus.de.hub.cs.dbis.aeolus.utils.StreamMerger,0,0,0,0,0,0,0,0,0
mjsax_aeolus.de.hub.cs.dbis.aeolus.spouts.AbstractOrderedInputSpout,1,0,0,0,0,0,0,0,1
mjsax_aeolus.de.hub.cs.dbis.aeolus.spouts.DataDrivenStreamRateDriverCollector,0,0,0,0,0,0,0,2,2
mjsax_aeolus.de.hub.cs.dbis.aeolus.spouts.FixedStreamRateDriverSpout,1,0,0,0,0,0,0,0,1
mjsax_aeolus.de.hub.cs.dbis.aeolus.spouts.DataDrivenStreamRateDriverSpout,1,0,0,0,0,0,0,0,1
mjsax_aeolus.de.hub.cs.dbis.aeolus.sinks.FileSinkBolt,1,0,0,0,0,0,0,3,4
mjsax_aeolus.de.hub.cs.dbis.lrb.operators.AccidentDetectionBolt,3,0,0,1,0,0,0,0,4
mjsax_aeolus.de.hub.cs.dbis.lrb.operators.AccidentNotificationBolt,2,0,0,1,0,0,0,0,3
mjsax_aeolus.de.hub.cs.dbis.lrb.operators.TollNotificationBolt,2,1,0,1,0,1,0,0,5
mjsax_aeolus.de.hub.cs.dbis.lrb.operators.CountVehiclesBolt,1,0,0,1,0,0,0,0,2
mjsax_aeolus.de.hub.cs.dbis.lrb.operators.AverageSpeedBolt,3,0,0,1,0,0,0,0,4
mjsax_aeolus.de.hub.cs.dbis.lrb.operators.StoppedCarsBolt,1,0,0,1,0,0,0,0,2
mjsax_aeolus.de.hub.cs.dbis.lrb.operators.DispatcherBolt,2,0,0,1,0,0,0,0,3
mjsax_aeolus.de.hub.cs.dbis.lrb.operators.LatestAverageVelocityBolt,2,0,0,1,0,0,0,0,3
mjsax_aeolus.de.hub.cs.dbis.lrb.operators.AverageVehicleSpeedBolt,2,1,0,1,0,0,0,0,4
mjsax_aeolus.de.hub.cs.dbis.lrb.operators.FileReaderSpout,2,0,0,1,0,0,0,0,3
mjsax_aeolus.storm.lrb.bolt.DailyExpenditureBolt,1,0,0,1,0,0,1,0,3
mjsax_aeolus.storm.lrb.bolt.AccountBalanceBolt,1,0,0,1,0,0,1,0,3
mjsax_aeolus.storm.lrb.LRBTopologyMain,0,0,0,0,0,0,1,1,2
mjsax_aeolus.de.hub.cs.dbis.aeolus.monitoring.utils.AeolusConfig,0,0,0,0,0,0,0,0,0
mjsax_aeolus.de.hub.cs.dbis.aeolus.monitoring.utils.ConfigReader,4,0,0,4,0,0,0,0,8
mjsax_aeolus.de.hub.cs.dbis.aeolus.batching.BatchOutputCollector,0,0,0,0,0,0,0,13,13
mjsax_aeolus.de.hub.cs.dbis.aeolus.batching.BoltBatchCollectorImpl,0,0,0,0,0,0,0,2,2
mjsax_aeolus.de.hub.cs.dbis.aeolus.batching.Batch,1,1,0,1,0,0,0,0,3
mjsax_aeolus.de.hub.cs.dbis.aeolus.batching.BatchSpoutOutputCollector,0,0,0,0,0,0,0,7,7
mjsax_aeolus.de.hub.cs.dbis.aeolus.batching.BatchColumn,0,0,0,0,0,0,0,0,0
mjsax_aeolus.de.hub.cs.dbis.aeolus.batching.SpoutBatchCollectorImpl,0,0,0,0,0,0,0,0,0
mjsax_aeolus.de.hub.cs.dbis.aeolus.batching.BatchingOutputFieldsDeclarer,4,0,0,0,0,0,0,0,4
mjsax_aeolus.de.hub.cs.dbis.aeolus.batching.AbstractBatchCollector,0,0,0,0,0,0,0,1,1
mjsax_aeolus.de.hub.cs.dbis.aeolus.batching.SingleBatchSizeHashMap,0,0,0,0,0,0,0,1,1
mjsax_aeolus.de.hub.cs.dbis.aeolus.batching.api.InputDebatcher,0,0,0,0,0,0,0,4,4
mjsax_aeolus.de.hub.cs.dbis.aeolus.batching.api.BoltOutputBatcher,0,0,0,0,0,0,0,5,5
mjsax_aeolus.de.hub.cs.dbis.aeolus.batching.api.AeolusBuilder,0,0,0,0,0,0,0,0,0
mjsax_aeolus.de.hub.cs.dbis.aeolus.batching.api.SpoutOutputBatcher,0,0,0,0,0,0,0,7,7
pac4j_play-pac4j.org.pac4j.play.PlayWebContext,0,0,0,0,0,0,0,2,2
pac4j_play-pac4j.org.pac4j.play.store.PlayCacheSessionStore,0,0,0,0,0,0,0,0,0
pac4j_play-pac4j.org.pac4j.play.store.ShiroAesDataEncrypter,1,0,0,1,0,0,0,0,2
Eldelshell_jongo.amforeas.RestController,1,0,0,1,0,1,0,8,11
Eldelshell_jongo.amforeas.jdbc.JDBCExecutor,7,0,0,7,0,1,0,0,15
Eldelshell_jongo.amforeas.rest.xstream.Pagination,7,0,0,7,0,0,0,0,14
Eldelshell_jongo.amforeas.jdbc.OrderParam,3,0,0,2,0,0,0,0,5
Eldelshell_jongo.amforeas.jdbc.LimitParam,4,0,0,1,0,0,0,1,6
Eldelshell_jongo.amforeas.jdbc.StoredProcedureParam,1,0,0,0,0,0,0,0,1
Eldelshell_jongo.amforeas.DefaultRestService,3,0,0,3,0,0,0,0,6
Eldelshell_jongo.amforeas.AmforeasUtils,10,0,0,1,0,4,0,3,18
Eldelshell_jongo.amforeas.PerformanceLogger,1,0,0,1,0,0,0,0,2
Eldelshell_jongo.amforeas.config.AmforeasConfiguration,5,0,0,5,0,0,0,0,10
Eldelshell_jongo.amforeas.config.AmforeasProperties,10,0,0,10,0,0,0,0,20
Eldelshell_jongo.amforeas.acl.ACLRule,1,0,0,1,0,0,0,0,2
Eldelshell_jongo.amforeas.acl.ACLManager,12,0,0,0,0,0,0,0,12
Eldelshell_jongo.amforeas.sql.Select,2,0,0,2,0,0,0,18,22
Eldelshell_jongo.amforeas.sql.Delete,0,0,0,0,0,0,0,2,2
Eldelshell_jongo.amforeas.sql.Insert,0,0,0,0,0,0,0,1,1
Eldelshell_jongo.amforeas.sql.Update,0,0,0,0,0,0,0,2,2
Eldelshell_jongo.amforeas.sql.dialect.Dialect,0,0,0,0,0,0,0,0,0
Eldelshell_jongo.amforeas.sql.dialect.SQLDialect,1,0,0,1,0,0,0,0,2
Eldelshell_jongo.amforeas.sql.Table,1,0,0,0,0,0,0,0,1
Eldelshell_jongo.amforeas.sql.SelectParam,1,0,0,1,0,0,0,0,2
Eldelshell_jongo.amforeas.client.RequestParams,4,0,0,4,0,0,0,0,8
imagej_imagej-ops.net.imagej.ops.OpInfo,0,0,0,0,0,0,0,0,0
imagej_imagej-ops.net.imagej.ops.topology.BoxCount,2,0,0,0,0,0,0,0,2
imagej_imagej-ops.net.imagej.ops.convert.Types,206,0,0,1,0,0,0,0,207
imagej_imagej-ops.net.imagej.ops.coloc.pValue.PValueResult,0,0,0,0,0,0,0,0,0
imagej_imagej-ops.net.imagej.ops.coloc.MergeSort,2,0,0,2,0,0,0,0,4
imagej_imagej-ops.net.imagej.ops.geom.GeomUtils,5,0,0,0,0,0,0,0,5
OpenNMS_newts.org.opennms.newts.rest.HttpBasicAuthenticationFilter,0,0,0,0,0,0,0,3,3
OpenNMS_newts.org.opennms.newts.rest.SamplesResource,0,0,0,0,0,0,0,0,0
OpenNMS_newts.org.opennms.newts.api.Timestamp,4,0,0,4,0,0,0,0,8
OpenNMS_newts.org.opennms.newts.rest.MeasurementsResource,1,0,0,1,0,0,0,0,2
OpenNMS_newts.org.opennms.newts.api.search.SearchResults,0,0,0,0,0,0,0,0,0
OpenNMS_newts.org.opennms.newts.api.Duration,11,0,0,11,0,0,0,0,22
OpenNMS_newts.org.opennms.newts.gsod.FileIterable,0,0,0,0,0,0,0,2,2
OpenNMS_newts.org.opennms.newts.gsod.FileObservable,0,0,0,0,0,0,0,0,0
OpenNMS_newts.org.opennms.newts.cassandra.NewtsInstance,4,0,0,4,0,0,0,0,8
OpenNMS_newts.org.opennms.newts.cassandra.search.ResourceMetadataCache,2,0,0,2,0,0,0,1,5
OpenNMS_newts.org.opennms.newts.cassandra.search.EscapableResourceIdSplitter,3,0,0,1,0,0,0,0,4
OpenNMS_newts.org.opennms.newts.cassandra.CassandraSession,0,0,0,0,0,0,0,1,1
OpenNMS_newts.org.opennms.newts.cassandra.search.SimpleResourceIdSplitter,2,0,0,0,0,0,0,0,2
OpenNMS_newts.org.opennms.newts.cassandra.search.CassandraIndexer,0,0,0,0,0,0,0,1,1
OpenNMS_newts.org.opennms.newts.api.Counter,0,0,0,0,0,0,0,0,0
OpenNMS_newts.org.opennms.newts.api.Absolute,0,0,0,0,0,0,0,0,0
OpenNMS_newts.org.opennms.newts.api.Derive,0,0,0,0,0,0,0,0,0
OpenNMS_newts.org.opennms.newts.api.ValueType,4,0,0,4,0,0,0,0,8
OpenNMS_newts.org.opennms.newts.api.query.AggregationFunction,0,0,0,0,0,0,0,0,0
OpenNMS_newts.org.opennms.newts.api.query.ResultDescriptor,7,0,0,7,0,0,0,0,14
OpenNMS_newts.org.opennms.newts.aggregate.ResultProcessor,0,0,0,0,0,0,0,0,0
OpenNMS_newts.org.opennms.newts.aggregate.Rate,2,1,0,2,0,0,0,0,5
OpenNMS_newts.org.opennms.newts.api.search.BooleanQuery,2,0,0,0,0,0,0,0,2
OpenNMS_newts.org.opennms.newts.graphite.GraphiteHandler,1,0,0,1,0,0,0,0,2
wendykierp_JTransforms.org.jtransforms.dht.FloatDHT_1D,0,0,0,0,0,0,0,0,0
wendykierp_JTransforms.org.jtransforms.dht.FloatDHT_2D,0,0,0,0,0,0,0,0,0
wendykierp_JTransforms.org.jtransforms.dht.DoubleDHT_1D,0,0,0,0,0,0,0,0,0
wendykierp_JTransforms.org.jtransforms.dht.FloatDHT_3D,0,0,0,0,0,0,0,0,0
wendykierp_JTransforms.org.jtransforms.dht.DoubleDHT_2D,0,0,0,0,0,0,0,0,0
wendykierp_JTransforms.org.jtransforms.dht.DoubleDHT_3D,0,0,0,0,0,0,0,0,0
wendykierp_JTransforms.org.jtransforms.dst.FloatDST_2D,0,0,0,0,0,0,0,0,0
wendykierp_JTransforms.org.jtransforms.dst.DoubleDST_2D,0,0,0,0,0,0,0,0,0
wendykierp_JTransforms.org.jtransforms.dst.DoubleDST_1D,0,0,0,0,0,0,0,0,0
wendykierp_JTransforms.org.jtransforms.dst.FloatDST_3D,0,0,0,0,0,0,0,0,0
wendykierp_JTransforms.org.jtransforms.dst.DoubleDST_3D,0,0,0,0,0,0,0,0,0
wendykierp_JTransforms.org.jtransforms.dst.FloatDST_1D,0,0,0,0,0,0,0,0,0
wendykierp_JTransforms.org.jtransforms.fft.FloatFFT_3D,0,0,0,0,0,0,0,0,0
wendykierp_JTransforms.org.jtransforms.utils.CommonUtils,0,0,0,0,0,0,0,0,0
wendykierp_JTransforms.org.jtransforms.fft.DoubleFFT_1D,0,0,0,0,0,0,0,0,0
wendykierp_JTransforms.org.jtransforms.fft.DoubleFFT_3D,0,0,0,0,0,0,0,0,0
wendykierp_JTransforms.org.jtransforms.fft.RealFFTUtils_2D,0,0,0,0,0,0,0,0,0
wendykierp_JTransforms.org.jtransforms.fft.FloatFFT_2D,0,0,0,0,0,0,0,0,0
wendykierp_JTransforms.org.jtransforms.fft.RealFFTUtils_3D,0,0,0,0,0,0,0,0,0
wendykierp_JTransforms.org.jtransforms.fft.FloatFFT_1D,0,0,0,0,0,0,0,0,0
wendykierp_JTransforms.org.jtransforms.fft.DoubleFFT_2D,0,0,0,0,0,0,0,0,0
wendykierp_JTransforms.org.jtransforms.dct.DoubleDCT_3D,0,0,0,0,0,0,0,0,0
wendykierp_JTransforms.org.jtransforms.dct.FloatDCT_1D,0,0,0,0,0,0,0,0,0
wendykierp_JTransforms.org.jtransforms.dct.FloatDCT_2D,0,0,0,0,0,0,0,0,0
wendykierp_JTransforms.org.jtransforms.dct.FloatDCT_3D,0,0,0,0,0,0,0,0,0
wendykierp_JTransforms.org.jtransforms.dct.DoubleDCT_1D,0,0,0,0,0,0,0,0,0
wendykierp_JTransforms.org.jtransforms.dct.DoubleDCT_2D,0,0,0,0,0,0,0,0,0
blockchain_api-v1-client-java.info.blockchain.api.blockexplorer.BlockExplorer,4,0,0,4,0,0,0,0,8
clinejj_foursquare-api-java.fi.foyt.foursquare.api.FoursquareApi,39,0,0,39,0,0,0,2,80
clinejj_foursquare-api-java.fi.foyt.foursquare.api.Result,13,0,0,13,0,0,0,0,26
sdstoehr_har-reader.de.sstoehr.harreader.HarReader,0,0,0,0,0,0,0,0,0
sdstoehr_har-reader.de.sstoehr.harreader.model.HarRequest,0,0,0,0,0,0,0,0,0
sdstoehr_har-reader.de.sstoehr.harreader.model.Har,0,0,0,0,0,0,0,0,0
sdstoehr_har-reader.de.sstoehr.harreader.model.HarEntry,0,0,0,0,0,0,0,0,0
sdstoehr_har-reader.de.sstoehr.harreader.model.HarPostData,0,0,0,0,0,0,0,0,0
sdstoehr_har-reader.de.sstoehr.harreader.model.HarPage,0,0,0,0,0,0,0,0,0
sdstoehr_har-reader.de.sstoehr.harreader.model.HarResponse,0,0,0,0,0,0,0,0,0
sdstoehr_har-reader.de.sstoehr.harreader.model.HarPageTiming,2,0,0,2,0,0,0,0,4
sdstoehr_har-reader.de.sstoehr.harreader.model.HarLog,3,0,0,3,0,0,0,0,6
sdstoehr_har-reader.de.sstoehr.harreader.model.HarTiming,0,0,0,0,0,0,0,0,0
ehcache_sizeof.org.ehcache.sizeof.SizeOf,1,1,0,0,0,0,0,0,2
ehcache_sizeof.org.ehcache.sizeof.Configuration,2,0,0,2,0,0,0,0,4
ehcache_sizeof.org.ehcache.sizeof.SizeOfFilterSource,2,0,0,1,0,0,0,0,3
ehcache_sizeof.org.ehcache.sizeof.impl.AgentLoader,2,0,0,2,0,0,0,0,4
ehcache_sizeof.org.ehcache.sizeof.filters.TypeFilter,2,0,0,2,0,0,0,0,4
benas_easy-batch.org.jeasy.batch.xml.XmlFileRecordReader,1,0,0,1,0,0,0,0,2
benas_easy-batch.org.jeasy.batch.core.job.JobExecutor,18,0,0,14,0,0,0,3,35
benas_easy-batch.org.jeasy.batch.core.record.GenericRecord,15,0,0,11,0,0,0,10,36
benas_easy-batch.org.jeasy.batch.xml.XmlRecordCompactor,0,0,0,0,0,0,0,0,0
benas_easy-batch.org.jeasy.batch.xml.XmlRecordReader,4,0,0,4,0,0,0,0,8
benas_easy-batch.org.jeasy.batch.core.job.JobBuilder,12,0,0,12,0,0,2,5,31
benas_easy-batch.org.jeasy.batch.jms.JmsRecordWriter,0,0,0,0,0,0,0,1,1
benas_easy-batch.org.jeasy.batch.jms.JmsRecordReader,1,0,0,1,0,0,0,1,3
benas_easy-batch.org.jeasy.batch.jms.JmsMessageTransformer,1,0,0,1,0,0,0,0,2
benas_easy-batch.org.jeasy.batch.json.JsonRecordReader,1,0,0,1,0,0,0,0,2
benas_easy-batch.org.jeasy.batch.json.JsonFileRecordReader,1,0,0,1,0,0,0,0,2
benas_easy-batch.org.jeasy.batch.json.JsonRecordMapper,3,0,0,3,0,0,0,0,6
benas_easy-batch.org.jeasy.batch.json.JsonRecordCompactor,0,0,0,0,0,0,0,0,0
benas_easy-batch.org.jeasy.batch.core.filter.StartsWithStringRecordFilter,2,0,0,2,0,0,0,0,4
benas_easy-batch.org.jeasy.batch.core.filter.GrepFilter,0,0,0,0,0,0,0,0,0
benas_easy-batch.org.jeasy.batch.core.filter.FileExtensionFilter,0,0,0,0,0,0,0,0,0
benas_easy-batch.org.jeasy.batch.core.filter.FilteredRecordsCollector,0,0,0,0,0,0,0,0,0
benas_easy-batch.org.jeasy.batch.core.filter.EmptyStringRecordFilter,0,0,0,0,0,0,0,0,0
benas_easy-batch.org.jeasy.batch.core.filter.EndsWithStringRecordFilter,2,0,0,2,0,0,0,0,4
benas_easy-batch.org.jeasy.batch.core.record.Header,0,0,0,0,0,0,0,0,0
benas_easy-batch.org.jeasy.batch.core.job.JobMetrics,6,0,0,6,0,0,0,0,12
benas_easy-batch.org.jeasy.batch.core.job.Job,6,0,0,6,0,0,0,10,22
benas_easy-batch.org.jeasy.batch.core.reader.RecordReader,2,0,0,2,0,0,0,6,10
benas_easy-batch.org.jeasy.batch.core.record.Batch,1,0,0,1,0,1,0,0,3
benas_easy-batch.org.jeasy.batch.core.job.JobReport,1,0,0,1,0,0,0,0,2
benas_easy-batch.org.jeasy.batch.core.util.Utils,3,0,0,0,0,0,0,0,3
benas_easy-batch.org.jeasy.batch.core.listener.CompositeBatchListener,0,0,0,0,0,0,0,1,1
benas_easy-batch.org.jeasy.batch.core.listener.CompositeRecordReaderListener,0,0,0,0,0,0,0,2,2
benas_easy-batch.org.jeasy.batch.core.listener.CompositeJobListener,0,0,0,0,0,0,0,2,2
benas_easy-batch.org.jeasy.batch.core.processor.RecordCollector,0,0,0,0,0,0,0,0,0
benas_easy-batch.org.jeasy.batch.core.reader.BlockingQueueRecordReader,1,0,0,0,0,0,0,0,1
benas_easy-batch.org.jeasy.batch.core.reader.IterableRecordReader,1,0,0,1,0,0,0,0,2
benas_easy-batch.org.jeasy.batch.core.reader.StreamRecordReader,1,0,0,1,0,0,0,0,2
benas_easy-batch.org.jeasy.batch.core.reader.FileRecordReader,2,0,0,2,0,0,0,0,4
benas_easy-batch.org.jeasy.batch.core.reader.StringRecordReader,1,0,0,1,0,0,0,0,2
benas_easy-batch.org.jeasy.batch.core.writer.FileRecordWriter,0,0,0,0,0,0,0,0,0
benas_easy-batch.org.jeasy.batch.core.writer.CompositeRecordWriter,0,0,0,0,0,0,0,2,2
benas_easy-batch.org.jeasy.batch.core.converter.BooleanTypeConverter,2,0,0,0,0,0,0,0,2
benas_easy-batch.org.jeasy.batch.flatfile.FlatFileRecordReader,1,0,0,1,0,0,0,0,2
benas_easy-batch.org.jeasy.batch.test.common.Tweet,2,0,0,2,0,0,0,0,4
benas_easy-batch.org.jeasy.batch.jdbc.JdbcRecordMapper,0,0,0,0,0,0,0,0,0
benas_easy-batch.org.jeasy.batch.jdbc.JdbcRecordReader,2,0,0,2,0,0,0,0,4
benas_easy-batch.org.jeasy.batch.extensions.apache.common.csv.ApacheCommonCsvRecordMarshaller,0,0,0,0,0,0,0,0,0
benas_easy-batch.org.jeasy.batch.extensions.yaml.YamlRecordReader,1,0,0,1,0,0,0,0,2
benas_easy-batch.org.jeasy.batch.extensions.yaml.YamlFileRecordReader,1,0,0,1,0,0,0,0,2
benas_easy-batch.org.jeasy.batch.extensions.spring.JobFactoryBean,0,0,0,0,0,0,0,0,0
benas_easy-batch.org.jeasy.batch.extensions.spring.SpringJdbcRecordMapper,1,0,0,1,0,0,0,0,2
benas_easy-batch.org.jeasy.batch.extensions.gson.GsonRecordMapper,3,0,0,3,0,0,0,0,6
benas_easy-batch.org.jeasy.batch.extensions.jackson.JacksonRecordMapper,3,0,0,3,0,0,0,0,6
kaazing_gateway.org.kaazing.gateway.resource.address.uri.URIUtils,3,1,0,2,0,0,0,7,13
kaazing_gateway.org.kaazing.gateway.resource.address.URLUtils,0,0,0,0,0,0,0,0,0
kaazing_gateway.org.kaazing.gateway.resource.address.ResourceAddressFactory,26,2,0,25,0,1,0,12,66
kaazing_gateway.org.kaazing.test.util.LoggingRule,0,0,0,0,0,0,2,29,31
kaazing_gateway.org.kaazing.mina.core.session.DummySessionEx,95,0,0,96,0,8,0,6,205
kaazing_gateway.org.apache.mina.core.future.DefaultConnectFuture,3,0,0,3,0,2,0,0,8
kaazing_gateway.org.apache.mina.core.session.DummySession,1,0,0,1,0,0,0,7,9
kaazing_gateway.org.kaazing.test.util.MemoryAppender,1,0,0,0,0,0,0,4,5
kaazing_gateway.org.kaazing.gateway.resource.address.ResourceAddress,15,0,0,9,0,0,0,0,24
kaazing_gateway.org.kaazing.gateway.resource.address.Comparators,1,0,0,0,0,1,0,1,3
kaazing_gateway.org.kaazing.gateway.resource.address.ResolutionUtils,0,0,0,0,0,0,0,0,0
kaazing_gateway.org.kaazing.mina.core.session.AbstractIoSessionEx,0,0,0,2,0,0,0,0,2
kaazing_gateway.org.kaazing.mina.core.buffer.IoBufferAllocatorEx,0,0,0,0,0,0,0,1,1
kaazing_gateway.org.apache.mina.core.service.IoService,2,0,0,2,0,1,0,0,5
kaazing_gateway.org.kaazing.mina.util.ExceptionMonitor,0,0,0,0,0,0,0,1,1
kaazing_gateway.org.apache.mina.util.ExceptionMonitor,1,0,0,1,0,0,0,0,2
kaazing_gateway.org.kaazing.mina.core.service.AbstractIoService,4,0,0,4,0,0,0,1,9
kaazing_gateway.org.kaazing.mina.netty.ChannelIoAcceptor,4,0,0,4,0,0,0,0,8
kaazing_gateway.org.apache.mina.core.filterchain.DefaultIoFilterChainBuilder,3,1,0,3,0,0,0,6,13
kaazing_gateway.org.kaazing.mina.netty.socket.nio.NioSocketChannelIoSessionConfig,1,0,0,1,0,0,0,0,2
kaazing_gateway.org.kaazing.mina.netty.socket.nio.DefaultNioSocketChannelIoSessionConfig,1,0,0,1,0,0,2,0,4
kaazing_gateway.org.kaazing.mina.netty.socket.nio.NioSocketChannelIoAcceptor,0,0,0,0,0,0,0,0,0
kaazing_gateway.org.kaazing.mina.netty.socket.nio.NioSocketChannelIoConnector,0,0,0,0,0,0,0,0,0
kaazing_gateway.org.apache.mina.core.service.AbstractIoService,0,0,0,0,0,0,0,2,2
kaazing_gateway.org.kaazing.mina.core.buffer.AbstractIoBufferAllocatorEx,0,0,0,0,0,0,2,2,4
kaazing_gateway.org.apache.mina.util.Base64,15,0,0,0,0,4,0,0,19
kaazing_gateway.org.apache.mina.filter.codec.CumulativeProtocolDecoder,3,0,0,3,0,0,0,0,6
kaazing_gateway.org.apache.mina.filter.reqres.RequestResponseFilter,1,0,0,1,0,0,0,2,4
kaazing_gateway.org.apache.mina.handler.chain.ChainedIoHandler,0,0,0,0,0,0,0,0,0
kaazing_gateway.org.apache.mina.core.future.DefaultIoFuture,7,0,0,7,0,1,0,0,15
kaazing_gateway.org.apache.mina.core.buffer.IoBuffer,33,6,0,26,0,8,0,1,74
kaazing_gateway.org.apache.mina.core.filterchain.IoFilterChain,3,1,0,3,0,0,1,1,9
kaazing_gateway.org.apache.mina.core.service.IoServiceListenerSupport,3,0,0,3,0,0,0,1,7
kaazing_gateway.org.apache.mina.core.future.ConnectFuture,43,0,0,45,0,0,4,4,96
kaazing_gateway.org.apache.mina.core.session.IoSession,5,1,0,5,0,1,0,6,18
kaazing_gateway.org.kaazing.mina.core.buffer.IoBufferEx,5,0,0,5,0,0,1,1,12
kaazing_gateway.org.apache.mina.core.future.IoFuture,14,0,0,8,0,2,5,2,31
kaazing_gateway.org.apache.mina.core.write.WriteRequest,0,0,0,0,0,0,0,0,0
kaazing_gateway.org.apache.mina.filter.codec.ProtocolEncoder,5,0,0,5,0,0,0,0,10
kaazing_gateway.org.apache.mina.core.future.DefaultWriteFuture,0,0,0,0,0,6,0,0,6
kaazing_gateway.org.kaazing.gateway.resource.address.ResourceOption,6,0,0,5,0,1,0,1,13
kaazing_gateway.org.kaazing.gateway.resource.address.IdentityResolver,1,0,0,0,0,0,0,0,1
kaazing_gateway.org.kaazing.gateway.server.spi.security.AuthenticationToken,3,0,0,3,0,0,0,0,6
kaazing_gateway.org.kaazing.mina.filter.codec.ProtocolCodecSessionEx,1,0,0,1,0,0,0,0,2
kaazing_gateway.org.kaazing.mina.core.session.IoSessionEx,1,0,0,1,0,2,0,1,5
kaazing_gateway.org.apache.mina.filter.codec.ProtocolDecoder,1,0,0,1,0,0,0,0,2
kaazing_gateway.org.apache.mina.core.future.CloseFuture,2,1,0,2,0,0,0,0,5
kaazing_gateway.org.kaazing.mina.core.future.DefaultUnbindFuture,4,1,0,4,0,0,0,0,9
kaazing_gateway.org.kaazing.mina.core.session.IoSessionConfigEx,2,0,0,2,0,0,0,0,4
radkovo_jStyleParser.cz.vutbr.web.css.CSSFactory,100,0,0,80,0,0,0,11,191
radkovo_jStyleParser.cz.vutbr.web.domassign.MultiMap,1,0,0,1,0,0,0,0,2
radkovo_jStyleParser.cz.vutbr.web.css.NodeData,6,0,0,3,0,0,0,0,9
radkovo_jStyleParser.cz.vutbr.web.css.TermFactory,23,0,0,6,0,0,0,0,29
radkovo_jStyleParser.cz.vutbr.web.css.Term,1,0,0,1,0,0,0,0,2
radkovo_jStyleParser.cz.vutbr.web.css.Selector,1,0,0,1,0,0,0,0,2
radkovo_jStyleParser.cz.vutbr.web.css.MediaSpec,1,0,0,1,0,0,0,0,2
radkovo_jStyleParser.cz.vutbr.web.css.SupportedCSS,1,1,0,0,0,0,0,0,2
radkovo_jStyleParser.cz.vutbr.web.csskit.MatchConditionOnElements,4,0,0,4,0,0,0,0,8
operasoftware_operaprestodriver.com.opera.core.systems.testing.drivers.TestDriverBuilder,3,1,0,0,0,2,0,0,6
operasoftware_operaprestodriver.com.opera.core.systems.OperaWebElement,3,0,0,2,0,0,1,1,7
operasoftware_operaprestodriver.com.opera.core.systems.OperaSettings,33,4,0,21,0,13,1,1,73
operasoftware_operaprestodriver.com.opera.core.systems.runner.launcher.OperaLauncherRunner,5,0,0,5,0,2,0,2,14
operasoftware_operaprestodriver.com.opera.core.systems.OperaBinary,4,0,0,1,0,0,0,0,5
operasoftware_operaprestodriver.com.opera.core.systems.OperaArguments,18,0,0,16,0,0,2,0,36
operasoftware_operaprestodriver.com.opera.core.systems.OperaProfile,7,0,0,4,0,1,0,0,12
operasoftware_operaprestodriver.com.opera.core.systems.preferences.OperaPreferences,7,0,0,6,0,0,0,0,13
operasoftware_operaprestodriver.com.opera.core.systems.model.ColorResult,1,0,0,1,0,0,0,0,2
operasoftware_operaprestodriver.com.opera.core.systems.preferences.AbstractOperaPreferences,2,0,0,2,0,0,0,0,4
operasoftware_operaprestodriver.com.opera.core.systems.preferences.OperaScopePreferences,1,0,0,1,0,0,0,0,2
operasoftware_operaprestodriver.com.opera.core.systems.testing.drivers.TestDriverSupplier,1,0,0,1,0,0,0,0,2
operasoftware_operaprestodriver.com.opera.core.systems.runner.OperaRunner,7,0,0,5,0,3,2,3,20
operasoftware_operaprestodriver.com.opera.core.systems.model.Canvas,3,0,0,2,0,0,0,0,5
operasoftware_operaprestodriver.com.opera.core.systems.mobile.OperaMobileEmulation,4,0,0,4,0,0,0,0,8
operasoftware_operaprestodriver.com.opera.core.systems.OperaMouse,7,0,0,7,0,0,0,0,14
operasoftware_operaprestodriver.com.opera.core.systems.model.ScreenCaptureReply,0,0,0,0,0,0,0,0,0
operasoftware_operaprestodriver.com.opera.core.systems.QuickWidget,4,1,0,1,0,0,1,0,7
operasoftware_operaprestodriver.com.opera.core.systems.QuickWindow,1,0,0,1,0,0,0,0,2
operasoftware_operaprestodriver.com.opera.core.systems.OperaProxy,18,7,0,14,0,5,0,0,44
operasoftware_operaprestodriver.com.opera.core.systems.scope.services.ConsoleLogger,0,0,0,0,0,0,0,0,0
operasoftware_operaprestodriver.com.opera.core.systems.OperaDesktopDriver,2,0,0,2,0,0,0,0,4
operasoftware_operaprestodriver.com.opera.core.systems.model.OperaColor,0,0,0,0,0,0,0,0,0
operasoftware_operaprestodriver.com.opera.core.systems.testing.drivers.TestOperaDesktopDriver,1,0,0,1,0,0,0,0,2
operasoftware_operaprestodriver.com.opera.core.systems.QuickMenu,2,0,0,0,0,0,0,0,2
operasoftware_operaprestodriver.com.opera.core.systems.OperaUIElement,1,0,0,0,0,0,0,0,1
operasoftware_operaprestodriver.com.opera.core.systems.QuickMenuItem,1,0,0,0,0,0,1,0,2
operasoftware_operaprestodriver.com.opera.core.systems.internal.VersionUtil,1,0,0,0,0,0,0,0,1
semanticvectors_semanticvectors.pitt.search.semanticvectors.VectorStoreRAM,2,0,0,2,0,0,0,0,4
semanticvectors_semanticvectors.pitt.search.semanticvectors.VectorStoreWriter,1,0,0,1,0,0,0,0,2
semanticvectors_semanticvectors.pitt.search.semanticvectors.CompoundVectorBuilder,2,0,0,2,0,0,0,0,4
semanticvectors_semanticvectors.pitt.search.semanticvectors.VectorStoreReaderLucene,1,0,0,1,0,1,0,0,3
semanticvectors_semanticvectors.pitt.search.semanticvectors.FlagConfig,5,0,0,5,0,2,0,0,12
semanticvectors_semanticvectors.pitt.search.semanticvectors.CompareTerms,2,0,0,2,0,0,0,0,4
semanticvectors_semanticvectors.pitt.search.semanticvectors.ElementalVectorStore,1,0,0,1,0,0,0,0,2
semanticvectors_semanticvectors.pitt.search.semanticvectors.VectorStoreDeterministic,3,0,0,3,0,0,0,0,6
semanticvectors_semanticvectors.pitt.search.semanticvectors.utils.MatrixUtils,0,0,0,0,0,0,0,0,0
semanticvectors_semanticvectors.pitt.search.semanticvectors.utils.StatUtils,2,0,0,0,0,0,0,0,2
semanticvectors_semanticvectors.pitt.search.semanticvectors.utils.Distribution,3,0,0,0,0,0,0,0,3
semanticvectors_semanticvectors.pitt.search.semanticvectors.tables.TypeSpec,1,0,0,1,0,0,0,0,2
semanticvectors_semanticvectors.pitt.search.semanticvectors.tables.Table,1,0,0,1,0,0,0,0,2
semanticvectors_semanticvectors.pitt.search.semanticvectors.vectors.ComplexVector,9,0,0,8,0,1,0,0,18
semanticvectors_semanticvectors.pitt.search.semanticvectors.vectors.PermutationUtils,2,0,0,0,0,0,0,0,2
semanticvectors_semanticvectors.pitt.search.semanticvectors.VectorStoreOrthographical,1,0,0,1,0,0,0,0,2
semanticvectors_semanticvectors.pitt.search.semanticvectors.vectors.RealVectorUtils,2,0,0,2,0,0,0,0,4
semanticvectors_semanticvectors.pitt.search.semanticvectors.vectors.BinaryVector,5,0,0,5,0,1,0,0,11
semanticvectors_semanticvectors.pitt.search.semanticvectors.vectors.VectorFactory,6,0,0,6,0,3,0,0,15
semanticvectors_semanticvectors.pitt.search.semanticvectors.vectors.VectorUtils,1,0,0,1,0,0,0,0,2
semanticvectors_semanticvectors.pitt.search.semanticvectors.vectors.RealVector,4,0,0,4,0,1,0,0,9
semanticvectors_semanticvectors.pitt.search.semanticvectors.orthography.NumberRepresentation,3,0,0,3,0,0,0,0,6
semanticvectors_semanticvectors.pitt.search.semanticvectors.LSA,1,0,0,1,0,1,0,0,3
semanticvectors_semanticvectors.pitt.search.semanticvectors.BuildIndex,1,0,0,0,0,1,0,0,2
senbox-org_s1tbx.org.esa.s1tbx.dat.toolviews.Projects.Project,1,0,0,0,0,0,0,0,1
senbox-org_s1tbx.org.esa.s1tbx.dat.toolviews.Projects.ProjectSubFolder,2,0,0,2,0,0,0,0,4
senbox-org_s1tbx.org.esa.s1tbx.utilities.gpf.UndersamplingOp,5,0,0,5,0,0,0,0,10
senbox-org_s1tbx.org.esa.s1tbx.utilities.gpf.DataAnalysisOp,1,0,0,1,0,0,0,0,2
senbox-org_s1tbx.org.esa.s1tbx.commons.test.ProductValidator,0,0,0,0,0,0,0,3,3
senbox-org_s1tbx.org.esa.s1tbx.commons.io.S1TBXProductReaderPlugIn,1,0,0,0,0,0,0,0,1
senbox-org_s1tbx.org.esa.s1tbx.commons.test.ProcessorTest,3,0,0,3,0,0,2,3,11
senbox-org_s1tbx.org.esa.s1tbx.commons.test.ReaderTest,0,0,0,0,0,0,2,100,102
senbox-org_s1tbx.org.esa.s1tbx.commons.test.S1TBXTests,0,0,0,0,0,0,0,14,14
senbox-org_s1tbx.org.esa.s1tbx.io.binary.BinaryFileReader,12,0,0,4,0,4,0,0,20
senbox-org_s1tbx.org.esa.s1tbx.io.TAXI.TAXIParameterFileReader,0,0,0,0,0,0,0,1,1
senbox-org_s1tbx.org.esa.s1tbx.sentinel1.gpf.experimental.DerampDemodPhaseOp,0,0,0,0,0,0,0,4,4
senbox-org_s1tbx.org.esa.s1tbx.sentinel1.gpf.util.ArcDataIntegration,0,0,0,0,0,0,0,4,4
senbox-org_s1tbx.org.esa.s1tbx.sentinel1.gpf.util.GraphUtils,1,0,0,0,0,0,0,0,1
senbox-org_s1tbx.org.esa.s1tbx.orbits.io.sentinel1.OrbitFileScraper,0,0,0,0,0,0,0,0,0
senbox-org_s1tbx.org.esa.s1tbx.orbits.io.sentinel1.SentinelPODOrbitFile,1,1,0,1,0,0,1,1,5
senbox-org_s1tbx.org.esa.s1tbx.orbits.io.sentinel1.OpenSearch,0,0,0,0,0,0,0,1,1
senbox-org_s1tbx.org.esa.s1tbx.orbits.io.sentinel1.GnssOrbitFileDownloader,0,0,0,0,0,0,0,0,0
senbox-org_s1tbx.org.esa.s1tbx.orbits.io.sentinel1.Sentinel1OrbitFileReader,2,0,0,2,0,0,0,0,4
senbox-org_s1tbx.org.esa.s1tbx.orbits.io.delft.OrbitalDataRecordReader,0,1,0,0,0,0,0,0,1
senbox-org_s1tbx.org.esa.s1tbx.insar.gpf.coregistration.CreateStackOp,3,0,0,0,0,0,0,0,3
senbox-org_s1tbx.org.esa.s1tbx.insar.gpf.coregistration.GCPManager,1,0,0,1,0,0,0,0,2
senbox-org_s1tbx.org.csa.rstb.polarimetric.gpf.PolarimetricDecompositionOp,0,0,0,0,0,0,0,3,3
senbox-org_s1tbx.org.csa.rstb.polarimetric.gpf.support.QuadPolProcessor,1,0,0,0,0,0,0,0,1
senbox-org_s1tbx.org.csa.rstb.soilmoisture.gpf.SMDielectricModelInverOp,2,0,0,0,0,0,0,0,2
senbox-org_s1tbx.org.esa.s1tbx.sar.gpf.MultilookOp,1,0,0,1,0,0,0,0,2
senbox-org_s1tbx.org.esa.s1tbx.sar.gpf.filtering.SpeckleFilterOp,6,0,0,0,0,0,0,0,6
senbox-org_s1tbx.org.esa.s1tbx.sar.gpf.geometric.SRGROp,1,0,0,1,0,0,0,0,2
senbox-org_s1tbx.org.esa.s1tbx.sar.gpf.geometric.RangeDopplerGeocodingOp,0,0,0,0,0,0,0,0,0
senbox-org_s1tbx.org.esa.s1tbx.cloud.utils.Credentials,1,0,0,1,0,0,0,0,2
senbox-org_s1tbx.org.jlinda.core.Orbit,7,0,0,4,0,0,0,0,11
senbox-org_s1tbx.org.jlinda.core.Point,1,0,0,0,0,0,0,0,1
senbox-org_s1tbx.org.jlinda.core.Ellipsoid,1,0,0,0,0,0,1,1,3
senbox-org_s1tbx.org.jlinda.core.Window,2,0,0,2,0,0,0,0,4
senbox-org_s1tbx.org.jlinda.core.SLCImage,1,0,0,0,0,0,0,0,1
senbox-org_s1tbx.org.jlinda.core.Baseline,9,0,0,0,0,0,0,0,9
senbox-org_s1tbx.org.jlinda.core.coregistration.utils.CoregistrationUtils,0,0,0,0,0,0,0,2,2
senbox-org_s1tbx.org.jlinda.core.coregistration.cross.CrossGeometry,0,0,0,0,0,0,0,2,2
senbox-org_s1tbx.org.jlinda.core.utils.MathUtils,4,0,0,0,0,0,0,2,6
senbox-org_s1tbx.org.jlinda.core.utils.LinearAlgebraUtils,0,0,0,0,0,0,1,0,1
senbox-org_s1tbx.org.jlinda.core.delaunay.TriangleInterpolator,0,0,0,0,0,0,0,0,0
senbox-org_s1tbx.org.jlinda.core.utils.SarUtils,0,0,0,0,0,0,0,0,0
senbox-org_s1tbx.org.jlinda.core.utils.GeoUtils,1,0,0,1,0,0,1,0,3
senbox-org_s1tbx.org.jlinda.core.utils.SpectralUtils,10,0,0,6,0,0,2,0,18
senbox-org_s1tbx.org.jlinda.core.utils.WeightWindows,0,0,0,0,0,0,2,0,2
senbox-org_s1tbx.org.jlinda.core.utils.PolyUtils,1,0,0,0,0,0,0,0,1
senbox-org_s1tbx.org.jlinda.core.unwrapping.snaphu.SnaphuConfigFile,0,0,0,0,0,0,0,1,1
senbox-org_s1tbx.org.jlinda.core.io.ResFile,1,0,0,1,0,0,0,0,2
senbox-org_s1tbx.org.jlinda.core.io.FlatBinary,0,0,0,0,0,0,0,0,0
senbox-org_s1tbx.org.jlinda.core.io.FlatBinaryDouble,0,0,0,0,0,0,1,0,1
senbox-org_s1tbx.org.jlinda.core.io.DataReader,6,0,0,5,0,0,0,0,11
senbox-org_s1tbx.org.jlinda.core.filtering.PhaseFilterUtils,0,0,0,0,0,0,0,0,0
senbox-org_s1tbx.org.jlinda.core.filtering.RangeFilter,4,0,0,4,0,0,0,5,13
senbox-org_s1tbx.org.jlinda.core.filtering.AzimuthFilter,1,0,0,1,0,0,0,0,2
senbox-org_s1tbx.org.jlinda.core.geocode.DInSAR,0,0,0,0,0,0,0,0,0
senbox-org_s1tbx.org.jlinda.core.geocode.Slant2Height,0,0,0,0,0,0,0,0,0
senbox-org_s1tbx.org.jlinda.core.geom.TopoPhase,1,0,0,1,0,0,0,0,2
senbox-org_s1tbx.org.jlinda.core.geom.DemTile,2,0,0,1,0,0,0,0,3
senbox-org_s1tbx.org.esa.s1tbx.commons.io.ImageIOFile,0,0,0,0,0,0,0,0,0
senbox-org_s1tbx.org.esa.s1tbx.commons.product.Missions,0,0,0,0,0,0,0,1,1
chaupal_jxse.net.jxse.JxseInstantiator,1,0,0,0,0,0,0,0,1
chaupal_jxse.net.jxse.configuration.JxsePeerConfiguration,29,0,0,29,0,1,0,0,59
chaupal_jxse.net.jxse.configuration.JxseHttpTransportConfiguration,8,0,0,7,0,1,0,0,16
chaupal_jxse.net.jxse.configuration.JxseMulticastTransportConfiguration,7,0,0,6,0,1,0,0,14
chaupal_jxse.net.jxse.configuration.JxseConfigurationTool,3,0,0,3,0,2,0,0,8
chaupal_jxse.net.jxse.configuration.JxseTcpTransportConfiguration,10,0,0,9,0,1,0,0,20
chaupal_jxse.net.jxse.configuration.JxseHttp2TransportConfiguration,8,0,0,7,0,1,0,0,16
chaupal_jxse.net.jxta.id.IDFactory,8,2,0,2,0,5,1,3,21
chaupal_jxse.net.jxta.document.StructuredDocumentFactory,1,0,0,1,0,0,0,0,2
chaupal_jxse.net.jxta.document.XMLDocument,2,2,0,2,0,2,0,0,8
chaupal_jxse.net.jxta.document.Advertisement,1,0,0,0,0,1,0,0,2
chaupal_jxse.net.jxta.document.MimeMediaType,7,0,0,3,0,3,1,1,15
chaupal_jxse.net.jxta.logging.Logging,1,0,0,0,0,0,0,0,1
chaupal_jxse.net.jxta.peergroup.LightWeightPeerGroup,0,2,0,0,0,0,0,0,2
chaupal_jxse.net.jxta.pipe.PipeID,4,2,0,4,0,4,0,0,14
chaupal_jxse.net.jxta.configuration.JxtaConfiguration,9,0,0,8,0,3,0,0,20
chaupal_jxse.net.jxta.configuration.PropertiesUtil,1,0,0,0,0,0,0,0,1
chaupal_jxse.net.jxta.protocol.DiscoveryResponseMsg,1,0,0,1,0,1,0,0,3
chaupal_jxse.net.jxta.impl.protocol.GroupConfig,1,0,0,1,0,1,1,0,4
chaupal_jxse.net.jxta.protocol.ResolverResponseMsg,1,0,0,1,0,1,0,1,4
chaupal_jxse.net.jxta.protocol.RdvAdvertisement,2,0,0,2,0,0,0,0,4
chaupal_jxse.net.jxta.protocol.ResolverSrdiMsg,2,0,0,2,0,0,0,0,4
chaupal_jxse.net.jxta.protocol.PeerAdvertisement,2,0,0,1,0,2,0,0,5
chaupal_jxse.net.jxta.protocol.ResolverQueryMsg,1,0,0,1,0,1,0,1,4
chaupal_jxse.net.jxta.protocol.PipeAdvertisement,0,0,0,0,0,0,0,0,0
chaupal_jxse.net.jxta.protocol.SignedAdvertisement,0,0,0,0,0,1,0,0,1
chaupal_jxse.net.jxta.protocol.DiscoveryQueryMsg,1,0,0,1,0,1,0,0,3
chaupal_jxse.net.jxta.impl.protocol.SrdiMessageImpl,1,0,0,1,0,1,0,0,3
chaupal_jxse.net.jxta.protocol.SrdiMessage,1,0,0,1,0,1,0,0,3
chaupal_jxse.net.jxta.document.AdvertisementFactory,5,0,0,5,0,2,0,1,13
chaupal_jxse.net.jxta.util.CountingOutputStream,0,0,0,0,0,0,0,0,0
chaupal_jxse.net.jxta.util.QueuingServerPipeAcceptor,1,0,0,1,0,0,0,0,2
chaupal_jxse.net.jxta.id.ID,6,0,0,6,0,6,0,0,18
chaupal_jxse.net.jxta.peergroup.PeerGroup,20,11,0,6,0,18,0,0,55
chaupal_jxse.net.jxta.impl.loader.RefJxtaLoader,4,0,0,1,0,4,0,0,9
chaupal_jxse.net.jxta.impl.peergroup.GenericPeerGroup,0,0,0,0,0,0,0,0,0
chaupal_jxse.net.jxta.impl.util.TimeUtils,6,0,0,5,0,0,0,0,11
chaupal_jxse.net.jxta.impl.util.URISeedingManager,1,1,0,1,0,0,0,1,4
chaupal_jxse.net.jxta.impl.util.threads.TaskManager,1,0,0,0,0,0,0,0,1
chaupal_jxse.net.jxta.impl.util.threads.SelfCancellingTask,1,0,0,1,0,0,0,0,2
chaupal_jxse.net.jxta.impl.id.UUID.UUIDFactory,0,0,0,0,0,2,0,0,2
chaupal_jxse.net.jxta.impl.id.UUID.UUID,1,0,0,0,0,1,0,0,2
chaupal_jxse.net.jxta.impl.id.binaryID.BinaryID,1,0,0,1,0,1,0,0,3
chaupal_jxse.net.jxta.impl.id.binaryID.PeerGroupBinaryID,1,0,0,1,0,1,0,0,3
chaupal_jxse.net.jxta.impl.id.binaryID.PeerBinaryID,1,0,0,1,0,1,0,0,3
chaupal_jxse.net.jxta.impl.id.binaryID.PipeBinaryID,1,0,0,1,0,1,0,0,3
chaupal_jxse.net.jxta.impl.id.binaryID.DigestTool,3,0,0,3,0,3,0,0,9
chaupal_jxse.net.jxta.impl.cm.Srdi,11,0,0,11,0,0,1,1,24
chaupal_jxse.net.jxta.impl.cm.XIndiceAdvertisementCache,0,0,0,0,0,0,0,1,1
chaupal_jxse.net.jxta.impl.cm.XIndiceSrdi,1,2,0,1,0,0,0,1,5
chaupal_jxse.net.jxta.impl.cm.SrdiManager,0,0,0,0,0,0,0,3,3
chaupal_jxse.net.jxta.impl.cm.CacheManager,18,2,0,11,0,2,0,0,33
chaupal_jxse.net.jxta.impl.cm.SrdiManagerPeriodicPushTask,0,0,0,0,0,0,0,4,4
chaupal_jxse.net.jxta.impl.content.ModuleWrapperFactory,0,0,0,2,0,0,0,0,2
chaupal_jxse.net.jxta.platform.Module,0,0,0,1,0,0,0,0,1
chaupal_jxse.net.jxta.impl.content.EventAggregator,1,0,0,1,0,0,0,0,2
chaupal_jxse.net.jxta.impl.content.TransferAggregator,4,0,0,3,0,0,0,0,7
chaupal_jxse.net.jxta.impl.content.ModuleLifecycleManager,4,0,0,4,0,0,0,0,8
chaupal_jxse.net.jxta.impl.content.ModuleLifecycleTracker,6,0,0,6,0,0,0,0,12
chaupal_jxse.net.jxta.impl.xindice.core.filer.BTreeFiler,3,0,0,3,0,3,0,0,9
chaupal_jxse.net.jxta.impl.endpoint.AsynchronousMessenger,8,0,0,9,0,1,0,0,18
chaupal_jxse.net.jxta.impl.endpoint.QueuedMessage,1,0,0,1,0,0,0,0,2
chaupal_jxse.net.jxta.endpoint.AbstractMessenger,1,0,0,1,0,0,0,0,2
chaupal_jxse.net.jxta.impl.endpoint.msgframing.WelcomeMessage,1,0,0,1,0,0,1,0,3
chaupal_jxse.net.jxta.impl.endpoint.msgframing.MessagePackageHeader,4,0,0,0,0,0,0,0,4
chaupal_jxse.net.jxta.impl.endpoint.netty.NettyTransportServer,2,0,0,1,0,1,1,0,5
chaupal_jxse.net.jxta.impl.endpoint.netty.InetSocketAddressTranslator,3,0,0,1,0,0,0,0,4
chaupal_jxse.net.jxta.impl.endpoint.netty.MessageDispatchHandler,0,0,0,0,0,0,0,4,4
chaupal_jxse.net.jxta.impl.endpoint.netty.NettyTransportClient,1,0,0,0,0,0,0,0,1
chaupal_jxse.net.jxta.impl.endpoint.netty.NettyTransport,0,0,0,0,0,0,0,0,0
chaupal_jxse.net.jxta.impl.membership.pse.PSEUtils,1,0,0,1,0,1,0,0,3
chaupal_jxse.net.jxta.endpoint.TextMessageElement,3,0,0,1,0,3,0,0,7
chaupal_jxse.net.jxta.endpoint.MessageElement,1,0,0,1,0,2,0,0,4
chaupal_jxse.net.jxta.document.TextDocumentReaderIO,1,0,0,0,0,1,0,0,2
chaupal_jxse.net.jxta.endpoint.ByteArrayMessageElement,3,0,0,0,0,3,0,0,6
chaupal_jxse.net.jxta.endpoint.MessengerStateBarrier,2,0,0,2,0,0,0,0,4
chaupal_jxse.net.jxta.document.DocumentStreamIO,0,0,0,0,0,0,0,1,1
chaupal_jxse.net.jxta.endpoint.InputStreamMessageElement,0,0,0,0,0,1,0,0,1
chaupal_jxse.net.jxta.endpoint.WireFormatMessageFactory,0,0,0,0,0,1,0,0,1
chaupal_jxse.net.jxta.endpoint.Message,16,0,0,15,0,1,0,1,33
chaupal_jxse.net.jxta.endpoint.MessengerStateListenerSet,0,0,0,0,0,0,0,4,4
chaupal_jxse.net.jxta.endpoint.EndpointAddress,7,0,0,2,0,1,0,0,10
chaupal_jxse.net.jxta.platform.NetworkManager,1,0,0,1,0,0,0,0,2
open-eid_digidoc4j.org.digidoc4j.X509Cert,2,0,0,0,0,0,0,2,4
open-eid_digidoc4j.org.digidoc4j.Container,93,1,0,79,0,1,2,12,188
open-eid_digidoc4j.org.digidoc4j.ContainerOpener,45,0,0,41,0,0,1,23,110
open-eid_digidoc4j.org.digidoc4j.Configuration,32,1,0,26,0,4,2,1,66
open-eid_digidoc4j.org.digidoc4j.DataFile,6,0,0,6,0,0,0,0,12
open-eid_digidoc4j.org.digidoc4j.ContainerBuilder,71,0,0,67,0,4,3,6,151
open-eid_digidoc4j.org.digidoc4j.SignatureBuilder,25,0,0,25,0,0,1,4,55
open-eid_digidoc4j.org.digidoc4j.Signature,12,0,0,12,0,0,0,0,24
open-eid_digidoc4j.org.digidoc4j.ValidationResult,5,0,0,4,0,0,0,0,9
open-eid_digidoc4j.org.digidoc4j.SignatureFinalizerBuilder,0,0,0,0,0,0,0,0,0
open-eid_digidoc4j.org.digidoc4j.utils.Helper,5,0,0,1,0,2,0,0,8
open-eid_digidoc4j.org.digidoc4j.DetachedXadesSignatureBuilder,19,0,0,19,0,0,0,0,38
open-eid_digidoc4j.org.digidoc4j.CertificateValidatorBuilder,0,0,0,0,0,5,0,1,6
open-eid_digidoc4j.org.digidoc4j.TSLCertificateSource,7,0,0,3,0,0,1,0,11
open-eid_digidoc4j.org.digidoc4j.SignatureProductionPlace,0,0,0,0,0,0,0,0,0
open-eid_digidoc4j.org.digidoc4j.impl.ddoc.DDocOpener,2,0,0,2,0,0,0,0,4
open-eid_digidoc4j.org.digidoc4j.SignatureToken,1,0,0,0,0,0,0,0,1
open-eid_digidoc4j.org.digidoc4j.signers.PKCS11SignatureToken,1,0,0,0,0,0,0,1,2
open-eid_digidoc4j.org.digidoc4j.signers.ExternalSigner,0,0,0,0,0,0,0,0,0
open-eid_digidoc4j.org.digidoc4j.signers.PKCS12SignatureToken,0,0,0,0,0,0,0,0,0
open-eid_digidoc4j.org.digidoc4j.utils.KeyStoreDocument,0,0,0,0,0,0,0,2,2
open-eid_digidoc4j.org.digidoc4j.utils.TokenAlgorithmSupport,0,0,0,0,0,0,0,0,0
open-eid_digidoc4j.org.digidoc4j.utils.PolicyUtils,1,0,0,0,0,0,0,0,1
open-eid_digidoc4j.org.digidoc4j.utils.DigestUtils,0,0,0,0,0,0,0,0,0
open-eid_digidoc4j.org.digidoc4j.utils.DateUtils,2,0,0,0,0,0,0,0,2
open-eid_digidoc4j.org.digidoc4j.utils.ResourceUtils,2,0,0,0,0,0,0,0,2
open-eid_digidoc4j.org.digidoc4j.utils.ZipEntryInputStream,0,0,0,0,0,0,0,3,3
open-eid_digidoc4j.org.digidoc4j.main.DigiDoc4J,4,0,0,0,0,0,2,16,22
open-eid_digidoc4j.org.digidoc4j.impl.StreamDocument,0,0,0,0,0,0,0,0,0
open-eid_digidoc4j.org.digidoc4j.impl.AiaDataLoaderFactory,1,0,0,1,0,0,0,0,2
open-eid_digidoc4j.org.digidoc4j.impl.SkTimestampDataLoader,0,0,0,0,0,0,0,0,0
open-eid_digidoc4j.org.digidoc4j.impl.SKOnlineOCSPSource,12,0,0,12,0,12,0,5,41
open-eid_digidoc4j.org.digidoc4j.impl.asic.tsl.TSLCertificateSourceImpl,0,0,0,0,0,0,0,0,0
open-eid_digidoc4j.org.digidoc4j.exceptions.CertificateValidationException,5,0,0,0,0,0,0,0,5
open-eid_digidoc4j.org.digidoc4j.impl.ServiceAccessScope,1,0,0,0,0,0,0,4,5
open-eid_digidoc4j.org.digidoc4j.impl.SkOCSPDataLoader,0,0,0,0,0,0,0,0,0
open-eid_digidoc4j.org.digidoc4j.impl.TspDataLoaderFactory,1,0,0,1,0,0,0,0,2
open-eid_digidoc4j.org.digidoc4j.impl.asic.AsicEntry,0,0,0,0,0,0,0,1,1
open-eid_digidoc4j.org.digidoc4j.impl.UncompressedAsicEntry,1,0,0,1,0,0,0,4,6
open-eid_digidoc4j.org.digidoc4j.impl.SimpleHttpGetDataLoader,7,0,0,0,0,7,2,12,28
open-eid_digidoc4j.org.digidoc4j.impl.asic.tsl.TslLoader,0,0,0,0,0,0,2,1,3
open-eid_digidoc4j.org.digidoc4j.impl.OcspDataLoaderFactory,1,0,0,1,0,0,0,0,2
open-eid_digidoc4j.org.digidoc4j.impl.asic.DataLoaderDecorator,19,0,0,0,0,0,0,12,31
open-eid_digidoc4j.org.digidoc4j.impl.asic.tsl.TslFileLoaderFactory,4,0,0,0,0,0,0,0,4
open-eid_digidoc4j.org.digidoc4j.impl.ddoc.DDocFacade,4,0,0,4,0,0,0,0,8
open-eid_digidoc4j.org.digidoc4j.impl.ddoc.ConfigManagerInitializer,1,0,0,0,0,0,0,0,1
open-eid_digidoc4j.org.digidoc4j.impl.AbstractValidationResult,3,0,0,3,0,0,0,0,6
open-eid_digidoc4j.org.digidoc4j.impl.AbstractSignatureValidationResult,0,0,0,0,0,0,0,0,0
open-eid_digidoc4j.org.digidoc4j.exceptions.DigiDoc4JException,0,0,0,0,0,0,0,0,0
open-eid_digidoc4j.org.digidoc4j.impl.asic.asice.bdoc.BDocSignatureOpener,2,0,0,2,0,0,0,0,4
open-eid_digidoc4j.org.digidoc4j.impl.asic.AsicSignature,0,0,0,0,0,0,0,0,0
open-eid_digidoc4j.org.digidoc4j.impl.asic.AsicContainer,10,0,0,10,0,0,0,0,20
open-eid_digidoc4j.org.digidoc4j.impl.asic.manifest.ManifestParser,2,0,0,2,0,0,0,0,4
open-eid_digidoc4j.org.digidoc4j.impl.asic.manifest.ManifestEntry,0,0,0,0,0,0,0,0,0
open-eid_digidoc4j.org.digidoc4j.impl.asic.manifest.ManifestValidator,5,0,0,5,0,0,0,0,10
open-eid_digidoc4j.org.digidoc4j.impl.asic.manifest.AsicManifest,0,0,0,0,0,0,0,0,0
open-eid_digidoc4j.org.digidoc4j.impl.asic.tsl.TslManager,2,0,0,2,0,0,0,0,4
open-eid_digidoc4j.org.digidoc4j.impl.asic.SKCommonCertificateVerifier,1,0,0,1,0,0,0,0,2
open-eid_digidoc4j.org.digidoc4j.impl.asic.xades.XadesValidationReportProcessor,5,0,0,0,0,0,0,0,5
open-eid_digidoc4j.org.digidoc4j.impl.asic.xades.XadesSignatureParser,5,0,0,5,0,0,0,0,10
open-eid_digidoc4j.org.digidoc4j.impl.asic.xades.XadesSigningDssFacade,0,0,0,0,0,0,0,0,0
open-eid_digidoc4j.org.digidoc4j.impl.asic.xades.validation.ThreadPoolManager,0,0,0,0,0,0,0,0,0
open-eid_digidoc4j.org.digidoc4j.impl.asic.report.SignatureValidationReport,1,0,0,1,0,0,0,0,2
open-eid_digidoc4j.org.digidoc4j.SignatureValidationResult,4,0,0,4,0,0,0,0,8
open-eid_digidoc4j.org.digidoc4j.impl.asic.AsicContainerParser,0,0,0,0,0,0,0,1,1
open-eid_digidoc4j.org.digidoc4j.impl.asic.xades.XadesSignatureWrapper,1,0,0,1,0,0,0,0,2
open-eid_digidoc4j.org.digidoc4j.impl.asic.AsicParseResult,2,0,0,2,0,0,0,0,4
open-eid_digidoc4j.org.digidoc4j.OCSPSourceBuilder,3,0,0,3,0,0,0,0,6
open-eid_digidoc4j.org.digidoc4j.impl.CommonOCSPSource,1,0,0,0,0,0,0,0,1
remibantos_jeeshop.org.rembx.jeeshop.catalog.Catalogs,4,0,0,1,0,2,0,0,7
remibantos_jeeshop.org.rembx.jeeshop.catalog.model.CatalogItem,22,0,0,10,0,4,0,0,36
remibantos_jeeshop.org.rembx.jeeshop.catalog.Discounts,4,0,0,1,0,2,0,0,7
remibantos_jeeshop.org.rembx.jeeshop.catalog.Categories,11,0,0,1,0,7,0,0,19
remibantos_jeeshop.org.rembx.jeeshop.catalog.Products,9,0,0,0,0,6,0,0,15
remibantos_jeeshop.org.rembx.jeeshop.catalog.Stores,1,0,0,1,0,0,0,0,2
remibantos_jeeshop.org.rembx.jeeshop.catalog.PresentationResource,1,0,0,1,0,0,0,0,2
remibantos_jeeshop.org.rembx.jeeshop.catalog.SKUs,10,0,0,1,0,6,0,0,17
remibantos_jeeshop.org.rembx.jeeshop.catalog.model.Discount,0,0,0,0,0,0,0,0,0
remibantos_jeeshop.org.rembx.jeeshop.util.LocaleUtil,0,0,0,0,0,0,0,0,0
remibantos_jeeshop.org.rembx.jeeshop.util.DateUtil,0,0,0,0,0,0,0,0,0
remibantos_jeeshop.org.rembx.jeeshop.mail.Mailer,2,0,0,0,0,2,0,0,4
remibantos_jeeshop.org.rembx.jeeshop.order.Orders,13,0,0,1,0,3,0,0,17
remibantos_jeeshop.org.rembx.jeeshop.user.model.Address,1,0,0,1,0,1,0,0,3
remibantos_jeeshop.org.rembx.jeeshop.order.model.Order,7,0,0,6,0,1,0,0,14
remibantos_jeeshop.org.rembx.jeeshop.order.PriceEngineImpl,1,1,0,1,0,0,0,0,3
remibantos_jeeshop.org.rembx.jeeshop.order.Fees,1,0,0,1,0,0,0,0,2
remibantos_jeeshop.org.rembx.jeeshop.user.MailTemplates,5,0,0,0,0,4,0,0,9
remibantos_jeeshop.org.rembx.jeeshop.user.model.MailTemplate,2,0,0,0,0,2,0,1,5
remibantos_jeeshop.org.rembx.jeeshop.user.model.User,9,0,0,4,0,5,0,2,20
remibantos_jeeshop.org.rembx.jeeshop.user.Users,13,0,0,2,0,7,0,0,22
remibantos_jeeshop.org.rembx.jeeshop.user.tools.CryptTools,0,0,0,0,0,0,0,0,0
remibantos_jeeshop.org.rembx.jeeshop.media.Medias,1,0,0,0,0,1,0,0,2
meltmedia_dropwizard-crypto.com.meltmedia.dropwizard.crypto.JsonPointerEditor,1,0,0,1,0,0,0,0,2
dpaukov_combinatoricslib.org.paukov.tool.IntExpressionParser,0,0,0,0,0,0,0,0,0
dpaukov_combinatoricslib.org.paukov.combinatorics.IntegerVector,7,0,0,7,0,0,0,0,14
dpaukov_combinatoricslib.org.paukov.combinatorics.IntegerFactory,14,0,0,14,0,0,0,0,28
dpaukov_combinatoricslib.org.paukov.combinatorics.CombinatoricsFactory,22,0,0,22,0,0,0,0,44
dpaukov_combinatoricslib.org.paukov.combinatorics.ICombinatoricsVector,8,0,0,6,0,0,0,0,14
dpaukov_combinatoricslib.org.paukov.combinatorics.IGenerator,48,0,0,48,0,0,0,0,96
dpaukov_combinatoricslib.org.paukov.combinatorics.util.Util,8,0,0,0,0,0,0,0,8
dpaukov_combinatoricslib.org.paukov.combinatorics.Generator,4,0,0,0,0,0,0,0,4
dpaukov_combinatoricslib.org.paukov.combinatorics.IntegerGenerator,1,0,0,1,0,0,0,0,2
forge_roaster.org.jboss.forge.roaster.model.impl.Strings,2,0,0,0,0,0,0,0,2
forge_roaster.org.jboss.forge.roaster.model.Packaged,2,0,0,2,0,0,0,0,4
forge_roaster.org.jboss.forge.roaster.model.JavaRecord,1,0,0,1,0,0,0,0,2
forge_roaster.org.jboss.forge.roaster.model.Named,16,0,0,16,0,0,0,0,32
forge_roaster.org.jboss.forge.roaster.model.source.JavaEnumSource,7,0,0,7,0,0,0,0,14
forge_roaster.org.jboss.forge.roaster.model.source.FieldHolderSource,32,0,0,32,0,0,0,0,64
forge_roaster.org.jboss.forge.roaster.model.source.MethodHolderSource,40,0,0,40,0,0,0,1,81
forge_roaster.org.jboss.forge.roaster.model.source.StaticCapableSource,3,0,0,3,0,0,0,0,6
forge_roaster.org.jboss.forge.roaster.model.JavaDoc,7,0,0,7,0,0,0,0,14
forge_roaster.org.jboss.forge.roaster.model.source.NamedSource,17,0,0,17,0,0,0,1,35
forge_roaster.org.jboss.forge.roaster.model.JavaType,7,0,0,7,0,0,0,0,14
forge_roaster.org.jboss.forge.roaster.model.source.MethodSource,11,0,0,9,0,0,0,0,20
forge_roaster.org.jboss.forge.roaster.model.source.PackagedSource,28,0,0,28,0,0,0,0,56
forge_roaster.org.jboss.forge.roaster.model.Type,4,0,0,4,0,0,0,0,8
forge_roaster.org.jboss.forge.roaster.model.Method,2,0,0,2,0,0,0,0,4
forge_roaster.org.jboss.forge.roaster.model.source.AbstractableSource,0,0,0,0,0,0,0,0,0
forge_roaster.org.jboss.forge.roaster.model.MethodHolder,2,0,0,2,0,0,0,0,4
forge_roaster.org.jboss.forge.roaster.Origin,0,0,0,0,0,0,0,0,0
forge_roaster.org.jboss.forge.roaster.model.JavaAnnotation,2,0,0,2,0,0,0,0,4
forge_roaster.org.jboss.forge.roaster.model.source.AnnotationElementSource,2,0,0,2,0,0,0,0,4
forge_roaster.org.jboss.forge.roaster.model.source.JavaAnnotationSource,6,0,0,6,0,0,0,0,12
forge_roaster.org.jboss.forge.roaster.model.Annotation,37,0,0,36,0,0,0,0,73
forge_roaster.org.jboss.forge.roaster.model.EnumConstant,1,0,0,1,0,0,0,0,2
forge_roaster.org.jboss.forge.roaster.Roaster,1,0,0,1,0,0,0,0,2
forge_roaster.org.jboss.forge.roaster.model.Parameter,1,0,0,1,0,0,0,0,2
forge_roaster.org.jboss.forge.roaster.model.source.PropertyHolderSource,2,0,0,2,0,0,0,0,4
forge_roaster.org.jboss.forge.roaster.model.JavaUnit,1,0,0,1,0,0,0,0,2
forge_roaster.org.jboss.forge.roaster.model.source.ExtendableSource,1,0,0,1,0,0,0,0,2
forge_roaster.org.jboss.forge.roaster.model.source.InterfaceCapableSource,7,0,0,7,0,0,0,0,14
forge_roaster.org.jboss.forge.roaster.model.Field,19,0,0,19,0,0,0,0,38
forge_roaster.org.jboss.forge.roaster.model.source.VisibilityScopedSource,10,0,0,10,0,0,0,0,20
forge_roaster.org.jboss.forge.roaster.model.source.Importer,16,0,0,15,0,0,0,0,31
forge_roaster.org.jboss.forge.roaster.model.source.LocationCapable,4,0,0,4,0,0,0,0,8
forge_roaster.org.jboss.forge.roaster.model.source.AnnotationSource,1,0,0,1,0,0,0,0,2
forge_roaster.org.jboss.forge.roaster.model.source.Import,7,0,0,5,0,0,0,0,12
forge_roaster.org.jboss.forge.roaster.model.InterfaceCapable,4,0,0,4,0,0,0,0,8
forge_roaster.org.jboss.forge.roaster.model.source.TypeHolderSource,3,0,0,3,0,0,0,0,6
forge_roaster.org.jboss.forge.roaster.model.JavaClass,1,0,0,1,0,0,0,0,2
forge_roaster.org.jboss.forge.roaster.model.source.FieldSource,1,0,0,1,0,0,0,0,2
forge_roaster.org.jboss.forge.roaster.model.source.AnnotationTargetSource,1,0,0,1,0,0,0,0,2
forge_roaster.org.jboss.forge.roaster.model.Extendable,4,0,0,3,0,0,0,0,7
forge_roaster.org.jboss.forge.roaster.model.source.FinalCapableSource,1,0,0,1,0,0,0,0,2
forge_roaster.org.jboss.forge.roaster.model.util.Formatter,1,0,0,1,0,0,0,0,2
forge_roaster.org.jboss.forge.roaster.model.util.JDTOptions,0,0,0,0,0,0,0,0,0
forge_roaster.org.jboss.forge.roaster.model.util.Types,12,0,0,2,0,0,0,0,14
forge_roaster.org.jboss.forge.roaster.model.util.SerialVersionUIDComputer,2,0,0,2,0,0,0,0,4
forge_roaster.org.jboss.forge.roaster.model.util.Methods,0,0,0,0,0,0,0,0,0
forge_roaster.org.jboss.forge.roaster.model.util.FormatterProfileReader,2,0,0,2,0,0,0,0,4
forge_roaster.org.jboss.forge.roaster.model.util.Refactory,6,0,0,6,0,0,0,0,12
forge_roaster.org.jboss.forge.roaster.model.util.DesignPatterns,2,0,0,2,0,0,0,0,4
unitsofmeasurement_unit-ri.tec.units.ri.quantity.NumberQuantity,1,0,0,0,0,0,0,0,1
unitsofmeasurement_unit-ri.tec.units.ri.quantity.DefaultQuantityFactory,5,0,0,0,0,0,0,0,5
unitsofmeasurement_unit-ri.tec.units.ri.quantity.Quantities,1,0,0,0,0,0,0,0,1
unitsofmeasurement_unit-ri.tec.units.ri.function.AddConverter,0,0,0,0,0,0,0,0,0
unitsofmeasurement_unit-ri.tec.units.ri.AbstractConverter,0,0,0,0,0,0,0,0,0
unitsofmeasurement_unit-ri.tec.units.ri.function.LogConverter,4,0,0,0,0,0,0,0,4
unitsofmeasurement_unit-ri.tec.units.ri.function.PiDivisorConverter,1,0,0,0,0,0,0,0,1
unitsofmeasurement_unit-ri.tec.units.ri.function.PiMultiplierConverter,1,0,0,0,0,0,0,0,1
unitsofmeasurement_unit-ri.tec.units.ri.function.MultiplyConverter,3,0,0,0,0,0,0,0,3
unitsofmeasurement_unit-ri.tec.units.ri.function.ExpConverter,4,0,0,1,0,0,0,0,5
unitsofmeasurement_unit-ri.tec.units.ri.internal.format.l10n.NumberFormat,1,0,0,1,0,0,0,0,2
unitsofmeasurement_unit-ri.tec.units.ri.internal.format.l10n.Annotation,1,0,0,0,0,0,0,0,1
unitsofmeasurement_unit-ri.tec.units.ri.internal.format.l10n.Format,1,0,0,1,0,0,0,0,2
unitsofmeasurement_unit-ri.tec.units.ri.internal.format.l10n.AttributedString,0,0,0,0,0,0,0,1,1
unitsofmeasurement_unit-ri.tec.units.ri.internal.format.l10n.DecimalFormatSymbols,4,0,0,4,0,0,0,0,8
unitsofmeasurement_unit-ri.tec.units.ri.internal.format.l10n.ParsePosition,1,0,0,1,0,0,0,0,2
unitsofmeasurement_unit-ri.tec.units.ri.internal.format.l10n.AttributedCharacterFieldDelegate,0,0,0,0,0,0,0,0,0
unitsofmeasurement_unit-ri.tec.units.ri.internal.format.l10n.FieldPosition,3,0,0,1,0,0,0,0,4
unitsofmeasurement_unit-ri.tec.units.ri.internal.format.l10n.DigitList,2,0,0,2,0,0,0,0,4
unitsofmeasurement_unit-ri.tec.units.ri.internal.MathUtil,0,0,0,0,0,0,0,0,0
unitsofmeasurement_unit-ri.tec.units.ri.AbstractSystemOfUnits,2,0,0,1,0,0,0,0,3
unitsofmeasurement_unit-ri.tec.units.ri.format.QuantityFormat,3,0,0,2,0,1,0,0,6
unitsofmeasurement_unit-ri.tec.units.ri.format.AbstractUnitFormat,0,0,0,0,0,0,0,0,0
unitsofmeasurement_unit-ri.tec.units.ri.spi.Range,2,0,0,2,0,0,0,0,4
unitsofmeasurement_unit-ri.tec.units.ri.quantity.QuantityRange,0,0,0,0,0,0,0,0,0
unitsofmeasurement_unit-ri.tec.units.ri.internal.format.DefaultUnitFormatService,1,0,0,0,0,0,0,0,1
unitsofmeasurement_unit-ri.tec.units.ri.spi.DimensionalModel,1,0,0,1,0,0,0,0,2
unitsofmeasurement_unit-ri.tec.units.ri.quantity.QuantityDimension,0,0,0,0,0,0,0,0,0
unitsofmeasurement_unit-ri.tec.units.ri.AbstractUnit,0,0,0,0,0,0,0,0,0
unitsofmeasurement_unit-ri.tec.units.ri.unit.TransformedUnit,1,0,0,0,0,0,0,0,1
unitsofmeasurement_unit-ri.tec.units.ri.unit.Units,0,0,0,0,0,0,0,0,0
mongobee_mongobee.com.github.mongobee.utils.ChangeService,2,1,0,2,0,0,0,0,5
mongobee_mongobee.com.github.mongobee.dao.LockDao,0,0,0,0,0,0,0,0,0
mongobee_mongobee.com.github.mongobee.dao.ChangeEntryDao,0,0,0,0,0,0,0,5,5
mongobee_mongobee.com.github.mongobee.dao.ChangeEntryIndexDao,2,0,0,2,0,0,1,0,5
mongobee_mongobee.com.github.mongobee.Mongobee,3,0,0,3,0,0,0,7,13
PayPal_SeLion.com.paypal.selion.SeLionBuildInfo,0,0,0,0,0,0,0,0,0
nitram509_jmacaroons.com.github.nitram509.jmacaroons.CryptoTools,0,0,0,0,0,0,0,0,0
nitram509_jmacaroons.com.github.nitram509.jmacaroons.MacaroonsVerifier,4,0,0,4,0,0,0,0,8
nitram509_jmacaroons.com.github.nitram509.jmacaroons.MacaroonsBuilder,13,0,0,12,0,0,0,0,25
nitram509_jmacaroons.com.github.nitram509.jmacaroons.MacaroonsSerializerV2,1,0,0,1,0,0,0,0,2
nitram509_jmacaroons.com.github.nitram509.jmacaroons.Macaroon,2,0,0,1,0,0,0,1,4
nitram509_jmacaroons.com.github.nitram509.jmacaroons.verifier.TimestampCaveatVerifier,0,0,0,0,0,0,0,0,0
dashbuilder_dashbuilder.org.dashbuilder.renderer.google.client.GoogleDisplayer,0,0,0,0,0,0,0,2,2
dashbuilder_dashbuilder.org.dashbuilder.renderer.google.client.GoogleBarChartDisplayer,0,0,0,0,0,0,0,1,1
dashbuilder_dashbuilder.org.dashbuilder.renderer.google.client.GoogleTableDisplayer,2,0,0,2,0,0,0,2,6
dashbuilder_dashbuilder.org.dashbuilder.displayer.DisplayerSettingsBuilder,14,0,0,14,0,0,0,4,32
dashbuilder_dashbuilder.org.dashbuilder.renderer.client.metric.MetricDisplayer,1,0,0,1,0,0,0,4,6
dashbuilder_dashbuilder.org.dashbuilder.renderer.client.table.TableDisplayer,5,0,0,5,0,0,0,4,14
dashbuilder_dashbuilder.org.dashbuilder.displayer.client.DisplayerCoordinator,6,0,0,6,0,0,0,3,15
dashbuilder_dashbuilder.org.dashbuilder.renderer.client.selector.SelectorLabelSetDisplayer,3,0,0,3,0,0,0,4,10
dashbuilder_dashbuilder.org.dashbuilder.renderer.client.selector.SelectorSliderDisplayer,2,0,0,2,0,0,0,8,12
dashbuilder_dashbuilder.org.dashbuilder.displayer.client.AbstractDisplayer,4,0,0,4,0,0,0,2,10
dashbuilder_dashbuilder.org.dashbuilder.renderer.client.selector.SelectorDisplayer,0,0,0,0,0,0,0,5,5
dashbuilder_dashbuilder.org.dashbuilder.renderer.client.selector.SelectorDropDownDisplayer,4,0,0,4,0,0,0,4,12
dashbuilder_dashbuilder.org.dashbuilder.client.editor.DisplayerDragComponent,0,0,0,0,0,0,0,1,1
dashbuilder_dashbuilder.org.dashbuilder.client.navigation.NavigationManager,0,0,0,0,0,0,0,1,1
dashbuilder_dashbuilder.org.dashbuilder.navigation.NavTree,25,0,0,13,0,4,0,6,48
dashbuilder_dashbuilder.org.dashbuilder.navigation.NavFactory,4,0,0,4,0,0,0,6,14
dashbuilder_dashbuilder.org.dashbuilder.navigation.NavGroup,3,0,0,0,0,0,0,0,3
dashbuilder_dashbuilder.org.dashbuilder.dataset.client.DataSetClientServices,6,0,0,6,0,0,0,0,12
dashbuilder_dashbuilder.org.dashbuilder.dataset.editor.client.screens.DataSetDefEditorPresenter,2,0,0,2,0,0,0,12,16
dashbuilder_dashbuilder.org.dashbuilder.dataset.editor.client.screens.DataSetDefWizardScreen,1,0,0,1,0,0,0,7,9
dashbuilder_dashbuilder.org.dashbuilder.dataset.editor.client.screens.DataSetDefType,1,0,0,1,0,0,0,0,2
dashbuilder_dashbuilder.org.dashbuilder.dataset.editor.client.screens.DataSetAuthoringHomePresenter,0,0,0,0,0,0,0,2,2
dashbuilder_dashbuilder.org.dashbuilder.dataset.editor.client.screens.DataSetDefExplorerScreen,0,0,0,0,0,0,0,2,2
dashbuilder_dashbuilder.org.dashbuilder.displayer.client.Displayer,1,0,0,1,0,0,0,5,7
dashbuilder_dashbuilder.org.dashbuilder.displayer.client.PerspectiveCoordinator,1,0,0,1,0,0,0,0,2
dashbuilder_dashbuilder.org.dashbuilder.displayer.client.widgets.DisplayerTypeSelector,0,0,0,0,0,0,0,1,1
dashbuilder_dashbuilder.org.dashbuilder.displayer.client.widgets.RendererSelector,0,0,0,0,0,0,0,2,2
dashbuilder_dashbuilder.org.dashbuilder.displayer.client.widgets.DisplayerSubtypeSelector,0,0,0,0,0,0,0,3,3
dashbuilder_dashbuilder.org.dashbuilder.displayer.client.widgets.DisplayerSettingsEditor,4,0,0,3,0,0,0,4,11
dashbuilder_dashbuilder.org.dashbuilder.displayer.client.widgets.DisplayerEditor,1,0,0,1,0,0,0,6,8
dashbuilder_dashbuilder.org.dashbuilder.displayer.client.widgets.DataSetLookupEditor,4,0,0,4,0,0,0,8,16
dashbuilder_dashbuilder.org.dashbuilder.displayer.client.widgets.filter.DataSetFilterEditor,2,0,0,2,0,0,0,1,5
dashbuilder_dashbuilder.org.dashbuilder.displayer.client.widgets.filter.TextParameterEditor,0,0,0,0,0,0,0,1,1
dashbuilder_dashbuilder.org.dashbuilder.displayer.client.widgets.filter.TimeInstantEditor,0,0,0,0,0,0,0,0,0
dashbuilder_dashbuilder.org.dashbuilder.displayer.client.widgets.filter.TimeAmountEditor,0,0,0,0,0,0,0,2,2
dashbuilder_dashbuilder.org.dashbuilder.displayer.client.widgets.filter.LikeToFunctionEditor,0,0,0,0,0,0,0,1,1
dashbuilder_dashbuilder.org.dashbuilder.displayer.client.widgets.filter.TimeFrameEditor,0,0,0,0,0,0,0,0,0
dashbuilder_dashbuilder.org.dashbuilder.displayer.client.widgets.filter.NumberParameterEditor,0,0,0,0,0,0,0,1,1
dashbuilder_dashbuilder.org.dashbuilder.displayer.client.widgets.filter.MultipleTextParameterEditor,3,0,0,3,0,0,0,2,8
dashbuilder_dashbuilder.org.dashbuilder.displayer.client.widgets.filter.MultipleNumberParameterEditor,3,0,0,3,0,0,0,3,9
dashbuilder_dashbuilder.org.dashbuilder.displayer.client.widgets.filter.ColumnFilterEditor,0,0,0,0,0,0,0,0,0
dashbuilder_dashbuilder.org.dashbuilder.displayer.client.widgets.sourcecode.SourceCodeEditor,2,0,0,2,0,0,0,1,5
dashbuilder_dashbuilder.org.dashbuilder.displayer.client.widgets.sourcecode.DefaultJsValidator,5,0,0,0,0,0,0,0,5
dashbuilder_dashbuilder.org.dashbuilder.displayer.client.widgets.group.DataSetGroupDateEditor,0,0,0,0,0,0,0,3,3
dashbuilder_dashbuilder.org.dashbuilder.displayer.client.widgets.group.ColumnFunctionEditor,1,0,0,1,0,0,0,5,7
dashbuilder_dashbuilder.org.dashbuilder.common.client.StringTemplateBuilder,1,0,0,1,0,0,0,0,2
dashbuilder_dashbuilder.org.dashbuilder.common.client.editor.ToggleSwitchEditor,0,0,0,0,0,0,0,3,3
dashbuilder_dashbuilder.org.dashbuilder.common.client.editor.ValueBoxEditor,0,0,0,0,0,0,0,3,3
dashbuilder_dashbuilder.org.dashbuilder.common.client.editor.file.FileUploadEditor,1,0,0,1,0,0,0,5,7
dashbuilder_dashbuilder.org.dashbuilder.common.client.editor.map.MapEditor,2,0,0,0,0,0,0,2,4
dashbuilder_dashbuilder.org.dashbuilder.common.client.editor.list.DropDownEditor,3,0,0,2,0,0,0,0,5
dashbuilder_dashbuilder.org.dashbuilder.common.client.editor.list.DropDownImageListEditor,0,0,0,0,0,0,0,0,0
dashbuilder_dashbuilder.org.dashbuilder.common.client.widgets.FilterLabelSet,0,0,0,0,0,0,0,1,1
dashbuilder_dashbuilder.org.dashbuilder.client.widgets.common.ClientRuntimeErrorPopupPresenter,0,0,0,0,0,0,0,1,1
dashbuilder_dashbuilder.org.dashbuilder.client.widgets.common.LoadingBox,0,0,0,0,0,0,0,2,2
dashbuilder_dashbuilder.org.dashbuilder.client.widgets.dataset.explorer.DataSetSummary,0,0,0,0,0,0,0,5,5
dashbuilder_dashbuilder.org.dashbuilder.client.widgets.dataset.explorer.DataSetPanel,0,0,0,0,0,0,0,4,4
dashbuilder_dashbuilder.org.dashbuilder.client.widgets.dataset.explorer.DataSetExplorer,5,0,0,0,0,0,0,1,6
dashbuilder_dashbuilder.org.dashbuilder.client.widgets.dataset.editor.DataSetDefColumnsFilterEditor,0,0,0,0,0,0,0,5,5
dashbuilder_dashbuilder.org.dashbuilder.client.widgets.dataset.editor.DataSetDefProviderTypeEditor,0,0,0,0,0,0,0,1,1
dashbuilder_dashbuilder.org.dashbuilder.client.widgets.dataset.editor.DataSetDefPreviewTable,1,0,0,1,0,0,0,2,4
dashbuilder_dashbuilder.org.dashbuilder.client.widgets.dataset.editor.DataSetDefFilterEditor,0,0,0,0,0,0,0,1,1
dashbuilder_dashbuilder.org.dashbuilder.common.client.event.ContextualEvent,3,0,0,3,0,0,0,2,8
dashbuilder_dashbuilder.org.dashbuilder.common.client.error.ClientRuntimeError,0,0,0,0,0,0,0,1,1
dashbuilder_dashbuilder.org.dashbuilder.client.widgets.dataset.editor.bean.BeanDataSetEditor,0,0,0,0,0,0,0,0,0
dashbuilder_dashbuilder.org.dashbuilder.client.widgets.dataset.editor.DataSetEditor,0,0,0,0,0,0,0,0,0
dashbuilder_dashbuilder.org.dashbuilder.client.widgets.dataset.editor.bean.BeanDataSetDefAttributesEditor,0,0,0,0,0,0,0,1,1
dashbuilder_dashbuilder.org.dashbuilder.client.widgets.dataset.editor.column.DataSetDefColumnsEditor,0,0,0,0,0,0,0,5,5
dashbuilder_dashbuilder.org.dashbuilder.client.widgets.dataset.editor.column.ColumnListEditor,2,0,0,0,0,0,0,12,14
dashbuilder_dashbuilder.org.dashbuilder.client.widgets.dataset.editor.column.ColumnTypeEditor,0,0,0,0,0,0,0,6,6
dashbuilder_dashbuilder.org.dashbuilder.client.widgets.dataset.editor.column.DataColumnDefEditor,0,0,0,0,0,0,0,6,6
dashbuilder_dashbuilder.org.dashbuilder.client.widgets.dataset.editor.attributes.DataSetDefBasicAttributesEditor,0,0,0,0,0,0,0,1,1
dashbuilder_dashbuilder.org.dashbuilder.client.widgets.dataset.editor.attributes.DataSetDefRefreshIntervalEditor,0,0,0,0,0,0,0,6,6
dashbuilder_dashbuilder.org.dashbuilder.client.widgets.dataset.editor.attributes.DataSetDefBackendCacheAttributesEditor,0,0,0,0,0,0,0,4,4
dashbuilder_dashbuilder.org.dashbuilder.client.widgets.dataset.editor.attributes.DataSetDefRefreshAttributesEditor,0,0,0,0,0,0,0,1,1
dashbuilder_dashbuilder.org.dashbuilder.client.widgets.dataset.editor.attributes.DataSetDefClientCacheAttributesEditor,0,0,0,0,0,0,0,4,4
dashbuilder_dashbuilder.org.dashbuilder.client.widgets.dataset.editor.csv.CSVDataSetEditor,0,0,0,0,0,0,0,0,0
dashbuilder_dashbuilder.org.dashbuilder.client.widgets.dataset.editor.csv.CSVDataSetDefAttributesEditor,0,0,0,0,0,0,0,1,1
dashbuilder_dashbuilder.org.dashbuilder.client.widgets.dataset.editor.elasticsearch.ElasticSearchDataSetDefAttributesEditor,0,0,0,0,0,0,0,1,1
dashbuilder_dashbuilder.org.dashbuilder.client.widgets.dataset.editor.elasticsearch.ElasticSearchDataSetEditor,0,0,0,0,0,0,0,0,0
dashbuilder_dashbuilder.org.dashbuilder.client.widgets.dataset.editor.workflow.edit.DataSetEditWorkflow,0,0,0,0,0,0,0,7,7
dashbuilder_dashbuilder.org.dashbuilder.client.widgets.dataset.editor.workflow.edit.SQLDataSetEditWorkflow,0,0,0,0,0,0,0,4,4
dashbuilder_dashbuilder.org.dashbuilder.client.widgets.dataset.editor.workflow.edit.CSVDataSetEditWorkflow,0,0,0,0,0,0,0,4,4
dashbuilder_dashbuilder.org.dashbuilder.client.widgets.dataset.editor.workflow.edit.ElasticSearchDataSetEditWorkflow,0,0,0,0,0,0,0,0,0
dashbuilder_dashbuilder.org.dashbuilder.client.widgets.dataset.editor.workflow.edit.BeanDataSetEditWorkflow,0,0,0,0,0,0,0,0,0
dashbuilder_dashbuilder.org.dashbuilder.client.widgets.dataset.editor.workflow.DataSetEditorWorkflow,1,0,0,1,0,0,0,7,9
dashbuilder_dashbuilder.org.dashbuilder.client.widgets.dataset.editor.workflow.create.DataSetProviderTypeWorkflow,0,0,0,0,0,0,0,2,2
dashbuilder_dashbuilder.org.dashbuilder.client.widgets.dataset.editor.workflow.create.ElasticSearchDataSetBasicAttributesWorkflow,0,0,0,0,0,0,0,0,0
dashbuilder_dashbuilder.org.dashbuilder.client.widgets.dataset.editor.workflow.create.DataSetBasicAttributesWorkflow,0,0,0,0,0,0,0,2,2
dashbuilder_dashbuilder.org.dashbuilder.client.widgets.dataset.editor.workflow.create.BeanDataSetBasicAttributesWorkflow,0,0,0,0,0,0,0,0,0
dashbuilder_dashbuilder.org.dashbuilder.client.widgets.dataset.editor.workflow.create.CSVDataSetBasicAttributesWorkflow,0,0,0,0,0,0,0,4,4
dashbuilder_dashbuilder.org.dashbuilder.client.widgets.dataset.editor.workflow.create.SQLDataSetBasicAttributesWorkflow,0,0,0,0,0,0,0,4,4
dashbuilder_dashbuilder.org.dashbuilder.client.widgets.dataset.editor.sql.SQLDataSetDefAttributesEditor,0,0,0,0,0,0,0,1,1
dashbuilder_dashbuilder.org.dashbuilder.client.widgets.dataset.editor.sql.SQLDataSetEditor,0,0,0,0,0,0,0,0,0
dashbuilder_dashbuilder.org.dashbuilder.dataset.DataSetDefRegistryCDI,1,0,0,1,0,0,0,2,4
dashbuilder_dashbuilder.org.dashbuilder.Bootstrap,1,0,0,0,0,0,0,0,1
dashbuilder_dashbuilder.org.dashbuilder.dataset.service.DataSetExportServicesImpl,1,0,0,0,0,0,0,0,1
dashbuilder_dashbuilder.org.dashbuilder.navigation.service.LayoutTemplateAnalyzer,8,0,0,7,0,0,0,0,15
dashbuilder_dashbuilder.org.dashbuilder.navigation.workbench.NavSecurityController,2,0,0,2,0,0,0,0,4
dashbuilder_dashbuilder.org.dashbuilder.navigation.NavItemContext,3,0,0,3,0,0,0,0,6
dashbuilder_dashbuilder.org.dashbuilder.navigation.workbench.NavWorkbenchCtx,2,0,0,2,0,0,0,0,4
dashbuilder_dashbuilder.org.dashbuilder.navigation.impl.NavItemContextImpl,0,0,0,0,0,0,0,0,0
dashbuilder_dashbuilder.org.dashbuilder.navigation.json.NavTreeJSONMarshaller,1,0,0,1,0,0,0,0,2
dashbuilder_dashbuilder.org.dashbuilder.displayer.json.DisplayerSettingsJSONMarshaller,1,0,0,1,0,0,0,0,2
3breadt_dd-plist.com.dd.plist.NSDictionary,9,0,0,4,0,0,0,0,13
3breadt_dd-plist.com.dd.plist.PropertyListParser,1,0,0,1,0,0,0,0,2
3breadt_dd-plist.com.dd.plist.NSString,8,0,0,0,0,0,0,0,8
3breadt_dd-plist.com.dd.plist.NSObject,1,0,0,1,0,1,0,0,3
3breadt_dd-plist.com.dd.plist.NSNumber,0,0,0,0,0,0,0,0,0
liveoak-io_liveoak.io.liveoak.security.client.SecurityClient,2,0,0,2,0,0,0,2,6
liveoak-io_liveoak.io.liveoak.testtools.assertions.Assertions,0,0,0,0,0,0,0,15,15
liveoak-io_liveoak.io.liveoak.spi.state.ResourceState,119,3,0,106,0,0,1,1,230
liveoak-io_liveoak.io.liveoak.stomp.server.SimpleStompServer,3,0,0,3,0,0,0,0,6
liveoak-io_liveoak.io.liveoak.spi.resource.async.Resource,0,0,0,0,0,0,0,0,0
liveoak-io_liveoak.io.liveoak.mongo.launcher.MongoLauncher,1,1,0,1,0,0,0,0,3
liveoak-io_liveoak.io.liveoak.spi.client.Client,28,0,0,27,0,0,0,0,55
liveoak-io_liveoak.io.liveoak.testtools.AbstractHTTPResourceTestCase,4,0,0,4,0,0,0,0,8
liveoak-io_liveoak.io.liveoak.common.util.StringPropertyReplacer,2,0,0,0,0,0,0,0,2
liveoak-io_liveoak.io.liveoak.spi.resource.SynchronousResource,3,0,0,0,0,0,0,0,3
liveoak-io_liveoak.io.liveoak.spi.exceptions.ResourceException,1,0,0,0,0,1,0,0,2
liveoak-io_liveoak.io.liveoak.spi.util.ObjectMapperFactory,3,0,0,3,0,0,0,0,6
liveoak-io_liveoak.io.liveoak.spi.RequestAttributes,2,0,0,2,0,0,0,0,4
liveoak-io_liveoak.io.liveoak.common.DefaultResourceParams,0,0,0,0,0,0,0,0,0
liveoak-io_liveoak.io.liveoak.common.security.DefaultSecurityContext,1,0,0,1,0,0,0,1,3
liveoak-io_liveoak.io.liveoak.common.DefaultResourceRequest,6,0,0,6,0,0,0,0,12
liveoak-io_liveoak.io.liveoak.spi.ReturnFields,1,0,0,1,0,0,0,0,2
liveoak-io_liveoak.io.liveoak.common.DefaultReturnFields,1,0,0,0,0,0,0,0,1
liveoak-io_liveoak.io.liveoak.spi.ResourcePath,6,0,0,2,0,0,0,0,8
liveoak-io_liveoak.io.liveoak.stomp.client.StompClient,2,0,0,2,0,0,0,0,4
liveoak-io_liveoak.io.liveoak.container.LiveOakSystem,1,0,0,1,0,0,0,0,2
liveoak-io_liveoak.io.liveoak.container.tenancy.InternalApplication,1,0,0,1,0,0,0,1,3
liveoak-io_liveoak.io.liveoak.spi.MediaType,10,0,0,8,0,0,0,0,18
liveoak-io_liveoak.io.liveoak.container.traversal.TraversalPlan,2,0,0,0,0,0,0,0,2
liveoak-io_liveoak.io.liveoak.container.interceptor.InterceptorChain,4,0,0,2,0,0,0,0,6
liveoak-io_liveoak.io.liveoak.common.codec.DefaultResourceState,26,0,0,23,0,1,0,0,50
liveoak-io_liveoak.io.liveoak.container.tenancy.InternalApplicationRegistry,1,0,0,1,0,0,0,0,2
liveoak-io_liveoak.io.liveoak.container.tenancy.service.ApplicationsDeployerService,1,0,0,1,0,0,0,0,2
liveoak-io_liveoak.io.liveoak.container.extension.system.ExtensionInstaller,1,0,0,1,0,0,0,0,2
liveoak-io_liveoak.io.liveoak.common.codec.driver.EncodingDriver,3,0,0,3,0,0,0,0,6
liveoak-io_liveoak.io.liveoak.common.DefaultMediaTypeMatcher,3,0,0,3,0,0,0,0,6
liveoak-io_liveoak.io.liveoak.spi.MediaTypeMatcher,5,0,0,5,0,0,0,0,10
oldratlee_classloader-playground.com.oldratlee.land.matcher.LandMatcher,1,0,0,0,0,0,0,0,1
oldratlee_classloader-playground.com.oldratlee.land.LandClassLoader,2,0,0,0,0,0,0,0,2
NLPchina_ansj_seg.org.ansj.library.DicLibrary,0,0,0,0,0,0,0,9,9
NLPchina_ansj_seg.org.ansj.splitWord.analysis.NlpAnalysis,0,0,0,0,0,0,0,1,1
NLPchina_ansj_seg.org.ansj.splitWord.analysis.ToAnalysis,1,0,0,1,0,0,0,7,9
NLPchina_ansj_seg.org.ansj.splitWord.analysis.IndexAnalysis,0,0,0,0,0,0,0,1,1
NLPchina_ansj_seg.org.ansj.splitWord.analysis.BaseAnalysis,0,0,0,0,0,0,0,1,1
NLPchina_ansj_seg.org.ansj.splitWord.analysis.DicAnalysis,1,0,0,1,0,0,0,2,4
NLPchina_ansj_seg.org.ansj.dic.PathToStream,0,0,0,0,0,0,0,1,1
NLPchina_ansj_seg.org.ansj.app.crf.pojo.Element,1,0,0,1,0,0,0,0,2
NLPchina_ansj_seg.org.ansj.library.CrfLibrary,0,0,0,0,0,0,0,1,1
NLPchina_ansj_seg.org.ansj.app.crf.Config,0,0,0,0,0,0,0,0,0
NLPchina_ansj_seg.org.ansj.app.crf.Model,0,0,0,0,0,0,0,3,3
NLPchina_ansj_seg.org.ansj.app.crf.model.WapitiCRFModel,2,2,0,0,0,2,0,1,7
NLPchina_ansj_seg.org.ansj.app.crf.model.CRFppTxtModel,3,3,0,0,0,3,0,0,9
NLPchina_ansj_seg.org.ansj.app.extracting.Lexical,0,0,0,0,0,0,0,1,1
NLPchina_ansj_seg.org.ansj.app.extracting.ExtractingTask,0,0,0,0,0,0,0,0,0
NLPchina_ansj_seg.org.ansj.app.extracting.domain.ExtractingResult,0,0,0,0,0,0,0,1,1
NLPchina_ansj_seg.org.ansj.app.extracting.domain.Token,1,0,0,1,0,0,0,0,2
NLPchina_ansj_seg.org.ansj.app.extracting.domain.Rule,1,0,0,1,0,0,0,0,2
NLPchina_ansj_seg.org.ansj.app.keyword.KeyWordComputer,0,0,0,0,0,0,0,1,1
NLPchina_ansj_seg.org.ansj.app.keyword.Keyword,1,0,0,0,0,0,0,0,1
NLPchina_ansj_seg.org.ansj.app.summary.TagContent,0,0,0,0,0,0,0,9,9
NLPchina_ansj_seg.org.ansj.domain.Result,1,0,0,1,0,0,0,9,11
NLPchina_ansj_seg.org.ansj.recognition.impl.DicRecognition,0,0,0,0,0,0,0,0,0
NLPchina_ansj_seg.org.ansj.recognition.impl.NatureRecognition,0,0,0,0,0,0,0,1,1
NLPchina_ansj_seg.org.ansj.domain.Term,0,0,0,0,0,0,0,0,0
jodastephen_property-alliance.org.joda.pa.MetaProperty,9,0,0,0,0,0,0,0,9
kzwang_elasticsearch-image.org.elasticsearch.index.query.image.ImageQueryBuilder,1,0,0,1,0,0,0,0,2
google_error-prone.com.google.errorprone.BugPatternValidator,0,0,0,0,0,0,0,7,7
google_error-prone.com.google.errorprone.BugPatternFileGenerator,0,0,0,0,0,0,0,0,0
google_error-prone.com.google.errorprone.BugPatternIndexWriter,0,0,0,0,0,0,0,0,0
google_error-prone.com.google.errorprone.ErrorProneOptions,8,0,0,1,0,0,0,0,9
google_error-prone.com.google.errorprone.ErrorProneFlags,7,0,0,5,0,0,0,0,12
google_error-prone.com.google.errorprone.DiagnosticTestHelper,31,0,0,20,0,0,1,0,52
google_error-prone.com.google.errorprone.VisitorState,3,0,0,1,0,0,0,0,4
google_error-prone.com.google.errorprone.BaseErrorProneJavaCompiler,2,0,0,0,0,0,0,1,3
google_error-prone.com.google.errorprone.FileManagers,1,0,0,1,0,0,0,0,2
google_error-prone.com.google.errorprone.CompilationTestHelper,5,0,0,0,0,0,19,3367,3391
google_error-prone.com.google.errorprone.BugCheckerRefactoringTestHelper,3,0,0,0,0,2,5,1066,1076
google_error-prone.com.google.errorprone.scanner.ScannerSupplier,2,0,0,2,0,0,0,15,19
google_error-prone.com.google.errorprone.apply.BasicImportOrganizer,0,0,0,0,0,0,0,0,0
google_error-prone.com.google.errorprone.apply.ImportStatements,11,0,0,10,0,0,0,0,21
google_error-prone.com.google.errorprone.apply.SourceFile,3,0,0,1,0,0,0,0,4
google_error-prone.com.google.errorprone.apply.AndroidImportOrganizer,0,0,0,0,0,0,0,0,0
google_error-prone.com.google.errorprone.apply.IdeaImportOrganizer,0,0,0,0,0,0,0,0,0
google_error-prone.com.google.errorprone.dataflow.AccessPathStore,1,0,0,1,0,0,0,0,2
google_error-prone.com.google.errorprone.matchers.StringLiteral,1,0,0,0,0,2,0,0,3
google_error-prone.com.google.errorprone.matchers.Description,2,0,0,2,0,0,0,0,4
google_error-prone.com.google.errorprone.matchers.Matchers,28,0,0,4,0,0,0,6,38
google_error-prone.com.google.errorprone.suppliers.Suppliers,0,0,0,0,0,0,0,1,1
google_error-prone.com.google.errorprone.util.RuntimeVersion,0,0,0,0,0,0,0,30,30
google_error-prone.com.google.errorprone.fixes.BranchedSuggestedFixes,1,0,0,1,0,0,0,0,2
google_error-prone.com.google.errorprone.fixes.Replacements,3,0,0,3,0,2,0,1,9
google_error-prone.com.google.errorprone.fixes.AppliedFix,0,0,0,0,0,0,0,1,1
google_error-prone.com.google.errorprone.fixes.SuggestedFixes,1,0,0,0,0,0,0,0,1
google_error-prone.com.google.errorprone.fixes.SuggestedFix,0,0,0,0,0,0,0,0,0
google_error-prone.com.google.errorprone.names.TermEditDistance,0,0,0,0,0,0,0,0,0
google_error-prone.com.google.errorprone.names.NamingConventions,0,0,0,0,0,0,0,0,0
google_error-prone.com.google.errorprone.names.NeedlemanWunschEditDistance,0,0,0,0,0,0,0,0,0
google_error-prone.com.google.errorprone.bugpatterns.inlineme.InlineMeData,0,0,0,0,0,0,0,0,0
google_error-prone.com.google.errorprone.bugpatterns.apidiff.ApiDiff,2,0,0,2,0,0,0,0,4
google_error-prone.com.google.errorprone.bugpatterns.javadoc.InvalidInlineTag,0,0,0,0,0,0,0,0,0
google_error-prone.com.google.errorprone.bugpatterns.checkreturnvalue.Api,6,0,0,6,0,0,0,0,12
google_error-prone.com.google.errorprone.refaster.UThrow,0,0,0,0,0,0,0,2,2
google_error-prone.com.google.errorprone.refaster.UExpressionStatement,0,0,0,0,0,0,0,4,4
google_error-prone.com.google.errorprone.refaster.UWildcardType,0,0,0,0,0,0,0,2,2
google_error-prone.com.google.errorprone.refaster.UTypeCast,0,0,0,0,0,0,0,2,2
google_error-prone.com.google.errorprone.refaster.UPrimitiveType,0,0,0,0,0,0,0,1,1
google_error-prone.com.google.errorprone.refaster.UVariableDecl,0,0,0,0,0,0,0,2,2
google_error-prone.com.google.errorprone.refaster.USynchronized,0,0,0,0,0,0,0,2,2
google_error-prone.com.google.errorprone.refaster.UBinary,0,0,0,0,0,0,0,2,2
google_error-prone.com.google.errorprone.refaster.UForAll,0,0,0,0,0,0,0,2,2
google_error-prone.com.google.errorprone.refaster.UConditional,0,0,0,0,0,0,0,2,2
google_error-prone.com.google.errorprone.refaster.UDoWhileLoop,0,0,0,0,0,0,0,2,2
google_error-prone.com.google.errorprone.refaster.UTypeVar,0,0,0,0,0,0,0,6,6
google_error-prone.com.google.errorprone.refaster.UInstanceOf,0,0,0,0,0,0,0,2,2
google_error-prone.com.google.errorprone.refaster.UMethodInvocation,0,0,0,0,0,0,0,0,0
google_error-prone.com.google.errorprone.refaster.Inlineable,0,0,0,0,0,0,0,0,0
google_error-prone.com.google.errorprone.refaster.ULiteral,8,0,0,8,0,0,0,3,19
google_error-prone.com.google.errorprone.refaster.UMemberSelect,0,0,0,0,0,0,0,3,3
google_error-prone.com.google.errorprone.refaster.UClassIdent,2,0,0,0,0,0,0,14,16
google_error-prone.com.google.errorprone.refaster.UContinue,0,0,0,0,0,0,0,2,2
google_error-prone.com.google.errorprone.refaster.Choice,1,0,0,1,0,0,0,0,2
google_error-prone.com.google.errorprone.refaster.ULocalVarIdent,0,0,0,0,0,0,0,2,2
google_error-prone.com.google.errorprone.refaster.UEnhancedForLoop,0,0,0,0,0,0,0,2,2
google_error-prone.com.google.errorprone.refaster.UTemplater,0,0,0,0,0,0,0,0,0
google_error-prone.com.google.errorprone.refaster.UWhileLoop,0,0,0,0,0,0,0,2,2
google_error-prone.com.google.errorprone.refaster.UForLoop,0,0,0,0,0,0,0,2,2
google_error-prone.com.google.errorprone.refaster.UPrimitiveTypeTree,0,0,0,0,0,0,0,1,1
google_error-prone.com.google.errorprone.refaster.RefasterRule,1,0,0,0,0,0,0,0,1
google_error-prone.com.google.errorprone.refaster.UType,0,0,0,0,0,0,0,0,0
google_error-prone.com.google.errorprone.refaster.ULabeledStatement,0,0,0,0,0,0,0,2,2
google_error-prone.com.google.errorprone.refaster.UAssignOp,0,0,0,0,0,0,0,2,2
google_error-prone.com.google.errorprone.refaster.UReturn,0,0,0,0,0,0,0,2,2
google_error-prone.com.google.errorprone.refaster.UWildcard,0,0,0,0,0,0,0,2,2
google_error-prone.com.google.errorprone.refaster.UTypeVarIdent,1,0,0,0,0,0,0,2,3
google_error-prone.com.google.errorprone.refaster.UAssign,0,0,0,0,0,0,0,2,2
google_error-prone.com.google.errorprone.refaster.UArrayType,0,0,0,0,0,0,0,3,3
google_error-prone.com.google.errorprone.refaster.UArrayAccess,0,0,0,0,0,0,0,0,0
google_error-prone.com.google.errorprone.refaster.UIf,0,0,0,0,0,0,0,2,2
google_error-prone.com.google.errorprone.refaster.ExpressionTemplate,0,0,0,0,0,0,0,5,5
google_error-prone.com.google.errorprone.refaster.UParens,0,0,0,0,0,0,0,2,2
google_error-prone.com.google.errorprone.refaster.UFreeIdent,1,0,0,1,0,0,0,2,4
google_error-prone.com.google.errorprone.refaster.UBreak,0,0,0,0,0,0,0,2,2
google_error-prone.com.google.errorprone.apply.DescriptionBasedDiff,1,0,0,1,0,0,0,0,2
google_error-prone.com.google.errorprone.refaster.UUnary,0,0,0,0,0,0,0,2,2
google_error-prone.com.google.errorprone.refaster.URepeated,1,0,0,1,0,0,0,2,4
google_error-prone.com.google.errorprone.refaster.UArrayTypeTree,0,0,0,0,0,0,0,2,2
kaazing_robot.org.kaazing.k3po.junit.rules.K3poRule,0,0,0,0,0,0,14,773,787
kaazing_robot.org.kaazing.k3po.driver.internal.Robot,39,0,0,39,0,0,1,3,82
kaazing_robot.org.kaazing.k3po.driver.internal.netty.channel.ChannelAddressFactory,2,0,0,2,0,0,0,1,5
kaazing_robot.org.kaazing.k3po.driver.internal.netty.channel.ChannelAddressFactorySpi,0,0,0,0,0,0,0,0,0
kaazing_robot.org.kaazing.k3po.driver.internal.behavior.ScriptProgress,1,0,0,1,0,0,0,0,2
kaazing_robot.org.kaazing.k3po.lang.internal.RegionInfo,0,0,0,0,0,0,0,2,2
kaazing_robot.org.kaazing.k3po.driver.internal.behavior.handler.ExecutionHandler,71,0,0,7,0,0,0,0,78
kaazing_robot.org.kaazing.k3po.driver.internal.netty.channel.Channels,0,0,0,0,0,0,0,0,0
kaazing_robot.org.kaazing.k3po.driver.internal.behavior.handler.codec.Masker,4,0,0,3,0,0,0,0,7
kaazing_robot.org.kaazing.k3po.driver.internal.behavior.handler.codec.MessageDecoder,32,0,0,0,0,0,0,0,32
kaazing_robot.org.kaazing.k3po.lang.internal.regex.NamedGroupPattern,15,0,0,15,0,0,0,6,36
kaazing_robot.org.kaazing.k3po.driver.internal.behavior.handler.codec.http.HttpMethodDecoder,0,0,0,0,0,0,0,0,0
kaazing_robot.org.kaazing.k3po.driver.internal.behavior.handler.barrier.AwaitBarrierDownstreamHandler,2,0,0,2,0,0,0,0,4
kaazing_robot.org.kaazing.k3po.driver.internal.behavior.handler.barrier.AwaitBarrierUpstreamHandler,2,0,0,2,0,0,0,0,4
kaazing_robot.org.kaazing.k3po.lang.internal.ast.builder.AstScriptNodeBuilder,0,0,0,0,0,0,0,6,6
kaazing_robot.org.kaazing.k3po.driver.internal.control.PreparedMessage,0,0,0,0,0,0,0,0,0
kaazing_robot.org.kaazing.k3po.driver.internal.control.ErrorMessage,0,0,0,0,0,0,0,0,0
kaazing_robot.org.kaazing.k3po.driver.internal.control.FinishedMessage,0,0,0,0,0,0,0,0,0
kaazing_robot.org.kaazing.k3po.driver.internal.control.PrepareMessage,0,0,0,0,0,0,0,0,0
kaazing_robot.org.kaazing.k3po.lang.internal.ast.builder.AstWriteConfigNodeBuilder,10,0,0,10,0,0,0,0,20
kaazing_robot.org.kaazing.k3po.lang.internal.ast.builder.AstReadConfigNodeBuilder,7,0,0,7,0,0,0,0,14
kaazing_robot.org.kaazing.k3po.lang.internal.ast.builder.AstReadClosedNodeBuilder,1,0,0,1,0,0,0,0,2
kaazing_robot.org.kaazing.k3po.lang.internal.ast.builder.AstWriteFlushNodeBuilder,1,0,0,1,0,0,0,0,2
kaazing_robot.org.kaazing.k3po.lang.internal.ast.builder.AstWriteCloseNodeBuilder,1,0,0,1,0,0,0,0,2
kaazing_robot.org.kaazing.k3po.lang.internal.ast.builder.AstWriteOptionNodeBuilder,1,0,0,1,0,0,0,0,2
kaazing_robot.org.kaazing.k3po.lang.internal.ast.builder.AstReadOptionNodeBuilder,1,0,0,1,0,0,0,0,2
kaazing_robot.org.kaazing.k3po.pcap.converter.internal.author.emitter.EmitterFactoryImpl,0,0,0,0,0,0,0,0,0
kaazing_robot.org.kaazing.k3po.pcap.converter.internal.author.composer.TcpServerComposer,2,0,0,3,0,0,0,0,5
kaazing_robot.org.kaazing.k3po.pcap.converter.internal.PcapConverter,9,0,0,0,0,5,0,0,14
kaazing_robot.org.kaazing.k3po.pcap.converter.internal.author.composer.TcpClientComposer,2,0,0,3,0,0,0,0,5
kaazing_robot.org.kaazing.k3po.pcap.converter.internal.filter.IpFilter,0,0,0,0,0,0,0,0,0
kaazing_robot.org.kaazing.k3po.pcap.converter.internal.author.RptScriptCreator,0,0,0,0,0,0,0,0,0
kaazing_robot.org.kaazing.k3po.pcap.converter.internal.author.emitter.EmitterFactory,0,0,0,0,0,0,0,0,0
kaazing_robot.org.kaazing.k3po.pcap.converter.internal.packet.Packet,1,0,0,1,0,0,0,0,2
kaazing_robot.org.kaazing.k3po.pcap.converter.internal.author.coordinator.TcpCoordinator,0,0,0,4,0,0,0,0,4
kaazing_robot.org.kaazing.k3po.pcap.converter.internal.filter.Filter,0,0,0,0,0,0,0,0,0
kaazing_robot.org.kaazing.k3po.pcap.converter.internal.parser.Parser,1,1,0,1,0,0,0,0,3
kaazing_robot.org.kaazing.k3po.pcap.converter.internal.author.script.ByteArrayWriter,0,0,0,0,0,0,0,6,6
kaazing_robot.org.kaazing.specification.ws.internal.Functions,0,0,0,0,0,0,0,0,0
kaazing_robot.org.kaazing.specification.wse.internal.Functions,2,0,0,1,0,0,0,0,3
kaazing_robot.org.kaazing.k3po.lang.internal.parser.ScriptParserImpl,13,0,0,13,0,0,1,0,27
kaazing_robot.org.kaazing.k3po.lang.internal.ast.AstReadValueNode,4,0,0,4,0,0,0,0,8
kaazing_robot.org.kaazing.k3po.lang.internal.ast.AstWriteValueNode,2,0,0,2,0,0,0,0,4
kaazing_robot.org.kaazing.k3po.lang.internal.ast.builder.AstAcceptNodeBuilder,0,0,0,0,0,0,0,0,0
kaazing_robot.org.kaazing.k3po.lang.internal.ast.builder.AstRejectedNodeBuilder,0,0,0,0,0,0,0,0,0
kaazing_robot.org.kaazing.k3po.lang.internal.ast.builder.AstConnectAbortNodeBuilder,0,0,0,0,0,0,0,0,0
kaazing_robot.org.kaazing.k3po.lang.internal.ast.builder.AstConnectAbortedNodeBuilder,0,0,0,0,0,0,0,0,0
kaazing_robot.org.kaazing.k3po.lang.internal.ast.builder.AstCloseNodeBuilder,0,0,0,0,0,0,0,0,0
kaazing_robot.org.kaazing.k3po.lang.internal.ast.builder.AstWriteAbortNodeBuilder,0,0,0,0,0,0,0,0,0
kaazing_robot.org.kaazing.k3po.lang.internal.ast.builder.AstReadAbortNodeBuilder,0,0,0,0,0,0,0,0,0
kaazing_robot.org.kaazing.k3po.lang.internal.ast.builder.AstReadAbortedNodeBuilder,0,0,0,0,0,0,0,0,0
kaazing_robot.org.kaazing.k3po.lang.internal.ast.builder.AstWriteAbortedNodeBuilder,0,0,0,0,0,0,0,0,0
kaazing_robot.org.kaazing.k3po.lang.internal.ast.builder.AstClosedNodeBuilder,0,0,0,0,0,0,0,0,0
kaazing_robot.org.kaazing.k3po.lang.internal.ast.builder.AstConnectedNodeBuilder,0,0,0,0,0,0,0,0,0
kaazing_robot.org.kaazing.k3po.lang.internal.ast.builder.AstReadNodeBuilder,14,0,0,14,0,0,0,0,28
kaazing_robot.org.kaazing.k3po.lang.internal.ast.builder.AstWriteNodeBuilder,12,0,0,12,0,0,0,0,24
kaazing_robot.org.kaazing.k3po.lang.internal.ast.builder.AstReadAwaitNodeBuilder,1,0,0,1,0,0,0,0,2
kaazing_robot.org.kaazing.k3po.lang.internal.ast.builder.AstReadNotifyNodeBuilder,1,0,0,1,0,0,0,0,2
kaazing_robot.org.kaazing.k3po.lang.internal.ast.builder.AstWriteAwaitNodeBuilder,1,0,0,1,0,0,0,0,2
kaazing_robot.org.kaazing.k3po.lang.internal.ast.builder.AstWriteNotifyNodeBuilder,1,0,0,1,0,0,0,0,2
kaazing_robot.org.kaazing.k3po.lang.internal.ast.builder.AstReadAdviseNodeBuilder,0,0,0,0,0,0,0,0,0
kaazing_robot.org.kaazing.k3po.lang.internal.ast.builder.AstWriteAdviseNodeBuilder,0,0,0,0,0,0,0,0,0
kaazing_robot.org.kaazing.k3po.lang.internal.ast.builder.AstReadAdvisedNodeBuilder,0,0,0,0,0,0,0,0,0
kaazing_robot.org.kaazing.k3po.lang.internal.ast.builder.AstWriteAdvisedNodeBuilder,0,0,0,0,0,0,0,0,0
kaazing_robot.org.kaazing.k3po.lang.internal.ast.builder.AstPropertyNodeBuilder,0,0,0,0,0,0,0,0,0
kaazing_robot.org.kaazing.k3po.lang.el.spi.FunctionMapperSpi,2,0,0,0,0,0,0,0,2
kaazing_robot.org.kaazing.k3po.control.internal.Control,0,0,0,0,0,0,0,6,6
raydac_java-binary-block-parser.com.igormaznitsa.jbbp.JBBPParser,196,2,0,157,0,9,0,26,390
raydac_java-binary-block-parser.com.igormaznitsa.jbbp.compiler.tokenizer.JBBPFieldTypeParameterContainer,5,2,0,4,0,0,0,0,11
raydac_java-binary-block-parser.com.igormaznitsa.jbbp.JBBPNamedNumericFieldMap,18,0,0,13,0,1,0,0,32
raydac_java-binary-block-parser.com.igormaznitsa.jbbp.utils.JBBPUtils,27,2,0,3,0,2,0,0,34
raydac_java-binary-block-parser.com.igormaznitsa.jbbp.utils.JBBPDslBuilder,41,0,0,41,0,1,0,2,85
raydac_java-binary-block-parser.com.igormaznitsa.jbbp.utils.JBBPCustomFieldTypeProcessorAggregator,1,0,0,0,0,1,0,0,2
raydac_java-binary-block-parser.com.igormaznitsa.jbbp.utils.JBBPIntCounter,7,0,0,1,0,0,0,0,8
raydac_java-binary-block-parser.com.igormaznitsa.jbbp.utils.JBBPTextWriter,13,0,0,11,0,1,0,0,25
raydac_java-binary-block-parser.com.igormaznitsa.jbbp.compiler.JBBPCompiler,33,0,0,26,0,8,0,1,68
raydac_java-binary-block-parser.com.igormaznitsa.jbbp.compiler.conversion.JBBPToJavaConverter,1,0,0,1,0,0,0,0,2
raydac_java-binary-block-parser.com.igormaznitsa.jbbp.io.JBBPOut,36,0,0,33,0,0,0,0,69
raydac_java-binary-block-parser.com.igormaznitsa.jbbp.model.JBBPFieldInt,6,0,0,3,0,0,0,0,9
raydac_java-binary-block-parser.com.igormaznitsa.jbbp.io.JBBPBitInputStream,48,0,0,44,0,1,0,0,93
raydac_java-binary-block-parser.com.igormaznitsa.jbbp.compiler.tokenizer.JBBPTokenizer,23,0,0,22,0,13,0,0,58
raydac_java-binary-block-parser.com.igormaznitsa.jbbp.compiler.tokenizer.JBBPToken,2,2,0,2,0,0,0,0,6
raydac_java-binary-block-parser.com.igormaznitsa.jbbp.compiler.varlen.JBBPOnlyFieldEvaluator,2,0,0,2,0,0,0,0,4
raydac_java-binary-block-parser.com.igormaznitsa.jbbp.compiler.varlen.JBBPExpressionEvaluator,38,1,0,38,0,0,0,0,77
raydac_java-binary-block-parser.com.igormaznitsa.jbbp.io.JBBPBitOutputStream,38,3,0,36,0,0,0,0,77
raydac_java-binary-block-parser.com.igormaznitsa.jbbp.model.JBBPAbstractField,19,0,0,19,0,0,0,0,38
raydac_java-binary-block-parser.com.igormaznitsa.jbbp.model.JBBPFieldArrayUInt,2,0,0,2,0,0,0,0,4
raydac_java-binary-block-parser.com.igormaznitsa.jbbp.model.JBBPFieldUInt,3,0,0,0,0,0,0,0,3
raydac_java-binary-block-parser.com.igormaznitsa.jbbp.model.JBBPFieldArrayLong,2,0,0,2,0,0,0,0,4
raydac_java-binary-block-parser.com.igormaznitsa.jbbp.model.JBBPFieldLong,2,0,0,0,0,0,0,0,2
raydac_java-binary-block-parser.com.igormaznitsa.jbbp.model.JBBPFieldArrayBit,3,0,0,3,0,0,0,0,6
raydac_java-binary-block-parser.com.igormaznitsa.jbbp.model.JBBPFieldBit,4,0,0,1,0,0,0,0,5
raydac_java-binary-block-parser.com.igormaznitsa.jbbp.model.JBBPFieldArrayUShort,2,0,0,2,0,0,0,0,4
raydac_java-binary-block-parser.com.igormaznitsa.jbbp.model.JBBPFieldUShort,3,0,0,0,0,0,0,0,3
raydac_java-binary-block-parser.com.igormaznitsa.jbbp.model.JBBPFieldBoolean,3,0,0,0,0,0,0,0,3
raydac_java-binary-block-parser.com.igormaznitsa.jbbp.model.JBBPFieldArrayShort,2,0,0,2,0,0,0,0,4
raydac_java-binary-block-parser.com.igormaznitsa.jbbp.model.JBBPFieldShort,3,0,0,0,0,0,0,0,3
raydac_java-binary-block-parser.com.igormaznitsa.jbbp.model.JBBPFieldString,1,0,0,0,0,0,0,0,1
raydac_java-binary-block-parser.com.igormaznitsa.jbbp.model.JBBPFieldArrayUByte,2,0,0,2,0,0,0,0,4
raydac_java-binary-block-parser.com.igormaznitsa.jbbp.model.AbstractFieldByteArray,0,0,0,0,0,0,0,0,0
raydac_java-binary-block-parser.com.igormaznitsa.jbbp.model.JBBPFieldUByte,3,0,0,0,0,0,0,0,3
raydac_java-binary-block-parser.com.igormaznitsa.jbbp.model.JBBPFieldStruct,7,0,0,3,0,0,0,0,10
raydac_java-binary-block-parser.com.igormaznitsa.jbbp.exceptions.JBBPTooManyFieldsFoundException,1,0,0,0,0,1,0,0,2
raydac_java-binary-block-parser.com.igormaznitsa.jbbp.model.JBBPFieldArrayStruct,2,0,0,1,0,0,0,0,3
raydac_java-binary-block-parser.com.igormaznitsa.jbbp.model.JBBPFieldArrayInt,2,0,0,2,0,0,0,0,4
raydac_java-binary-block-parser.com.igormaznitsa.jbbp.model.JBBPFieldByte,3,0,0,0,0,0,0,0,3
raydac_java-binary-block-parser.com.igormaznitsa.jbbp.model.JBBPFieldArrayByte,3,0,0,3,0,0,0,0,6
raydac_java-binary-block-parser.com.igormaznitsa.jbbp.model.JBBPFieldArrayBoolean,3,0,0,2,0,0,0,0,5
raydac_java-binary-block-parser.com.igormaznitsa.jbbp.model.JBBPFieldArrayString,2,0,0,2,0,0,0,0,4
raydac_java-binary-block-parser.com.igormaznitsa.jbbp.exceptions.JBBPMapperException,2,0,0,1,0,0,0,0,3
raydac_java-binary-block-parser.com.igormaznitsa.jbbp.exceptions.JBBPTokenizerException,3,0,0,0,0,0,0,0,3
sanjivsingh_stackoverflow-java-sdk.com.google.code.stackexchange.client.query.QuestionApiQuery,11,0,0,11,0,0,0,0,22
sanjivsingh_stackoverflow-java-sdk.com.google.code.stackexchange.client.query.QuestionTimelineApiQuery,1,0,0,1,0,0,0,0,2
sanjivsingh_stackoverflow-java-sdk.com.google.code.stackexchange.client.query.StackExchangeApiQueryFactory,24,0,0,0,0,0,0,0,24
sanjivsingh_stackoverflow-java-sdk.com.google.code.stackexchange.client.query.AdvanceSearchApiQuery,1,0,0,1,0,0,0,0,2
sanjivsingh_stackoverflow-java-sdk.com.google.code.stackexchange.client.query.TagApiQuery,1,0,0,1,0,0,0,0,2
sanjivsingh_stackoverflow-java-sdk.com.google.code.stackexchange.client.query.CommentApiQuery,8,0,0,8,0,0,0,0,16
sanjivsingh_stackoverflow-java-sdk.com.google.code.stackexchange.client.query.UserTimelineApiQuery,1,0,0,1,0,0,0,0,2
sanjivsingh_stackoverflow-java-sdk.com.google.code.stackexchange.client.query.UserApiQuery,2,0,0,2,0,0,0,0,4
sanjivsingh_stackoverflow-java-sdk.com.google.code.stackexchange.client.query.StackExchangeApiQuery,0,0,0,0,0,0,0,0,0
sanjivsingh_stackoverflow-java-sdk.com.google.code.stackexchange.client.query.BadgeApiQuery,0,0,0,0,0,0,0,0,0
sanjivsingh_stackoverflow-java-sdk.com.google.code.stackexchange.client.query.ReputationApiQuery,3,0,0,3,0,0,0,0,6
sanjivsingh_stackoverflow-java-sdk.com.google.code.stackexchange.client.query.RevisionApiQuery,1,0,0,1,0,0,0,0,2
sanjivsingh_stackoverflow-java-sdk.com.google.code.stackexchange.client.query.NotificationApiQuery,0,0,0,0,0,0,0,0,0
sanjivsingh_stackoverflow-java-sdk.com.google.code.stackexchange.client.StackExchangeApiClient,6,0,0,0,0,0,0,0,6
lejon_T-SNE-Java.com.jujutsu.tsne.barneshut.DataPoint,0,0,0,0,0,0,0,0,0
lejon_T-SNE-Java.com.jujutsu.tsne.barneshut.VpTree,0,0,0,0,0,0,0,1,1
lejon_T-SNE-Java.com.jujutsu.tsne.barneshut.AtomicDouble,0,0,0,0,0,0,0,0,0
lejon_T-SNE-Java.com.jujutsu.utils.MatrixUtils,3,0,0,3,0,0,0,43,49
lejon_T-SNE-Java.com.jujutsu.utils.MatrixOps,1,2,0,1,0,0,0,3,7
