Repo,Assertion roulette,Conditional test logic,Constructor initialization,Eager test,Empty test,Exception handling,Ignored tests,Unknown test,Total
mpetazzoni_ttorrent,5,0,0,5,0,0,0,2,12
Graphify_graphify,2,0,0,0,0,0,2,4,8
jbake-org_jbake,100,2,1,0,0,0,0,32,135
andrewgaul_s3proxy,101,5,0,2,0,21,2,4,135
apache_storm,537,13,7,364,0,13,0,251,1185
palominolabs_jvm-ssh-groovy-shell,5,0,0,0,0,0,0,0,5
jai-imageio_jai-imageio-jpeg2000,2,0,0,1,0,0,0,1,4
Cube-Space_Yamler,0,0,0,0,0,0,0,2,2
lumifyio_lumify,62,6,1,0,0,3,1,40,113
apache_incubator-reef,108,9,12,0,0,38,0,172,339
linkedin_Cubert,15,0,1,0,0,0,0,33,49
renepickhardt_generalized-language-modeling-toolkit,9,0,0,2,0,0,0,0,11
NLPchina_nlp-lang,3,0,0,1,0,0,0,16,20
kkapelon_java-testing-with-spock,10,0,1,0,0,0,0,3,14
jordw_heftydb,8,0,11,0,0,1,0,5,25
prometheus_jmx_exporter,12,0,4,2,0,0,0,11,29
ethereum_ethereumj,453,29,8,0,4,24,62,327,907
tehmou_rx-android-architecture,17,0,0,0,0,1,4,10,32
martinpaljak_GlobalPlatform,8,0,0,0,0,0,0,5,13
graphaware_neo4j-reco,15,0,0,1,0,0,0,0,16
gosu-lang_gosu-lang,8,0,0,0,0,0,0,150,158
google_closure-compiler,2140,30,48,0,3,37,80,14332,16670
SahaginOrg_sahagin-java,14,0,0,3,72,8,0,191,288
looly_hutool,990,4,2,0,1,15,353,402,1767
SoftInstigate_restheart,131,2,0,0,0,22,1,54,210
spotify_trickle,10,0,0,5,0,6,0,19,40
chanedi_QuickProject,0,0,0,0,0,0,0,6,6
reds-heig_logisim-evolution,25,0,0,0,0,0,0,4,29
wildfly-security_wildfly-elytron,734,24,1,360,1,67,15,410,1612
tesseradata_RHIPE,0,0,0,0,11,0,0,15,26
Azure_azure-storage-android,358,22,0,0,0,164,0,177,721
WhisperSystems_BitHub,1,0,0,0,0,0,0,6,7
JCTools_JCTools,122,17,9,53,0,7,0,22,230
dev9com_parallel-webtest,22,2,5,0,0,0,3,23,55
sharneng_gm4java,9,0,0,3,0,1,0,81,94
bedrin_jdbc-sniffer,245,19,1,109,0,89,0,209,672
petitparser_java-petitparser,167,1,0,78,0,0,0,219,465
mulesoft_jaxrs-to-raml,42,1,0,0,0,1,0,3,47
Conductor_kangaroo,27,0,0,0,0,0,0,12,39
square_burst,13,0,7,0,0,0,0,8,28
grpc_grpc-java,1907,29,4,0,10,306,9,812,3077
ObsidianBox_Obsidian,3,2,0,0,0,1,0,0,6
highsource_jaxb2-annotate-plugin,5,0,0,0,0,0,0,1,6
rjenkins_ursus,3,0,0,0,0,0,0,0,3
skroutz_elasticsearch-analysis-turkishstemmer,29,0,0,0,0,0,0,0,29
ceskaexpedice_kramerius,156,5,0,0,1,10,2,44,218
xaguzman_pathfinding,4,0,0,0,0,0,0,0,4
elastic_elasticsearch,16,1,0,0,0,1,0,81,99
mono_sharpen,17,0,0,0,0,3,1,251,272
englishtown_vertx-jersey,35,1,1,4,0,1,1,28,71
jooby-project_jooby,176,0,0,63,0,2,0,16,257
ZheYuan_Mario,33,0,0,0,1,1,0,1,36
openhab_jmdns,51,1,0,32,0,0,2,12,98
mulesoft_raml-jaxrs-codegen,0,0,0,0,0,0,4,6,10
augustt198_lumen,27,0,0,18,0,0,0,2,47
spring-projects_spring-test-htmlunit,26,0,0,0,0,0,0,15,41
ymback_NGA-CLIENT-VER-OPEN-SOURCE,0,0,0,0,0,0,0,2,2
holgerbrandl_r4intellij,70,0,0,0,0,0,0,68,138
Pragmatists_junitparams,43,4,1,0,41,0,4,51,144
OpenHFT_Koloboke,34,2,0,0,0,1,0,2,39
zhang-xzhi_simplehbase,101,0,0,0,0,0,0,48,149
wildfly-extras_wildfly-camel,344,7,6,36,0,22,1,52,468
jivesoftware_jive-selenium-pages-framework,0,0,0,0,0,0,0,1,1
GluuFederation_oxTrust,69,0,0,10,0,65,0,1,145
SonarSource_sonarqube,5252,18,8,0,2,183,0,2443,7906
NLPchina_elasticsearch-sql,188,19,0,102,0,9,0,98,416
novoda_simple-easy-xml-parser,1,0,0,0,0,0,0,13,14
micromata_javaapiforkml,43,1,0,0,116,0,1,280,441
Steveice10_MCProtocolLib,3,0,0,1,0,2,0,0,6
squeek502_SpiceOfLife,4,0,0,0,0,0,0,0,4
sendgridlabs_vertx-scheduler,2,0,0,0,0,0,0,5,7
CaptainBern_Reflection,0,0,0,0,0,0,0,3,3
Unidata_awips2,581,160,0,0,6,36,2,177,962
tomitribe_crest,50,0,0,14,0,4,2,120,190
yahoo_xpath_proto_builder,4,0,0,1,0,0,0,0,5
alexholmes_hiped2,2,0,0,0,0,0,0,1,3
pmd_pmd-eclipse-plugin,39,5,0,0,1,0,1,4,50
TouK_sputnik,62,0,0,0,0,0,0,16,78
cloudfoundry_java-buildpack-auto-reconfiguration,0,0,0,0,0,0,0,30,30
metricminer-msr_metricminer2,69,0,0,54,0,1,0,8,132
mooso_azure-tables-hadoop,9,0,0,0,0,1,0,2,12
HubSpot_Rosetta,44,0,0,0,0,0,1,1,46
Netflix_ocelli,17,0,0,0,2,0,4,6,29
GlenKPeterson_fp4java7,235,0,1,151,0,6,1,27,421
uwolfer_gerrit-rest-java-client,30,0,3,12,0,5,0,54,104
imglib_imglib2,242,9,2,126,0,0,4,109,492
ReactiveX_RxJavaMath,0,0,0,0,0,8,0,56,64
coheigea_testcases,2,0,1,0,0,0,0,39,42
ToastShaman_dropwizard-auth-jwt,12,0,0,0,0,10,0,0,22
mklemm_jaxb2-rich-contract-plugin,19,0,0,0,0,0,0,13,32
CloudSlang_cloud-slang,531,1,3,2,0,6,21,145,709
mikeberger_borg_calendar,11,3,0,0,0,1,0,5,20
thekrakken_java-grok,32,1,0,0,0,1,0,6,40
sindicetech_siren,226,1,1,115,0,4,1,195,543
enioka_jqm,115,2,1,0,0,9,0,36,163
GrammarViz2_grammarviz2_src,5,0,0,4,0,1,0,0,10
OutSystems_OutSystemsNow-Android,3,0,0,0,0,0,0,0,3
hmsonline_storm-cassandra-cql,5,0,1,1,0,0,0,2,9
lumifyio_securegraph,65,12,2,61,0,5,0,9,154
OfficeDev_ews-java-api,51,1,1,0,0,4,0,8,65
PSDev_FormValidations,12,0,0,0,0,0,0,2,14
bulenkov_iconloader,0,0,2,0,0,0,0,1,3
dswarm_dswarm,73,3,7,0,37,15,38,286,459
apache_incubator-blur,219,12,0,0,8,10,0,152,401
spotify_helios,217,6,2,0,0,14,1,109,349
openscore_score-actions,575,2,0,9,7,24,2,292,911
cloud-software-foundation_c5-replicator,37,1,0,0,0,1,0,24,63
jphp-compiler_jphp,232,0,0,0,5,1,6,382,626
apache_struts,54,0,0,18,0,4,0,4,80
google_guava,860,6,12,203,45,266,0,348,1740
wiztools_stagen,0,1,0,0,0,0,0,0,1
wgybzbrobot_sentiment-search,4,0,0,0,1,0,1,6,12
eXparity_hamcrest-date,23,0,0,0,0,0,0,0,23
shilad_wikibrain,94,4,0,13,2,0,26,53,192
mimno_Mallet,6,0,0,0,0,0,0,1,7
takari_takari-smart-builder,6,0,1,0,0,0,0,0,7
jmeter-maven-plugin_jmeter-maven-plugin,73,0,0,62,0,3,3,4,145
sailorgeoffrey_ddp-client-java,1,0,0,0,0,3,0,0,4
structurizr_java,342,0,0,0,0,247,0,8,597
puniverse_capsule,43,3,0,0,0,0,0,1,47
tuenti_SmsRadar,0,0,0,0,0,0,0,7,7
vinhkhuc_jcrfsuite,2,0,0,2,0,0,0,1,5
tech-advantage_sonar-gerrit-plugin,30,0,0,25,0,0,0,7,62
mapzen_open,108,0,0,0,0,0,2,58,168
apache_knox,920,15,0,594,1,122,1,348,2001
igniterealtime_Openfire,188,7,2,77,2,7,4,32,319
sword-org_wechat4j,0,0,0,0,6,0,0,47,53
stickfigure_gwizard,4,0,0,0,0,0,0,2,6
mapzen_on-the-road,37,1,0,0,0,0,1,1,40
consulo_consulo-dotnet,1,0,0,0,0,0,0,0,1
SEL-columbia_dristhi,239,0,1,0,0,0,1,501,742
mcharmas_shoppinglist-clean-architecture-example,3,0,0,0,0,0,0,12,15
syncany_syncany,281,13,0,0,5,8,10,51,368
ReactiveCouchbase_ReactiveCouchbase-play,1,0,0,0,0,0,0,0,1
aparapi_aparapi,5,1,1,0,0,0,0,4,11
Kurento_kurento-java,85,14,1,0,0,12,186,586,884
couchbase_couchbase-lite-java,407,23,0,0,0,47,2,43,522
wuic_wuic,106,3,0,0,0,1,0,36,146
weefbellington_screenplay,0,0,0,0,0,0,0,1,1
AzureAD_azure-activedirectory-library-for-java,21,0,0,7,0,6,0,1,35
seagate_kinetic-java,90,3,0,48,3,65,0,7,216
KleeGroup_vertigo,148,0,0,50,0,6,0,60,264
Flow_nbt,2,0,0,1,0,0,0,4,7
BjoernKW_ZenQuery,0,0,0,0,0,0,0,1,1
icode_ameba,1,0,0,0,0,0,0,2,3
iluwatar_java-design-patterns,341,4,8,153,0,39,0,90,635
apache_servicemix,2,1,0,0,0,1,0,28,32
libgdx_ashley,71,0,0,0,0,2,0,20,93
podcastpedia_podcastpedia-web,5,0,0,0,1,0,5,24,35
jaibeermalik_elasticsearch-tutorial,26,2,0,0,0,1,4,2,35
HubSpot_jinjava,493,0,1,0,12,31,20,51,608
zafarkhaja_jsemver,52,1,2,29,0,3,0,0,87
spring-projects_spring-sync,81,0,0,0,0,6,3,2,92
dschulten_hydra-java,77,0,0,0,0,0,1,22,100
WhisperSystems_PushServer,4,0,0,2,0,0,0,0,6
google_firing-range,1,0,0,0,0,0,0,69,70
ic3fox_jawr-main-repo,350,22,4,154,0,9,7,115,661
red5_red5-websocket,7,0,0,7,0,0,0,2,16
vmware_thinapp_factory,26,1,0,0,2,5,1,47,82
tkurz_sesame-vocab-builder,9,0,1,0,0,1,0,0,11
opendaylight_controller,574,15,0,0,20,22,3,396,1030
abwaters_cryptsy-api,0,0,0,0,0,0,0,22,22
google_google-api-java-client,6,0,0,0,0,4,0,0,10
audit4j_audit4j-core,33,0,1,20,3,1,0,61,119
red5_red5-client,2,1,0,0,0,0,0,7,10
OhmData_c5-replicator,37,1,0,0,0,1,0,24,63
fhussonnois_storm-trident-elasticsearch,4,0,0,0,0,0,0,2,6
OpenHFT_Chronicle-Bytes,218,9,14,147,0,20,0,83,491
matiwinnetou_spring-soy-view,37,0,0,16,0,1,1,4,59
jbossdemocentral_brms-coolstore-demo,9,0,0,0,0,0,0,0,9
blackberry_Krackle,0,0,0,0,0,4,0,0,4
jmockit_jmockit1,454,2,3,0,2,17,3,325,806
mendix_RestServices,24,0,0,0,0,8,0,6,38
TheLQ_PircBotX,51,0,1,0,0,1,0,4,57
tim-group_test-driven-detectors4findbugs,3,0,0,2,1,0,0,11,17
techdev-solutions_trackr-backend,18,0,0,0,0,0,14,8,40
tokuhirom_avans,42,0,0,0,0,0,0,3,45
Microsoft_AppInsights-Java,308,1,0,0,1,3,0,56,369
surech_halarious,16,0,0,0,0,0,0,9,25
sdeleuze_opensnap,1,0,0,0,0,0,0,0,1
snazy_ohc,78,2,0,62,0,3,0,10,155
blackberry_KaBoom,5,0,0,0,2,0,0,3,10
noskovd_spring-data-orient,6,0,0,0,0,0,0,10,16
giovibal_vertx-mqtt-broker-mod,0,0,0,0,0,0,0,2,2
opentripplanner_OpenTripPlanner,918,9,1,0,3,4,0,216,1151
orientechnologies_orientdb-etl,30,0,0,0,0,1,0,0,31
droidstealth_droid-stealth,2,0,0,0,0,0,0,2,4
bitcoin-solutions_multibit-hardware,3,0,0,0,0,0,0,0,3
highsource_jsonix-schema-compiler,15,0,0,0,0,0,0,13,28
jimmoores_quandl4j,25,0,0,16,0,0,0,16,57
krschultz_AndroidWeatherBuoyDemo,16,0,0,0,0,0,0,4,20
clarkparsia_stardog-examples,3,0,0,0,0,0,0,5,8
edx_edx-app-android,114,4,0,0,1,2,5,54,180
TNG_jgiven,63,8,6,0,1,4,2,281,365
reinert_requestor,44,0,0,43,0,0,0,0,87
jenjinstudios_jenjin,21,0,0,0,1,0,0,27,49
IKCAP_wings,0,0,0,0,0,0,0,4,4
eclipse_smarthome,917,14,8,0,0,63,12,414,1428
Jimmy-Shi_bean-query,18,0,0,2,0,1,0,0,21
MyRobotLab_myrobotlab,69,5,0,60,2,4,0,42,182
darcy-framework_darcy-ui,36,0,0,17,0,0,0,67,120
bitcoin-solutions_multibit-website,9,0,0,0,0,0,0,2,11
optimaize_language-detector,30,0,0,16,0,0,0,29,75
zhangkaitao_shiro-example,6,0,0,0,0,1,0,22,29
andsel_moquette,86,2,0,56,0,3,0,43,190
KengoTODA_what-is-maven,0,0,0,0,0,0,0,1,1
real-logic_Aeron,445,11,1,0,0,9,1,258,725
caskdata_tephra,160,5,0,16,0,25,0,41,247
apache_tajo,781,109,16,505,2,37,0,478,1928
otros-systems_otroslogviewer,167,4,0,0,2,1,0,35,209
locationtech_udig-platform,493,26,1,0,38,30,158,206,952
searchisko_elasticsearch-river-jira,141,1,0,69,1,6,0,19,237
serenity-bdd_serenity-jbehave,74,0,0,0,0,0,0,2,76
bodiam_markdown-to-asciidoc,0,0,0,0,0,0,1,0,1
uPhyca_GAlette,0,0,0,0,0,0,0,11,11
HubSpot_Singularity,259,4,3,0,0,7,0,28,301
thelinmichael_spotify-web-api-java,89,0,0,1,0,0,0,198,288
TestFX_TestFX,224,3,0,0,5,12,4,142,390
paukiatwee_budgetapp,16,0,0,10,0,0,0,0,26
SteveyO_Hue-Emulator,7,0,0,0,0,0,0,0,7
bruno-medeiros_DDT,2,0,1,0,0,0,1,141,145
arquillian_arquillian-cube,204,2,0,111,0,12,2,78,409
odiszapc_nginx-java-parser,21,0,0,4,0,0,1,2,28
adjust_android_sdk,2,0,0,0,0,6,0,41,49
ExactTarget_fuel-java,177,1,5,0,3,0,0,73,259
JakeWharton_Telecine,9,0,0,0,0,0,0,0,9
ceph_cephfs-hadoop,2,0,0,0,0,0,0,0,2
xtreemfs_babudb,33,1,2,0,0,2,0,9,47
apache_airavata,89,3,31,56,0,4,1,40,224
cathive_sass-java,6,2,0,0,0,0,2,12,22
ArtificerRepo_artificer,139,5,0,0,1,14,0,7,166
squarespace_jersey2-guice,3,0,0,0,0,0,0,2,5
arangodb_arangodb-java-driver,391,14,4,175,0,59,0,41,684
mini2Dx_mini2Dx,486,27,1,0,2,27,0,50,593
juniversal_jsimple,167,7,0,0,0,7,0,21,202
carymrobbins_intellij-haskforce,0,0,2,0,0,0,0,3,5
eseifert_gral,302,2,0,0,1,4,0,22,331
numenta_htm.java,401,21,0,0,1,91,0,53,567
googlegenomics_dataflow-java,38,0,0,5,0,0,1,30,74
HubSpot_live-config,1,0,0,0,0,0,0,0,1
Netflix_Raigad,22,0,0,0,0,0,0,9,31
marklogic_java-client-api,1061,128,0,0,4,152,3,566,1914
eclipsesource_J2V8,356,0,0,307,0,32,0,109,804
JasonRuckman_sidney,0,0,0,0,0,2,0,26,28
alaisi_postgres-async-driver,14,0,1,3,0,9,0,6,33
squeek502_ASMHelper,0,0,0,0,0,0,0,18,18
google_gcm,29,0,0,0,0,10,0,2,41
vogellacompany_eclipse4book,3,0,0,0,0,0,0,0,3
TheMCPEGamer_Dragonet,14,5,10,0,1,0,0,6,36
stephanenicolas_injectview,20,0,0,0,0,0,0,0,20
bkimminich_kata-tcg,14,0,0,0,0,0,0,0,14
hcoles_QuickBuilder,30,0,0,10,0,10,0,0,50
roikku_swift-explorer,44,0,0,0,0,18,1,43,106
stuartgunter_dropwizard-cassandra,4,0,1,2,0,0,0,6,13
kennycason_kumo,21,2,0,11,0,0,3,56,93
tsiemens_pathfinder-toolkit,22,0,0,0,0,0,0,0,22
yahoo_artifactory_ssh_proxy,22,1,0,0,1,0,0,16,40
oxo42_stateless4j,22,0,0,0,0,0,0,8,30
RichardWarburton_honest-profiler,11,0,13,0,0,2,0,19,45
Plaid_plaid-java,67,4,0,51,0,1,0,1,124
BuiltBrokenModding_ICBM,16,4,0,0,0,0,0,2,22
highsource_jaxb2-basics,17,0,1,0,0,0,0,15,33
Cascading_fluid,9,0,0,0,0,0,0,4,13
casidiablo_multidex,2,2,0,0,0,1,0,1,6
wiztools_rest-client,3,1,0,0,0,0,0,1,5
ReactiveX_RxJava,3542,221,0,0,1,1245,12,2915,7936
RestExpress_RestExpress-Examples,2,0,0,0,0,0,0,1,3
mapzen_mapzen-android-demo,108,0,0,0,0,0,2,58,168
naver_pinpoint,1205,21,0,0,31,25,1,961,2244
SpringOne2GX-2014_microservice-security,1,0,0,0,6,0,0,6,13
virgo47_javasimon,121,0,0,106,0,0,0,31,258
yfpeng_pengyifan-commons,48,0,0,12,0,0,0,10,70
pwittchen_NetworkEvents,0,0,0,0,0,0,0,5,5
LapisBlue_Commons,9,0,0,0,0,0,0,3,12
googlemaps_google-maps-services-java,120,1,7,0,0,2,0,2,132
seleniumQuery_seleniumQuery,237,8,0,215,6,13,9,276,764
chenlb_mmseg4j-solr,0,0,0,0,0,0,0,6,6
datacleaner_DataCleaner,163,8,0,112,1,12,2,45,343
raulhaag_MiMangaNu,0,0,0,0,0,0,0,71,71
Putnami_putnami-web-toolkit,1,0,0,0,0,0,0,0,1
Stratio_stratio-ingestion,66,4,0,0,0,6,51,59,186
c4fcm_CLIFF,30,0,0,26,0,0,0,10,66
Appendium_objectlabkit,167,0,0,49,0,0,0,4,220
teamed_qulice,10,0,0,3,9,0,0,84,106
google_acai,18,0,0,0,0,4,0,6,28
mdeverdelhan_ta4j,193,0,0,58,0,1,0,1,253
takari_takari-lifecycle,115,5,1,3,0,6,3,14,147
sjamesr_jfreesane,16,0,1,0,0,1,0,13,31
caelum_vraptor-panettone,31,0,0,26,0,0,1,1,59
Stratio_streaming-cep-engine,66,1,0,6,1,0,8,6,88
VHAINNOVATIONS_InfoButtons-182,5,0,0,0,0,4,1,7,17
bytedeco_javacpp,69,25,5,52,0,1,0,0,152
fiji_Trainable_Segmentation,2,1,0,1,0,0,0,3,7
apache_incubator-samoa,37,0,3,2,0,2,0,22,66
SudoPlayGames_Joise,0,0,0,0,0,0,0,32,32
OpenTOSCA_container,16,0,0,12,0,0,0,0,28
path_android-priority-jobqueue,27,3,1,0,0,2,0,7,40
onepf_OPFPush,21,1,0,0,0,0,0,1,23
vert-x3_vertx-metrics,47,4,0,12,0,1,0,8,72
fge_grappa,17,0,1,0,0,13,0,23,54
IBM-Bluemix_todo-apps,36,0,0,0,0,11,0,1,48
guardianproject_ChatSecureAndroid,12,0,0,0,0,0,0,3,15
wbaumann_SmartReceiptsLibrary,233,0,0,0,0,0,0,220,453
KittehOrg_KittehIRCClientLib,47,1,0,26,0,2,0,63,139
linkedin_gobblin,1038,23,20,0,0,89,0,160,1330
ZK-1931_javazab,14,0,2,0,0,0,0,3,19
astefanutti_camel-cdi,50,0,0,0,4,4,1,23,82
robert-bor_aho-corasick,16,0,0,12,0,0,0,32,60
RichardWarburton_java-8-lambdas-exercises,13,0,6,1,1,2,1,32,56
softlayer_softlayer-java,34,0,0,15,0,2,1,6,58
Esri_solutions-geoevent-java,0,0,0,0,2,0,0,2,4
tabulapdf_tabula-java,56,1,1,34,1,2,2,7,104
Netflix_s3mper,7,1,0,0,0,2,0,3,13
HotswapProjects_HotswapAgent,58,0,0,8,3,1,0,14,84
TEAMMATES_repo,644,6,0,0,31,2,0,379,1062
gid15_jpcsp,2,0,0,1,0,0,0,0,3
tdunning_t-digest,48,7,0,33,0,3,0,33,124
raphaeljolivet_java2typescript,1,0,0,1,0,0,0,20,22
copper-engine_copper-engine,46,1,0,0,0,3,0,257,307
rocketscience-projects_javaslang,889,62,1,0,54,83,35,1216,2340
simpligility_android-ndk-maven-plugin,3,0,1,0,0,1,0,0,5
square_javapoet,63,0,0,0,0,52,1,9,125
l3nz_ObjectiveSync,7,0,0,0,0,0,0,2,9
migzai_irc-api,16,0,0,4,0,0,0,16,36
commons-rdf_commons-rdf,25,0,0,18,0,0,0,5,48
real-logic_Agrona,330,4,2,0,0,10,0,83,429
getsentry_raven-java,0,0,35,0,2,0,0,39,76
nutzam_nutzwx,0,0,0,0,0,0,0,2,2
ebay_oink,19,0,0,6,0,8,0,4,37
martinpaljak_GlobalPlatformPro,8,0,0,0,0,0,0,5,13
kuenishi_presto-riak,1,0,0,0,1,0,0,7,9
johnmartel_javaccPlugin,21,0,0,0,0,0,0,61,82
smola_galimatias,29,2,1,23,0,2,0,2,59
Jaspersoft_jrs-rest-java-client,170,0,0,0,0,1,0,20,191
kuali_kc,930,14,2,0,0,9,0,388,1343
google_guice,147,4,0,55,0,71,0,127,404
ruediste1_btrbck,29,0,0,0,0,0,0,6,35
Qkyrie_Twitch,3,0,0,0,0,0,0,7,10
nidi3_raml-tester,74,0,1,40,0,1,0,40,156
tracee_tracee,82,0,0,21,0,0,2,107,212
chanjarster_weixin-java-tools,5,0,0,4,0,0,0,1,10
exteso_alf.io,248,3,10,0,0,5,0,100,366
OpenHFT_hftc,34,2,0,0,0,1,0,2,39
SpongePowered_Sponge,66,1,2,0,0,5,0,11,85
finn-no_cassandra-hadoop,0,0,0,0,0,0,0,1,1
FlexTradeUKLtd_jfixture,146,0,0,14,0,2,0,33,195
nosceon_titanite,22,0,0,0,0,0,0,41,63
naver_yobi,288,1,0,0,0,2,0,13,304
mulesoft-labs_rhinodo,8,0,0,0,1,1,0,1,11
release-engineering_pom-manipulation-ext,156,13,3,52,50,24,0,90,388
vert-x3_vertx-codegen,249,0,0,214,1,1,0,54,519
AdoptOpenJDK_mjprof,31,0,0,0,4,0,0,9,44
nhnopensource_volley-extensions,52,0,0,0,0,0,1,45,98
Netflix_dyno,59,2,0,0,0,7,0,25,93
jOOQ_jOOL,394,0,0,0,0,188,0,212,794
super-csv_super-csv,259,1,0,0,0,69,14,131,474
ReactiveX_RxAndroid,29,0,1,0,0,16,12,2,60
recommenders_rival,26,0,0,0,0,0,0,0,26
OfficeDev_Office-365-SDK-for-Android,32,0,0,0,0,91,0,2,125
twitter_cloudhopper-commons,303,3,0,86,0,53,3,17,465
searchisko_elasticsearch-river-sysinfo,71,0,0,23,0,5,0,13,112
ObeoNetwork_UML-Designer,64,11,8,0,0,0,0,0,83
PasaLab_Tachyon-Perf,8,0,0,0,0,0,0,0,8
PaNaVTEC_Clean-Contacts,4,0,0,0,0,0,0,13,17
bodar_totallylazy,514,1,0,0,0,9,15,48,587
addthis_hydra,348,9,0,3,4,14,7,215,600
nutzam_ssdb4j,21,0,0,0,0,0,0,1,22
jenkinsci_acceptance-test-harness,143,1,0,0,0,8,7,91,250
sanity_quickml,48,0,0,26,3,0,7,20,104
swagger-api_swagger-parser,330,4,0,236,0,4,0,20,594
openMF_android-client,0,0,0,0,0,0,0,53,53
AzureAD_azure-activedirectory-library-for-android,243,6,0,0,0,72,12,20,353
Stratio_flume-ingestion,66,4,0,0,0,6,51,59,186
hyperic_hq,140,12,0,0,7,26,4,80,269
dpreussler_jodamoblog,1,0,0,0,1,0,0,9,11
holyeye_spring-trace,0,0,0,0,0,0,0,4,4
OrbitzWorldwide_consul-client,91,15,0,84,0,5,21,40,256
spring-io_sagan,53,0,0,0,0,0,0,63,116
sonyxperiadev_gerrit-events,57,0,0,47,0,0,0,27,131
mybatis_ibatis-2,172,0,0,27,11,47,0,25,282
DroidPlanner_DroneKit-Android,10,0,0,0,1,0,0,1,12
neo4j-contrib_cypher-dsl,76,1,1,0,0,5,0,8,91
nhl_link-rest,174,0,0,85,0,3,0,243,505
bitcoin-solutions_multibit-hd,103,6,0,0,0,2,0,42,153
SeanTater_uncc2014watsonsim,28,0,1,0,1,0,0,3,33
pusher_pusher-websocket-java,21,0,0,0,0,0,0,87,108
OAuth-Apis_apis,46,0,0,23,0,1,0,13,83
google_closure-stylesheets,460,4,0,334,0,18,4,1188,2008
paksv_teamcity-azure-plugin,2,0,0,0,0,0,0,0,2
unitsofmeasurement_unit-api,63,2,0,28,0,22,0,0,115
reactive-streams_reactive-streams-jvm,12,0,7,0,0,10,0,236,265
filoghost_HolographicDisplays,2,0,0,0,0,0,0,0,2
dvorka_keepass2-to-keepassx,0,0,0,0,0,0,0,3,3
real-logic_simple-binary-encoding,100,4,0,0,0,10,0,8,122
hal_circuit,22,0,0,2,0,0,0,1,25
gwizard_gwizard,4,0,0,0,0,0,0,2,6
primecloud-controller-org_primecloud-controller,37,6,0,5,0,1,14,10,73
hawkular_hawkular-metrics,96,1,6,0,0,4,0,16,123
silb_shiro-jersey,0,0,0,0,0,0,0,8,8
ampm_douban-fm-sdk,32,0,0,0,5,1,0,5,43
jelkosz_Kanbanik,5,0,0,0,0,0,0,2,7
nordicway_moji,9,3,0,0,0,9,0,1,22
marschall_threeten-jpa,25,0,0,7,0,0,0,2,34
ulyn_eos,0,0,0,0,1,0,0,8,9
oswetto_Loboevolution,156,0,0,145,0,40,0,1548,1889
serso_android-checkout,43,0,0,0,1,2,0,48,94
Stratio_stratio-deep,75,2,2,0,17,7,0,47,150
bryanreinero_Firehose,0,0,0,0,0,0,0,2,2
cglib_cglib,2,0,0,1,0,0,0,1,4
MSOpenTech_azure-activedirectory-library-for-android,243,6,0,0,0,72,12,20,353
fluo-io_fluo,191,4,0,130,0,7,0,25,357
ctron_package-drone,39,0,0,0,0,4,0,73,116
ReactiveX_RxNetty,4,0,0,0,0,0,0,0,4
sequenceiq_sequenceiq-samples,1,0,0,0,0,0,0,0,1
telefonicaid_fiware-cygnus,176,34,0,0,0,549,4,17,780
libgdx_gdx-ai,8,0,0,0,0,0,0,0,8
graphaware_neo4j-timetree,94,0,0,0,0,2,1,7,104
groupon_odo,11,3,0,0,0,1,0,0,15
LucidWorks_spark-solr,7,0,0,0,0,7,6,27,47
Talend_tcommon-studio-se,725,40,1,0,49,37,24,149,1025
serenity-bdd_serenity-core,456,6,20,280,42,23,15,752,1594
wikimedia_search-highlighter,220,8,0,64,2,4,0,66,364
bodar_utterlyidle,180,1,0,0,0,3,0,47,231
OPENNETWORKINGLAB_onos,2502,50,0,0,7,140,40,932,3671
Label305_Stan-for-Android,6,0,0,0,0,7,0,7,20
pac4j_pac4j,258,1,0,202,0,17,1,228,707
google_u2f-ref-code,18,0,0,0,0,1,0,8,27
michaelwittig_java-q,7,0,0,5,0,0,1,1,14
SAP_cloud-dirigible,83,8,0,0,1,60,0,27,179
andytill_erlyberly,0,0,0,0,0,0,0,11,11
spring-cloud_spring-cloud-cli,0,1,0,0,6,0,11,6,24
federicoiosue_Omni-Notes,38,1,0,0,0,0,0,30,69
naver_ngrinder,123,5,0,0,1,9,4,37,179
dsyer_spring-security-angular,19,0,0,0,0,0,0,0,19
SnippingToolPlusPlus_SnippingToolPlusPlus,5,0,0,0,0,0,0,4,9
rpau_walkmod-core,57,7,0,49,0,5,0,4,122
schema-repo_schema-repo,20,0,0,19,1,0,1,5,46
rundeck_rundeck,65,0,0,0,0,11,0,75,151
davityle_ngAndroid,4,0,0,0,9,0,0,15,28
Kixeye_janus,28,0,0,0,1,0,0,3,32
headissue_cache2k,691,26,3,0,0,95,4,210,1029
SurveyMan_SurveyMan,25,2,0,18,9,1,1,18,74
pivotalsoftware_pivotal-samples,0,0,0,0,0,0,0,6,6
peholmst_vaadin4spring,11,1,0,0,0,0,0,1,13
neo4j-contrib_graph-collections,48,14,0,46,0,0,3,3,114
digidotcom_XBeeJavaLibrary,1112,17,12,763,0,50,0,898,2852
jvirtanen_nassau,17,0,0,16,0,0,0,2,35
benjiman_expressions,24,0,0,1,0,12,0,4,41
Netflix_Prana,1,0,0,0,0,0,0,0,1
saulmm_Material-Movies,0,0,0,0,0,0,0,5,5
lesaint_damapping,25,1,1,19,0,0,0,102,148
hazelcast_hazelcast-simulator,181,0,0,0,3,7,0,143,334
manuzhang_storm-benchmark,14,0,0,3,0,0,0,19,36
rmagen_elastic-gremlin,3,0,0,0,0,0,0,3,6
lilicoding_soot-infoflow-android-iccta,0,0,0,0,0,7,0,1,8
openhab_openhab2,1479,499,2,815,0,44,0,1102,3941
GlowstoneMC_Glowstone,86,4,5,0,4,0,0,48,147
mayconbordin_streaminer,72,3,3,0,1,0,7,38,124
thechunknetwork_RedisBungee,1,0,0,0,0,0,0,2,3
xtext_seven-languages-xtext,11,0,0,0,0,21,0,6,38
cloudera_cm_ext,86,6,0,0,0,2,0,25,119
timolson_cointrader,5,0,0,5,3,0,0,11,24
DawnFire-Realms_CommunityBridge,53,0,0,0,0,8,0,96,157
Linfar_TeamCity.SonarQubePlugin,16,0,0,0,0,1,0,2,19
conveyal_gtfs-data-manager,1,0,0,0,0,0,0,0,1
codecentric_spring-boot-starter-batch-web,21,0,0,0,3,0,0,9,33
teamed_requs,1,0,0,0,2,0,0,3,6
tarql_tarql,28,0,0,13,0,0,6,19,66
TomasMikula_ReactFX,56,0,0,1,0,1,0,10,68
larsgrefer_android-library,1,0,0,0,0,0,0,2,3
sogyf_mybatis-pagination,0,0,0,0,0,0,0,8,8
fge_throwing-lambdas,58,0,1,0,0,0,0,0,59
lenskit_lenskit,495,9,0,0,0,3,4,8,519
MALfunction84_psi-probe,36,0,0,0,0,0,0,150,186
payara_Payara,798,57,6,257,7,119,34,500,1778
OpenHFT_Chronicle-Map,89,14,1,46,0,11,16,85,262
SignalR_java-client,23,0,0,0,0,0,0,0,23
edgedalmacio_phisix,14,2,0,7,0,0,0,4,27
Azure_azure-documentdb-java,14,0,1,0,0,0,1,5,21
xerial_sqlite-jdbc,232,2,0,21,1,14,0,37,307
totalvoidness_cryptomator,27,4,0,0,0,0,0,2,33
HotelsDotCom_plunger,74,0,0,0,0,0,0,4,78
windy1_google-places-api-java,1,1,0,0,0,0,0,1,3
spring-cloud_spring-cloud-consul,70,0,1,0,2,2,5,45,125
DICE-UNC_jargon,612,26,0,0,0,9,1,96,744
apache_incubator-tamaya,383,3,0,215,0,0,0,8,609
mifmif_Generex,14,0,4,0,0,0,0,0,18
PGWelch_com.opendoorlogistics,11,2,0,0,0,0,0,5,18
SonarSource_sonar-findbugs,50,0,0,11,0,0,0,18,79
PhantomYdn_wicket-orientdb,59,2,0,16,0,0,15,19,111
OryxProject_oryx,222,6,0,125,0,2,1,72,428
ontometrics_slack-youtrack,3,0,0,0,3,0,0,7,13
unchartedsoftware_aperture-tiles,132,10,0,0,0,4,2,93,241
Universal-Electricity_ICBM,16,4,0,0,0,0,0,2,22
datanucleus_datanucleus-core,2,0,0,2,0,0,0,0,4
Roanis_atg-tdd,8,0,0,0,0,0,0,1,9
snakerflow_snakerflow,0,0,0,0,0,0,0,40,40
stealthly_xml-avro,16,0,0,0,0,1,0,5,22
novoda_sqlite-provider,7,0,0,0,0,0,0,22,29
vladimirvivien_clamshell-cli,10,0,4,0,0,0,0,19,33
awslabs_aws-dynamodb-encryption-java,207,4,0,103,0,10,0,60,384
Stratio_deep-spark,75,2,2,0,17,7,0,47,150
NoChanceSD_PvPManager,9,0,0,0,0,0,0,1,10
lqd-io_liquid-sdk-android,17,0,0,0,0,6,0,0,23
wix_petri,73,0,1,0,0,0,0,78,152
wgybzbrobot_sns-crm,3,0,0,0,1,0,0,1,5
DataDog_jmxfetch,47,0,5,0,0,5,0,1,58
geftimov_MapReduce,0,0,0,0,0,0,0,4,4
eclipse-jetty_eclipse-jetty-plugin,0,0,0,0,1,0,0,3,4
my2iu_Jinq,286,0,0,76,2,0,0,5,369
galenframework_galen,252,0,0,26,0,1,0,26,305
camunda_camunda-consulting,161,0,2,0,1952,7,2,2369,4493
embulk_embulk-output-jdbc,4,0,0,0,0,0,0,0,4
kite-sdk_kite,663,10,13,0,0,23,14,247,970
mvarnagiris_financius-public,8,0,0,0,0,0,0,0,8
spring-projects_spring-session,353,1,0,0,8,0,0,239,601
netplex_json-smart-v1,2,0,0,0,0,0,0,0,2
jonnyzzz_TeamCity.Virtual,17,0,0,0,1,1,0,2,21
gravel-st_gravel,101,0,0,0,4,0,0,1812,1917
WhisperSystems_WebSocket-Resources,5,0,0,4,0,1,0,2,12
fiji_Stitching,5,0,0,3,0,1,0,2,11
apache_stratos,60,8,0,0,0,6,0,24,98
joshlong_boot-examples,0,0,0,0,3,0,0,3,6
googlesamples_android-testing,3,0,3,0,0,0,0,51,57
yandex-qatools_hamcrest-pojo-matcher-generator,2,0,0,0,0,0,0,2,4
dgageot_simplelenium,18,0,0,0,0,0,0,50,68
yammer_breakerbox,36,1,0,0,0,0,0,0,37
zk1931_jzab,14,0,2,0,0,0,0,3,19
PayPal_PayPal-Java-SDK,14,0,0,0,0,10,0,1,25
dropwizard_dropwizard-protobuf,3,0,0,0,0,0,0,0,3
danielnorberg_auto-matter,47,0,0,0,0,0,1,18,66
shazam_fork,6,0,0,0,0,0,1,11,18
HearthStats_HearthStats.net-Uploader,0,0,0,0,0,0,1,0,1
spring-projects_spring-xd-modules,10,0,0,0,0,0,0,3,13
vibe-project_vibe-java-server,0,0,0,0,0,0,0,1,1
chocotan_lolibox,0,0,0,0,2,0,0,2,4
codeine-cd_codeine,38,0,0,0,0,0,2,17,57
wildflyext_wildfly-camel,344,7,6,36,0,22,1,52,468
takari_takari-local-repository,41,0,1,8,0,1,0,4,55
spotify_crtauth-java,8,0,0,1,0,0,0,5,14
nusco_narjillos,131,0,0,0,2,6,0,27,166
intercom_intercom-java,45,3,0,0,0,11,0,0,59
murraycu_android-galaxyzoo,25,0,0,0,1,5,0,3,34
neo4j_neo4j-ogm,764,20,7,383,4,29,15,128,1350
drapostolos_type-parser,11,0,0,0,0,9,0,176,196
SomMeri_matasano-cryptopals-solutions,18,0,0,0,0,1,0,6,25
kaazing_k3po,280,1,3,155,49,5,22,950,1465
red5_red5-hls-plugin,0,0,0,0,0,0,0,1,1
flipkart-incubator_foxtrot,105,0,7,0,0,47,5,37,201
phishman3579_java-algorithms-implementation,116,1,0,0,0,1,0,25,143
Crate_crate,3032,127,5,0,0,167,0,1165,4496
KronicDeth_intellij-elixir,1,0,0,0,0,0,0,0,1
neuroph_master,61,1,17,0,2,0,0,11,92
devnied_EMV-NFC-Paycard-Enrollment,77,0,0,51,0,5,0,4,137
jbruchanov_AnUitor,6,0,3,0,0,2,0,0,11
Kixeye_chassis,77,0,0,7,0,0,2,5,91
spring-projects_spring-integration-aws,39,0,0,0,0,0,0,6,45
orientechnologies_orientdb-lucene,17,0,0,0,0,0,0,5,22
nginx-clojure_nginx-clojure,47,0,0,0,0,1,0,29,77
jMetal_jMetal,400,0,0,0,3,1,15,47,466
sitewhere_sitewhere,0,0,0,0,1,0,0,13,14
eclipse_leshan,280,2,19,0,3,9,3,28,344
jboss-gpe_processFlowProvision,13,0,0,0,0,0,0,4,17
Apereo-Learning-Analytics-Initiative_OpenDashboard,0,0,0,0,1,0,0,5,6
lumongo_lumongo,11,0,0,0,0,0,0,8,19
GumTreeDiff_gumtree,87,1,0,0,0,0,0,13,101
norecha_pokubot,1,0,0,0,0,0,1,0,2
sualeh_magnetictrackparser,15,0,0,13,0,0,0,10,38
poetix_protonpack,11,0,0,2,0,4,0,1,18
freemarker_fmpp,8,0,0,0,0,1,0,0,9
Netflix_Surus,1,0,0,0,0,0,0,0,1
gridkit_nanocloud,55,3,2,31,4,13,3,474,585
jackpf_ApkDownloader,1,0,0,0,0,0,0,0,1
jparkie_GivesMeHopeAndroidClient,0,0,0,0,0,0,0,40,40
outbrain_ob1k,88,1,0,0,0,32,11,45,177
xhanin_jarup,8,0,0,7,0,0,0,0,15
kristian-lange_MechArg,127,1,0,0,0,90,0,133,351
Cascading_cascading-hive,42,0,1,0,0,0,0,17,60
Cloudslab_CloudSimEx,65,3,0,0,0,0,0,17,85
ReactiveX_RxSwing,17,1,3,0,0,2,0,16,39
appium_java-client,102,0,1,0,4,15,0,28,150
jvirtanen_parity,10,0,0,8,0,0,0,0,18
pusher_pusher-http-java,29,0,0,19,0,0,0,14,62
JorgeCastilloPrz_Corleone,0,0,0,0,0,0,0,8,8
spring-projects_spring-integration-kafka,41,0,0,0,0,8,0,8,57
welovecoding_editorconfig-netbeans,39,0,0,0,0,0,0,0,39
cegeka_batchers,39,0,0,0,0,0,0,44,83
ysc_word,20,0,0,6,0,13,0,9,48
ReactiveX_RxJavaJoins,0,0,0,0,0,0,0,81,81
larsga_Duke,170,0,0,85,0,2,2,200,459
pedrovgs_Algorithms,7,0,0,0,0,0,0,40,47
indexiatech_antiquity,37,1,0,16,0,0,0,0,54
marcosvidolin_doco,6,0,0,0,0,0,0,0,6
nenick_AndroidAppDevelopment,15,0,0,0,0,0,0,49,64
Viscent_JavaConcurrencyPattern,0,0,0,0,0,0,0,2,2
SimonVT_cathode,1,0,0,0,0,0,0,0,1
HiddenStage_divide,15,0,1,0,6,0,0,13,35
caskdata_coopr,298,6,0,0,0,58,0,178,540
douglascraigschmidt_POSA-14,22,0,0,0,0,2,0,8,32
emory-courses_cs323,7,0,0,0,0,0,1,12,20
Ullink_simple-slack-api,30,0,0,0,0,0,0,0,30
fiji_TrackMate,51,8,0,46,0,0,0,3,108
pardom_ollie,10,0,0,0,0,0,0,3,13
digitalfondue_lavagna,185,0,0,0,0,0,0,144,329
ddavison_conductor,0,0,0,0,0,0,0,14,14
valchkou_cassandra-driver-mapping,79,0,0,0,0,1,0,4,84
CIRDLES_Topsoil,5,0,0,0,0,3,0,2,10
ShifuML_guagua,4,0,0,0,0,5,0,4,13
apache_metamodel,242,5,1,206,0,11,0,65,530
kuujo_copycat,286,1,1,218,0,10,9,121,646
spring-projects_spring-integration-java-dsl,87,0,0,0,0,16,0,1,104
dobrynya_nomin,2,0,0,0,0,0,0,1,3
jmrozanec_cron-utils,217,80,4,86,0,4,37,96,524
basis-technology-corp_tcl-regex-java,45,0,0,0,0,0,0,7,52
GoogleCloudPlatform_bigdata-interop,589,5,4,322,11,10,5,149,1095
lucaspouzac_contiperf,23,1,0,0,2,1,0,35,62
Stratio_stratio-cassandra,500,40,0,0,1,27,2,436,1006
pulsarIO_realtime-analytics,5,0,0,5,0,0,0,4,14
rejasupotaro_octodroid,5,0,0,0,0,0,0,0,5
codefollower_Tomcat-Research,1007,62,2,670,2,31,0,1288,3062
h2oai_h2o,106,23,4,84,8,8,14,114,361
pavel4n_wowdoge.org,189,12,1,163,0,31,0,24,420
SharedKnowledge_SharkFW,16,7,0,15,1,1,2,11,53
kishida_sqlparser,1,0,1,0,0,0,0,34,36
jcabi_jcabi-http,34,0,0,28,0,0,0,15,77
simon-heinen_SimpleUi,1,0,0,0,0,0,0,0,1
nemerosa_ontrack,73,1,0,0,0,3,0,23,100
bonigarcia_dualsub,3,0,0,1,0,0,8,11,23
RuedigerMoeller_kontraktor,13,1,0,0,0,2,31,58,105
wildfly_wildfly-core,2225,144,34,1163,1,211,25,1930,5733
google_domaintest,17,0,2,5,0,0,0,17,41
passy_scdl,16,2,0,0,0,0,0,10,28
jagornet_dhcp,33,0,0,0,0,0,0,27,60
iilab_PanicButton,18,0,0,0,4,0,0,34,56
holodeck-b2b_Holodeck-B2B,247,3,0,70,1,116,0,4,441
Netflix_aegisthus,1,0,0,0,0,0,1,1,3
subchen_jetbrick-template-2x,85,0,0,0,0,0,0,38,123
pilehvar_ADW,6,0,0,0,0,0,0,0,6
mozilla_MozStumbler,39,0,0,0,0,0,0,11,50
guardianproject_NetCipher,26,1,0,0,0,6,0,0,33
mcupak_beacon-of-beacons,16,1,1,0,0,1,0,13,32
oyachai_HearthSim,372,5,0,0,0,16,7,24,424
jlinn_quartz-redis-jobstore,50,3,0,1,0,0,0,8,62
damiencarol_jsr203-hadoop,35,0,0,0,0,1,3,9,48
LordH3lmchen_TwitchTools,1,1,0,0,0,0,0,2,4
nulab_backlog4j,90,0,0,0,0,0,0,5,95
TeamCohen_ProPPR,35,3,0,0,0,0,0,20,58
google_truth,749,10,2,38,0,41,0,1769,2609
serenity-bdd_serenity-demos,0,0,1,0,0,0,0,23,24
JetBrains_youtrack.mylyn.connector,1,0,0,0,0,0,0,0,1
abel533_ECharts,0,0,0,0,0,0,0,26,26
greenmail-mail-test_greenmail,103,1,0,0,0,8,0,27,139
denimgroup_threadfix,88,8,0,0,2,4,7,239,348
pastekit_twist,60,0,0,2,10,0,0,11,83
buremba_rakam,21,1,0,0,1,0,0,15,38
Tillerino_Tillerinobot,56,2,0,0,0,3,0,98,159
emicklei_rendersnake,0,0,0,0,0,0,0,1,1
twotoasters_multi-column-list-adapter,0,0,0,0,0,0,0,3,3
opensciencemap_vtm,15,0,0,0,0,0,0,9,24
elastic_elasticsearch-river-couchdb,6,1,0,0,0,0,0,5,12
dbfit_dbfit,27,1,3,0,10,9,1,91,142
idok_jscs-plugin,2,0,0,0,0,0,0,0,2
elastic_elasticsearch-river-wikipedia,0,2,0,0,0,0,0,0,2
jkazama_ddd-java,13,0,0,0,0,7,0,0,20
bywan_trello-java-wrapper,72,0,6,0,2,0,0,2,82
glazedlists_glazedlists,750,8,1,0,1,34,15,179,988
englishtown_vertx-cassandra,25,0,0,2,0,0,0,11,38
enonic_xp,2067,3,7,0,1,73,0,996,3147
Instagram_ig-json-parser,29,0,0,0,0,0,0,2,31
mbernste_machine-learning,1,0,0,0,0,0,0,0,1
vert-x3_codegen,249,0,0,214,1,1,0,54,519
google_closure-templates,1448,8,0,838,0,78,0,1000,3372
pantsbuild_intellij-pants-plugin,2,0,5,0,1,0,0,4,12
socketIo4Netty_socketIo4j,24,0,0,0,0,0,0,0,24
beothorn_webGrude,1,0,0,0,0,0,0,0,1
OpenMRS_openmrs-module-fhir,90,1,0,19,2,0,0,2,114
jitsi_jigasi,6,0,0,5,0,0,0,1,12
srikalyc_Sql4D,0,0,0,0,0,1,0,2,3
HubTurbo_HubTurbo,229,10,6,0,0,9,0,117,371
elibom_jogger,36,0,0,29,1,15,0,21,102
fizzed_java-stork,21,3,2,19,0,3,0,0,48
extjwnl_extjwnl,166,0,1,112,0,1,0,11,291
xpqiu_fnlp,2,0,0,2,7,0,0,35,46
moznion_java-mysql-diff,7,0,0,0,0,6,0,0,13
vert-x3_service-proxy,54,6,0,2,0,0,0,39,101
gwtbootstrap3_gwtbootstrap3,3,0,0,0,0,0,0,0,3
hankcs_HanLP,0,0,0,0,0,0,0,12,12
elastic_elasticsearch-transport-memcached,1,0,0,0,0,0,0,0,1
WASdev_standards.jsr352.jbatch,28,1,0,5,1,5,3,9,52
Kixeye_kixmpp,25,1,0,17,0,0,0,1,44
Rayman2200_PDFA3,3,0,0,3,0,0,0,0,6
bither_bitherj,26,3,1,0,1,4,0,9,44
OpenSilk_Orpheus,78,0,0,0,0,0,0,9,87
Wolfgang-Schuetzelhofer_jcypher,146,14,0,145,0,29,0,29,363
pcingola_SnpEff,126,36,2,124,0,30,0,349,667
mirkosertic_FXDesktopSearch,6,0,0,0,0,0,0,2,8
magarena_magarena,3,0,0,0,0,0,0,0,3
SmartBear_JCeleryWorker,6,0,0,0,0,0,0,1,7
etsy_Conjecture,22,0,0,0,0,0,0,2,24
goodow_realtime-store,17,0,0,0,0,0,0,0,17
airbnb_AirMapView,0,0,0,0,0,0,1,1,2
Cardshifter_Cardshifter,21,0,0,0,0,0,0,0,21
lessthanoptimal_ejml,644,43,2,0,1,11,0,224,925
nicklondhe_newsindexer,31,3,0,10,0,17,0,0,61
google_rich-test-results,0,0,0,0,0,0,1,4,5
ribot_easy-adapter,17,0,0,0,0,0,0,0,17
lightcouch_LightCouch,9,0,0,0,0,0,0,16,25
tuplejump_stargate-core,13,0,0,0,0,0,0,3,16
meyerjp3_psychometrics,141,1,2,112,0,0,0,29,285
levigo_jbig2-imageio,11,0,3,10,0,0,12,14,50
nightscout_android-uploader,31,0,0,0,0,13,0,21,65
reines_dropwizard-debpkg-maven-plugin,28,0,0,17,0,0,0,8,53
HdrHistogram_HdrHistogram,35,9,0,19,0,1,0,13,77
netizen539_civcraft,1,0,0,1,0,0,0,0,2
wso2_siddhi,885,420,0,57,1,21,0,209,1593
FasterXML_jackson-dataformat-cbor,0,0,0,0,0,0,0,2,2
subchen_jetbrick-template-1x,10,1,3,2,2,2,0,7,27
Netflix_Nicobar,36,0,1,0,4,2,0,19,62
igniterealtime_Spark,1,0,0,1,1,1,0,1,5
mulesoft-labs_quartz-mongodb,5,0,0,0,0,0,0,1,6
smartparam_smartparam,88,2,0,0,0,3,0,27,120
HadoopGenomics_Hadoop-BAM,79,1,3,40,0,1,0,19,143
dropwizard_metrics,272,3,2,173,0,24,3,100,577
igniterealtime_jxmpp,34,0,0,0,1,4,0,20,59
igniterealtime_Smack,347,5,5,0,1,21,2,45,426
Talend_tdi-studio-se,424,34,0,0,1,19,4,90,572
google_google-http-java-client,68,0,0,61,0,13,0,5,147
Mashape_Astronode-Broadcaster,2,0,0,0,0,1,0,0,3
wso2_carbon-identity,1,0,0,0,0,0,0,0,1
rkday_jsipp,6,0,0,0,0,0,0,5,11
ks-no_eventstore2,24,0,9,9,1,0,0,42,85
SonarCommunity_sonar-csharp,286,0,1,89,0,1,1,76,454
elastic_elasticsearch-river-rabbitmq,4,0,0,0,0,0,0,3,7
chenlb_mmseg4j-core,4,0,0,3,0,0,3,3,13
poetix_octarine,31,0,0,1,0,0,0,0,32
RNCryptor_JNCryptor,9,0,3,6,0,0,0,3,21
jlpoolen_libreveris,14,2,0,0,3,0,0,123,142
pedrovgs_Renderers,8,0,0,0,0,0,0,37,45
ic3fox_jawr,465,24,4,0,0,9,7,28,537
javaee-samples_javaee7-samples,184,11,0,44,1,22,0,35,297
awslabs_aws-sdk-java-resources,8,0,0,6,0,2,16,8,40
whois-server-list_public-suffix-list,14,0,0,6,0,0,0,1,21
the-blue-alliance_the-blue-alliance-android,137,1,2,0,4,0,3,246,393
kohlschutter_junixsocket,172,29,0,0,3,29,0,67,300
jindrapetrik_jpexs-decompiler,19,4,0,15,0,14,0,347,399
linux-china_plantuml-gist,0,0,0,0,0,0,0,2,2
vert-x3_vertx-reactive-streams,13,1,0,0,0,2,0,2,18
spearal_spearal-java,10,4,0,0,0,1,0,23,38
sneerteam_sneer,0,0,0,0,0,0,0,1,1
sarl_sarl,995,2,0,44,2,4,1,57,1105
abel533_Mapper,328,2,0,78,0,0,2,40,450
AppliedEnergistics_Applied-Energistics-2,49,1,1,0,0,0,0,9,60
apache_incubator-brooklyn,1199,30,0,0,2,132,0,551,1914
digitalbuddha_AndroidStarter,0,0,0,0,0,0,0,2,2
Ecwid_consul-api,8,0,0,0,0,0,0,4,12
ajohnston9_ciscorouter,7,0,0,0,0,2,0,0,9
TannerPerrien_picasso-transformations,1,0,0,0,0,0,0,0,1
OpenHFT_Chronicle-Queue,179,16,15,106,1,18,15,125,475
caskdata_cdap,1413,33,10,0,0,113,14,657,2240
kiselev-dv_gazetteer,8,0,0,0,2,3,0,12,25
jansorg_BashSupport,154,8,1,0,5,5,13,687,873
kairosdb_kairosdb-client,47,0,0,47,0,7,0,14,115
nguyenq_tess4j,9,2,0,6,0,1,0,0,18
Netflix_ReactiveLab,1,0,0,0,0,0,0,0,1
krasa_StringManipulation,43,0,1,0,0,1,0,49,94
jamesagnew_hapi-fhir,6122,62,0,0,13,1006,0,610,7813
juniversal_juniversal,1,0,0,0,1,1,0,25,28
jprante_log4j2-elasticsearch,5,0,0,0,0,0,0,3,8
AChep_AcDisplay,1,0,0,0,0,0,0,0,1
HPI-Information-Systems_Metanome,264,1,0,151,7,26,0,79,528
basgren_railways,19,0,3,0,0,0,0,9,31
Stratio_stratio-streaming,66,1,0,6,1,0,8,6,88
swookiee_com.swookiee.runtime,2,0,0,0,0,0,0,0,2
codelibs_elasticsearch-dynarank,7,5,0,0,0,0,0,0,12
radcortez_wow-auctions,9,0,0,2,0,0,0,2,13
hansenji_pocketknife,33,0,0,0,0,0,0,2,35
palantir_stash-codesearch-plugin,1,0,0,0,0,1,0,3,5
irobertson_pojomatic,60,2,0,15,0,13,0,27,117
TomasMikula_EasyBind,10,0,0,0,0,0,0,0,10
ESAPI_esapi-java-legacy,222,8,6,113,7,88,0,168,612
ben-manes_concurrentlinkedhashmap,2,0,1,0,0,0,0,4,7
psidnell_ofexport2,69,0,0,55,0,1,0,46,171
mraad_Shapefile,22,0,0,9,0,0,0,0,31
ruediste_btrbck,29,0,0,0,0,0,0,6,35
tectonicus_tectonicus,7,0,0,0,0,0,0,3,10
jherico_jovr,0,0,0,0,0,0,0,1,1
englishtown_vertx-when,9,0,0,0,0,0,0,21,30
aol_simple-react,3337,18,0,0,71,245,135,626,4432
cloud-software-foundation_c5,852,56,33,0,6,70,17,393,1427
OpenSOC_opensoc-streaming,3,0,0,0,0,0,0,42,45
JD-Software_JDeSurvey,0,0,0,0,0,0,0,4,4
project-ncl_pnc,344,7,8,224,0,23,2,67,675
thheller_shadow-pgsql,8,0,0,0,0,0,0,9,17
google_openrtb-doubleclick,9,0,0,0,0,0,0,13,22
InkApplications_android-preferences,0,0,0,0,0,5,0,5,10
stickfigure_objectify-insight,4,0,0,0,0,0,0,40,44
Cloudslab_cloudsim,63,0,0,42,1,1,5,14,126
edwardcapriolo_nibiru,24,0,0,20,0,0,1,3,48
vt-middleware_passay,1,0,0,0,0,0,0,0,1
btrplace_scheduler,379,6,0,0,0,5,0,34,424
Netflix_staash,2,0,0,0,10,2,33,39,86
stagemonitor_stagemonitor,262,1,3,0,0,11,6,70,353
apache_incubator-calcite,1038,9,2,0,25,157,0,4669,5900
openlvc_portico,397,32,0,0,2,286,0,1184,1901
maciejmiklas_cyclop,45,2,0,0,0,5,0,123,175
calrissian_flowmix,12,0,0,12,0,0,2,0,26
midonet_midonet,232,2,3,0,0,6,4,25,272
google_google-oauth-java-client,2,0,0,2,0,0,0,12,16
ReactiveX_RxJavaReactiveStreams,21,0,0,0,0,2,0,1,24
spotify_docker-maven-plugin,8,0,0,5,0,0,0,4,17
eseifert_vectorgraphics2d,27,0,0,0,0,0,0,23,50
divolte_divolte-collector,86,1,4,0,0,0,0,53,144
theupswell_appengine-counter,44,0,0,0,0,6,0,18,68
roboconf_roboconf-platform,1424,17,2,0,0,35,1,251,1730
NetApp_NetApp-Hadoop-NFS-Connector,3,0,0,0,0,0,0,0,3
hk2-project_hk2,962,57,4,0,0,109,3,239,1374
komamitsu_jackson-dataformat-msgpack,9,4,0,0,0,0,0,2,15
WhisperSystems_TextSecure-Server,354,1,0,0,0,24,0,69,448
cecom_pomutils,4,0,0,3,0,0,0,0,7
davidsowerby_krail,119,0,0,0,0,2,1,27,149
venmo_cursor-utils,14,0,0,0,0,1,0,13,28
fesh0r_fernflower,0,0,0,0,0,0,0,168,168
Robbert1_boot-stateless-auth,5,0,0,0,0,0,0,5,10
HolmesNL_kafka-spout,24,0,0,4,0,3,0,10,41
jbachorik_btrace,30,1,0,0,1,1,0,121,154
HotswapProjects_HotswapAgentExamples,7,0,0,0,0,0,0,3,10
krisjey_redis.usecase,2,0,0,0,0,0,0,3,5
pushtorefresh_bamboo-storage,249,0,0,0,0,92,0,380,721
jprante_elasticsearch-xml,1,2,0,0,0,3,0,0,6
aceleradora6-tw_RegistroLivre,2,0,0,0,0,0,0,10,12
arun-gupta_wildfly-samples,6,1,0,0,0,0,0,1,8
whatscloud_whatscloud-android,1,0,0,0,0,0,0,0,1
BranchMetrics_Branch-Android-SDK,31,1,0,0,3,23,0,8,66
eHarmony_vw-webservice,10,1,0,0,0,0,2,3,16
flaxsearch_luwak,60,0,0,36,0,6,0,6,108
VRL-Studio_VRL,21,0,0,0,0,0,0,1,22
edwardcapriolo_farsandra,8,0,0,5,0,0,1,1,15
scratches_spring-boot-legacy,3,0,0,0,0,0,0,3,6
phasenraum2010_javaee7-petclinic,2,0,0,0,0,0,0,1,3
mrniko_redisson,1591,67,0,646,0,36,0,214,2554
lordi_tickmate,9,0,0,0,0,0,0,3,12
webdriverextensions_webdriverextensions,2,0,0,1,0,3,24,90,120
couchbase_couchbase-jvm-core,398,7,0,279,0,39,8,49,780
spring-cloud_spring-cloud-connectors,119,1,0,0,0,0,0,32,152
dcevm_dcevm,82,0,0,0,0,0,1,14,97
brettwooldridge_HikariJSON,3,0,0,0,0,0,0,0,3
Baqend_Orestes-Bloomfilter,72,3,7,0,1,0,4,13,100
quemb_QMBForm,3,0,0,0,0,0,0,0,3
sequenceiq_cloudbreak,156,3,0,0,0,14,1,151,325
JetBrains_teamcity-deployer-plugin,7,0,0,0,0,0,0,7,14
Netflix_zeno,75,3,0,0,0,1,0,16,95
viritin_viritin,26,1,3,0,0,1,8,8,47
vladmihalcea_flexy-pool,47,2,0,0,0,19,0,31,99
chanjarster_tomcat-mongo-access-log,0,0,0,0,0,0,0,2,2
Alexey1Gavrilov_expectit,31,1,1,29,0,5,0,6,73
Vincentyification_JavaBot,25,0,0,6,0,1,0,0,32
caelum_mamute,104,0,0,71,0,0,0,19,194
Poweruser_MinetickMod,28,13,0,0,0,0,0,7,48
chanan_SignalJ,1,0,0,0,0,0,0,0,1
abel533_Mybatis-Spring,0,0,0,0,0,0,0,1,1
vinumeris_lighthouse,26,0,0,0,0,1,0,1,28
usc-isi-i2_Web-Karma,19,7,0,8,0,27,0,18,79
rancherio_cattle,81,0,0,0,0,8,4,4,97
Netflix_spectator,473,13,1,0,0,21,0,315,823
MicBrain_Graph-API,39,0,0,0,0,0,0,0,39
readydev_retrogram,1,0,0,0,0,1,0,2,4
red5_red5-io,49,9,0,0,0,1,3,9,71
google_jimfs,253,5,0,92,0,39,0,94,483
searchisko_elasticsearch-river-remote,197,0,0,100,1,12,0,17,327
Sotera_distributed-graph-analytics,44,0,0,0,0,2,0,22,68
apache_olingo-odata4,1540,52,10,1067,2,111,10,642,3434
allanbank_mongodb-async-driver,1508,48,0,1193,0,208,0,310,3267
tlaukkan_zigbee4java,31,0,2,11,4,8,12,35,103
chiuki_gce2retrofit,9,0,0,0,0,0,0,5,14
Team254_TrajectoryLib,1,0,0,1,0,0,0,31,33
fcrepo3_gsearch,1,0,0,0,0,1,0,0,2
fcrepo3_fcrepo,243,10,4,0,3,79,9,294,642
jetty-project_jetty-alpn,3,0,0,0,0,2,0,2,7
prasanthj_hyperloglog,14,0,6,0,0,0,0,0,20
jurmous_etcd4j,46,2,0,0,0,4,4,1,57
41concepts_VALJOGen,35,1,1,0,0,0,0,10,47
tkaczmarzyk_specification-arg-resolver,133,0,1,8,0,0,1,196,339
JetBrains_teamcity-azure-plugin,2,0,0,0,0,0,0,0,2
twitter_hpack,3,0,1,0,0,0,0,4,8
recruit-tech_redpen,478,1,0,439,1,12,0,8,939
serenity-bdd_serenity-cucumber,8,0,0,0,0,0,0,7,15
XiaoMi_chronos,10,0,0,0,0,0,0,2,12
SpongePowered_SpongeAPI,30,0,0,0,0,0,0,2,32
reveal-technologies_sitewhere,0,0,0,0,1,0,0,13,14
junichi11_netbeans-github-issues-plugin,6,0,0,0,0,0,0,0,6
dropwizard_dropwizard-java8,15,0,0,2,0,10,0,12,39
rterp_GMapsFX,0,0,0,0,0,0,0,6,6
tox4j_tox4j,0,0,0,0,0,0,0,1,1
jtrfp_terminal-recall,127,1,0,51,0,1,0,31,211
rapidftr_RapidFTR-Android,92,0,0,0,3,0,13,134,242
inductiveautomation_opc-ua-stack,5,0,0,0,0,0,0,8,13
mulesoft_raml-for-jax-rs,42,1,0,0,0,1,0,3,47
bramp_ffmpeg-cli-wrapper,23,0,4,12,0,1,2,8,50
simpligility_android-maven-plugin,36,0,18,0,0,0,1,7,62
kwon37xi_hibernate4-memcached,25,1,0,0,0,1,0,52,79
spring-cloud_spring-cloud-config,259,2,1,0,1,6,4,145,418
pietermartin_sqlg,1122,208,0,1053,0,70,1,332,2786
netceteragroup_valdr-bean-validation,7,0,0,0,0,2,0,0,9
stephanenicolas_mimic,0,0,0,0,0,0,0,24,24
Realm_realm-java,947,74,24,0,0,169,4,188,1406
google_google-authenticator-android,91,3,0,0,0,0,0,57,151
jensjaeger_play4jpa,39,0,0,0,0,0,0,0,39
graphaware_neo4j-uuid,13,12,0,0,0,0,0,1,26
miho_JCSG,1,0,0,0,0,0,0,5,6
yesnault_PlayStartApp,1,0,0,0,0,0,0,0,1
Flow_Caustic,1,0,0,1,0,0,0,0,2
IntuitDeveloper_SampleApp-TimeTracking_Invoicing-Java,15,0,0,0,0,3,0,6,24
jenkinsci_junit-plugin,73,1,0,0,0,1,0,8,83
jayway_powermock,304,2,11,0,9,109,16,141,592
haifengl_smile,694,8,19,0,0,0,0,107,828
hogelog_line-chart-view,1,0,0,0,0,0,0,0,1
revapi_revapi,191,3,0,92,0,2,0,31,319
WebGoat_WebGoat,13,0,0,0,0,9,0,201,223
immutables_immutables,34,1,30,8,0,4,4,782,863
spring-projects_spring-data-examples,139,3,0,0,1,1,0,72,216
documents4j_documents4j,19,0,1,6,0,1,0,11,38
spring-projects_spring-restdocs,110,0,1,0,0,0,0,119,230
vert-x3_vertx-rx,262,8,0,29,12,45,3,251,610
qcri-social_AIDR,88,1,0,0,10,33,0,17,149
abrensch_brouter,15,7,0,0,0,1,0,4,27
lightblue-platform_lightblue-core,503,24,5,90,12,28,16,125,803
apache_curator,433,25,0,370,3,52,0,55,938
OpenHFT_Chronicle-Core,145,41,6,81,0,20,2,43,338
davidmoten_rxjava-jdbc,30,0,1,12,0,3,2,51,99
oasp_oasp4j,40,3,0,0,0,3,0,14,60
salyh_elasticsearch-river-imap,3,0,0,0,0,0,0,14,17
mucommander_mucommander,0,0,0,0,0,1,0,206,207
resty-gwt_resty-gwt,17,0,0,0,1,0,0,12,30
statefulj_statefulj,38,0,0,11,0,3,0,1,53
joel-costigliola_assertj-swing,206,0,95,71,14,13,3,980,1382
octo-online_reactive-audit,7,1,0,0,0,1,0,73,82
confluentinc_kafka-rest,280,1,7,0,0,75,0,77,440
tootedom_related,141,7,0,0,2,45,0,16,211
apache_falcon,450,9,0,0,1,34,0,123,617
fabric8io_quickstarts,6,0,0,0,0,1,0,0,7
bnjmn_weka,60,1,0,0,0,10,0,5,76
ehcache_ehcache-jcache,8,0,0,0,0,0,0,2,10
expercise_expercise,20,0,0,17,0,0,0,8,45
uPhyca_idobata4j,25,0,0,0,0,0,0,5,30
bitcoinj_bitcoinj,444,10,5,0,0,25,11,60,555
jubeio_jube,10,0,0,0,1,0,0,3,14
guikeller_jetty-runner,12,1,0,0,0,1,0,0,14
nativelibs4java_BridJ,289,8,5,0,0,3,7,77,389
Firebase_geofire-java,17,1,0,4,0,0,0,10,32
mstahv_maddon,26,1,3,0,0,1,8,8,47
etsy_statsd-jvm-profiler,12,0,0,2,0,0,0,12,26
cloudfoundry-community_spring-boot-cf-service-broker,0,0,0,0,0,0,0,34,34
xmlunit_xmlunit,176,15,1,96,0,16,1,419,724
wso2_product-esb,2,0,0,0,0,0,0,1,3
apache_incubator-twill,57,1,0,49,0,2,1,2,112
holgerbrandl_themoviedbapi,39,5,0,0,1,3,1,1,50
branky_cascading.hive,11,0,0,0,0,1,0,0,12
rtreffer_minidns,73,3,0,0,6,0,0,18,100
vladmihalcea_hibernate-master-class,34,0,0,0,0,15,5,67,121
vbence_stream-m,0,0,0,0,0,1,0,6,7
orangesignal_orangesignal-android-camera,20,0,0,0,1,0,3,1,25
springer-opensource_omelet,11,2,0,3,2,0,0,2,20
redraiment_jactiverecord,10,0,0,8,2,0,0,4,24
OpenHFT_Chronicle-Wire,376,19,56,259,0,10,15,148,883
MER-C_wiki-java,140,4,13,43,0,0,0,0,200
jitsi_jicofo,9,0,0,1,0,0,0,0,10
AltBeacon_android-beacon-library,56,0,0,0,0,1,0,42,99
flexiblepower_powermatcher,71,0,0,0,0,3,1,72,147
iheartradio_open-m3u8,21,0,2,0,1,0,0,8,32
apache_jackrabbit-filevault,375,10,5,0,0,17,9,95,511
tesis-dynaware_graph-editor,21,2,0,8,0,0,0,3,34
NirmataOSS_workflow,19,0,0,19,0,6,0,2,46
flipkart-incubator_Lois,0,0,0,0,0,0,0,19,19
udacity_ud859,92,0,0,0,0,0,0,0,92
linkedin_Spyglass,13,0,0,0,0,0,0,7,20
phax_ph-css,151,3,0,123,0,0,1,14,292
TeamBliss-LP_android_frameworks_base,19,0,0,0,1,3,0,4,27
internet-research-network_breeze,35,0,0,11,0,13,0,15,74
davidmoten_rtree,41,0,0,27,1,1,1,30,101
fookwood_Launcher3,25,1,0,0,3,0,6,51,86
naver_volley-extensions,52,0,0,0,0,0,1,45,98
pydio_pydio-sync-java,6,0,0,0,1,0,0,1,8
gregturn_spring-a-gram,4,0,0,0,0,0,0,0,4
awslabs_aws-ant-tasks,6,2,0,6,0,2,0,0,16
Hive2Hive_PeerBox,198,11,0,0,8,1,6,87,311
mapzen_lost,60,0,0,0,0,0,0,57,117
javaparser_javaparser,859,18,4,682,0,19,0,796,2378
yegor256_netbout,49,1,0,0,0,6,3,3,62
tynamo_tapestry-security,0,0,0,0,0,0,0,5,5
knightliao_disconf,15,0,0,0,5,16,0,8,44
MCTCP_TerrainControl,18,0,0,0,0,0,0,7,25
jprante_elasticsearch-plugin-bundle,0,0,0,0,0,0,0,2,2
zhangkaitao_spring4-showcase,12,0,0,0,0,0,0,31,43
johnjohndoe_TypedPreferences,7,0,0,0,0,0,0,0,7
uwescience_myria,120,28,0,0,0,5,0,47,200
fs_android-base,0,0,0,0,0,0,0,2,2
spotify_futures-extra,35,0,0,5,0,18,0,9,67
MinecraftForge_FernFlower,0,0,0,0,0,0,0,168,168
GluuFederation_oxAuth,884,0,2,848,2,144,0,80,1960
oodrive_eguan,422,27,17,0,3,40,0,147,656
RentTheRunway2_alchemy,79,0,0,48,0,2,0,58,187
orhanobut_wasp,23,0,2,0,0,8,0,0,33
Accla_d4m_api_java,96,1,1,70,2,3,4,35,212
esigate_esigate,7,1,0,5,0,0,0,0,13
javers_javers,10,0,0,0,0,0,0,2,12
codelibs_elasticsearch-taste,0,0,0,0,0,0,0,2,2
spirosoik_RapidAndroidApp,10,0,0,0,1,0,0,1,12
la-team_light-admin,25,0,0,12,1,0,2,20,60
apache_struts-examples,10,0,0,2,0,0,0,0,12
fadeyev_intellijcoder,14,0,0,0,0,7,0,39,60
wb14123_bard,18,0,0,0,0,0,0,0,18
scopely_fontain,0,0,2,0,0,0,0,0,2
timtiemens_secretshare,22,2,0,0,0,0,0,39,63
entando_entando-components,150,0,0,0,0,5,0,210,365
buschmais_extended-objects,101,0,1,82,2,7,0,18,211
novoda_sqlite-analyzer,3,0,0,0,0,0,0,16,19
kontalk_tigase-server,114,0,0,80,1,29,0,11,235
embulk_embulk,77,0,0,0,0,8,0,106,191
polydawn_mdm,39,0,0,0,0,1,0,3,43
JetBrains_kotlin-eclipse,1,0,0,0,0,0,107,1125,1233
square_okio,222,9,1,0,0,58,1,31,322
cternes_openkeepass,78,0,0,75,0,0,0,21,174
querydsl_querydsl,948,19,8,0,20,4,100,960,2059
tuenti_ButtonMenu,6,0,0,0,0,0,0,19,25
FEMR_femr,12,0,0,0,0,0,0,0,12
castlabs_dashencrypt,5,0,0,2,0,0,0,0,7
nasa_OpenSPIFe,126,3,0,0,1,11,0,56,197
orangesignal_orangesignal-csv,341,0,0,0,0,3,0,210,554
ewolff_user-registration,2,0,0,1,0,0,0,1,4
esig_dss,1708,92,0,883,0,21,0,287,2991
CorfuDB_CorfuDB,642,30,1,0,0,58,1,209,941
XiaoMi_themis,112,21,0,0,0,27,0,27,187
druid-io_druid,4062,182,217,2909,0,197,37,3081,10685
h2oai_h2o-dev,1406,87,0,0,11,97,61,657,2319
ClickTravel_Cheddar,342,9,1,0,0,1,0,88,441
pumadong_cl-privilege,0,0,0,0,0,0,0,1,1
google_google-auth-library-java,345,1,0,244,0,6,0,54,650
Swrve_rate-limited-logger,11,0,0,0,0,0,0,1,12
andrewgaul_modernizer-maven-plugin,6,0,0,6,0,0,0,0,12
bjornharrtell_jdbc-http-server,3,0,0,0,0,0,0,0,3
dcm4che_dcm4chee-arc-cdi,56,0,0,0,0,1,0,81,138
tiagobento_watertemplate-engine,30,0,0,1,0,0,0,2,33
protostuff_protostuff,63,0,0,22,2,2,2,25,116
spotify_docker-client,157,22,0,137,0,9,0,61,386
yammer_tenacity,44,0,0,0,0,10,0,8,62
mjsax_aeolus,67,5,0,30,0,1,3,98,204
pac4j_play-pac4j,4,0,0,1,0,0,0,3,8
Eldelshell_jongo,85,0,1,47,38,7,0,79,257
RPTools_maptool,179,7,0,0,1,7,0,21,215
imagej_imagej-ops,678,3,0,3,3,1,1,144,833
netplex_json-smart-v2,32,1,2,0,0,4,0,42,81
elastic_elasticsearch-hadoop,353,11,26,0,0,7,8,177,582
OpenNMS_newts,50,1,0,37,0,0,0,8,96
wendykierp_JTransforms,0,0,26,0,0,0,0,0,26
blockchain_api-v1-client-java,4,0,0,4,0,0,0,0,8
clinejj_foursquare-api-java,53,0,0,52,0,0,0,2,107
Yubico_java-u2flib-server,45,0,0,0,0,2,0,12,59
aol_micro-server,146,0,0,0,1,1,8,36,192
joeattardi_tailstreamer,5,0,0,0,0,0,0,0,5
sdstoehr_har-reader,6,0,0,5,1,0,0,17,29
sviperll_adt4j,6,0,0,0,0,0,0,0,6
pmarches_jStellarAPI,14,0,0,0,2,1,0,6,23
ehcache_sizeof,14,2,0,7,0,1,0,9,33
pprados_audit-reactive,7,1,0,0,0,1,0,73,82
benas_easy-batch,149,1,0,88,0,2,3,58,301
taichi_siden,8,0,2,0,0,3,0,12,25
kaazing_gateway,748,28,4,284,11,61,185,1336,2657
apache_uima-uimafit,160,0,0,0,0,0,0,54,214
shiyimin_androidtestdebug,1,0,1,0,0,0,0,50,52
sequenceiq_ambari-shell,1,0,0,0,0,0,0,8,9
spring-cloud_spring-cloud-cluster,31,0,0,0,0,0,0,0,31
Apereo-Learning-Analytics-Initiative_LearningAnalyticsProcessor,8,0,0,0,0,0,0,8,16
dsyer_spring-boot-ratpack,7,0,0,0,0,0,0,0,7
radkovo_jStyleParser,140,2,0,97,0,0,1,32,272
operasoftware_operaprestodriver,209,15,0,97,1,48,16,21,407
semanticvectors_semanticvectors,59,0,0,50,0,11,0,2,122
freenet_fred,49,1,0,0,0,11,0,75,136
TomasMikula_RichTextFX,66,1,0,0,0,0,3,5,75
senbox-org_s1tbx,122,2,4,48,1,9,16,316,518
chaupal_jxse,301,24,2,206,0,118,9,73,733
acciente_oacc-core,1091,140,0,0,0,440,0,20,1691
open-eid_digidoc4j,590,2,0,346,0,38,22,184,1182
camelinaction_camelinaction,57,2,0,0,1,12,0,32,104
thiagolocatelli_parse4j,37,0,0,0,0,23,0,15,75
DICE-UNC_idrop,60,2,0,0,1,5,0,11,79
exxeleron_qJava,37,3,0,0,0,3,0,1,44
remibantos_jeeshop,132,1,0,32,2,67,0,5,239
urandom_gearshift,37,0,0,0,1,4,0,1,43
kairosdb_kairosdb,317,0,1,0,0,8,0,114,440
fireduck64_jelectrum,29,0,0,0,2,0,0,32,63
Netflix_iep,105,2,1,0,0,5,0,25,138
thm-projects_arsnova-backend,25,0,0,0,1,0,0,13,39
zutherb_AppStash,13,0,0,0,5,0,4,9,31
meltmedia_dropwizard-crypto,2,0,0,1,0,0,0,0,3
policeman-tools_forbidden-apis,19,0,0,0,0,1,0,0,20
kohlschuetter_junixsocket,172,29,0,0,3,29,0,67,300
dpaukov_combinatoricslib,112,0,0,98,0,0,0,0,210
ReactiveX_RxJavaString,8,0,0,0,0,4,0,27,39
forge_roaster,389,0,0,320,0,0,0,3,712
unitsofmeasurement_unit-ri,141,0,0,17,0,6,0,2,166
kite-sdk_kite-examples,4,0,0,0,0,0,1,9,14
Haehnchen_idea-php-shopware-plugin,2,0,0,0,0,0,0,0,2
matrix-org_matrix-android-sdk,70,0,0,0,2,7,0,74,153
ConnectSDK_Connect-SDK-Android-Core,60,0,2,0,0,9,0,43,114
crosswalk-project_crosswalk-cordova-android,1,0,0,0,0,0,0,0,1
mongobee_mongobee,7,1,0,7,0,0,1,12,28
PayPal_SeLion,97,5,0,0,0,1,0,62,165
Netflix_suro,98,8,2,0,0,12,0,10,130
spring-projects_spring-data-keyvalue,37,0,0,0,0,0,0,37,74
h3xstream_http-script-generator,0,0,0,0,0,0,0,22,22
jbox2d_jbox2d,1,0,0,0,0,0,0,1,2
matlux_jvm-breakglass,3,0,0,0,0,0,0,5,8
xvik_dropwizard-guicey,30,0,1,0,0,0,0,0,31
nitram509_jmacaroons,20,0,0,18,0,0,0,2,40
dashbuilder_dashbuilder,163,0,1,115,0,4,0,368,651
EdwardRaff_JSAT,723,40,2,0,0,0,0,18,783
3breadt_dd-plist,21,0,0,6,0,2,0,15,44
lsds_SEEP,61,1,0,0,0,5,0,0,67
liveoak-io_liveoak,283,5,0,209,0,2,1,68,568
twotoasters_SectionCursorAdapter,6,0,0,0,0,0,0,4,10
coinbase_coinbase-java,27,0,1,0,0,0,0,6,34
DroidPlanner_3DRServices,10,0,0,0,1,0,0,1,12
nathantippy_jFASTStages,314,51,1,0,0,23,6,63,458
oldratlee_classloader-playground,11,0,0,0,0,3,0,0,14
arnohaase_a-base,137,2,3,0,0,1,3,9,155
NLPchina_ansj_seg,12,5,0,6,0,6,0,68,97
CompEvol_beast2,98,0,0,0,4,10,0,71,183
greenrobot_greenrobot-common,57,3,5,0,0,2,0,19,86
jodastephen_property-alliance,9,0,0,0,0,0,0,0,9
JeffreyFalgout_ThrowingStream,4,0,0,0,0,4,0,2,10
kzwang_elasticsearch-image,1,0,0,1,0,0,0,0,2
atinfo_at.info-knowledge-base,1,1,0,0,1,2,0,26,31
Clashsoft_Dyvil,0,0,0,0,1,0,0,3,4
LapisBlue_Pore,274,4,0,0,0,15,2,47,342
google_error-prone,203,1,5,72,70,8,33,4867,5259
lemire_RoaringBitmap,1006,21,16,0,0,10,1,132,1186
kaazing_robot,280,1,3,155,49,5,22,950,1465
ehcache_ehcache3,1181,43,5,0,3,248,7,501,1988
raydac_java-binary-block-parser,666,13,0,484,0,42,0,37,1242
CalebFenton_simplify,47,0,0,0,0,0,0,125,172
freenet_plugin-WebOfTrust,55,0,0,0,1,9,1,5,71
sinkillerj_ProjectE,45,1,0,0,0,0,0,0,46
freenet_plugin-Freetalk,3,0,0,0,0,0,0,0,3
ATLauncher_ATLauncher,7,0,0,0,0,0,0,1,8
AChep_HeadsUp,1,0,0,0,1,0,0,1,3
xtreemfs_xtreemfs,239,23,0,0,1,37,1,52,353
sanjivsingh_stackoverflow-java-sdk,104,0,0,29,0,0,0,0,133
groupon_jesos,15,0,0,0,0,0,0,0,15
iainporter_oauth2-provider,9,0,0,0,0,0,0,3,12
lejon_T-SNE-Java,5,2,0,4,0,0,0,47,58
mrmans0n_smart-location-lib,7,0,0,0,0,0,0,14,21
lestard_advanced-bindings,63,0,0,0,0,0,0,46,109
