Repo,HWD,GS,ED,LDV,Total
mpetazzoni_ttorrent,77,65,13,96,251
Graphify_graphify,0,41,4,0,45
jbake-org_jbake,0,123,7,0,130
andrewgaul_s3proxy,11,51,2,1,65
apache_storm,1176,2208,330,628,4342
palominolabs_jvm-ssh-groovy-shell,0,0,0,0,0
jai-imageio_jai-imageio-jpeg2000,46,225,21,246,538
Cube-Space_Yamler,5,11,0,0,16
lumifyio_lumify,0,681,103,0,784
apache_incubator-reef,0,773,177,2,952
linkedin_Cubert,0,541,37,0,578
renepickhardt_generalized-language-modeling-toolkit,20,0,1,0,21
NLPchina_nlp-lang,15,38,6,0,59
kkapelon_java-testing-with-spock,0,0,0,0,0
jordw_heftydb,0,27,15,0,42
prometheus_jmx_exporter,5,2,0,0,7
OhadR_oAuth2-sample,1,1,0,0,2
ethereum_ethereumj,0,297,76,3,376
ptgoetz_storm-hbase,0,9,0,0,9
tehmou_rx-android-architecture,0,26,2,0,28
martinpaljak_GlobalPlatform,0,32,2,0,34
graphaware_neo4j-reco,3,2,0,0,5
gosu-lang_gosu-lang,0,1203,304,22,1529
google_closure-compiler,1,628,281,13,923
SahaginOrg_sahagin-java,50,33,11,52,146
looly_hutool,0,614,124,25,763
SoftInstigate_restheart,0,359,29,0,388
spotify_trickle,4,7,5,20,36
chanedi_QuickProject,0,193,1,0,194
reds-heig_logisim-evolution,1,1670,259,7,1937
AndroidBootstrap_android-bootstrap,0,0,0,0,0
wildfly-security_wildfly-elytron,295,835,130,735,1995
tesseradata_RHIPE,14,106,0,2,122
Azure_azure-storage-android,0,915,76,0,991
benhysell_V.FlyoutTest,0,348,2,0,350
WhisperSystems_BitHub,1,3,0,17,21
ArcBees_gwtquery-tooltip-plugin,7,18,3,7,35
JCTools_JCTools,38,405,6,2,451
dev9com_parallel-webtest,0,15,0,0,15
sharneng_gm4java,9,6,1,27,43
cloudera_spark-dataflow,0,0,0,0,0
bedrin_jdbc-sniffer,37,99,25,44,205
petitparser_java-petitparser,14,28,1,291,334
mulesoft_jaxrs-to-raml,6,13,7,15,41
Conductor_kangaroo,0,13,0,0,13
square_burst,0,22,0,0,22
grpc_grpc-java,0,725,232,1,958
ObsidianBox_Obsidian,0,13,0,0,13
highsource_jaxb2-annotate-plugin,1,30,0,2,33
rjenkins_ursus,7,10,0,1,18
skroutz_elasticsearch-analysis-turkishstemmer,2,12,0,0,14
DeemOpen_zkui,5,7,0,0,12
ceskaexpedice_kramerius,1,1117,130,2,1250
xaguzman_pathfinding,0,4,0,0,4
elastic_elasticsearch,3,13352,5003,28,18386
mono_sharpen,0,19,5,0,24
englishtown_vertx-jersey,15,49,2,6,72
caoxinyu_RedisClient,0,238,4,0,242
jooby-project_jooby,112,270,28,290,700
ZheYuan_Mario,0,5,0,0,5
gjoseph_BarbaryWatchService,0,0,0,0,0
openhab_jmdns,18,92,7,99,216
InstantWebP2P_node-android,0,268,15,0,283
mulesoft_raml-jaxrs-codegen,9,8,0,1,18
augustt198_lumen,23,23,11,64,121
spring-projects_spring-test-htmlunit,0,2,0,0,2
ymback_NGA-CLIENT-VER-OPEN-SOURCE,0,177,26,0,203
holgerbrandl_r4intellij,0,234,8,3,245
wso2_balana,67,497,46,151,761
sys1yagi_indirect-injector,0,3,0,0,3
jbossdemocentral_bpms-travel-agency-demo,0,15,4,0,19
Pragmatists_junitparams,12,19,0,1,32
OpenHFT_Koloboke,0,98,2,2,102
zhang-xzhi_simplehbase,0,233,4,0,237
wildfly-extras_wildfly-camel,56,175,3,14,248
jivesoftware_jive-selenium-pages-framework,7,16,3,15,41
GluuFederation_oxTrust,81,327,19,116,543
SonarSource_sonarqube,0,1512,880,8,2400
NLPchina_elasticsearch-sql,45,25,15,111,196
aporter_coursera-android,0,119,0,0,119
novoda_simple-easy-xml-parser,0,28,3,0,31
micromata_javaapiforkml,0,56,32,0,88
sd4324530_fastweixin,59,78,15,2,154
Steveice10_MCProtocolLib,7,74,10,0,91
TrsstProject_trsst,0,31,0,0,31
squeek502_SpiceOfLife,4,129,12,0,145
sendgridlabs_vertx-scheduler,0,0,0,0,0
CaptainBern_Reflection,3,693,9,34,739
Unidata_awips2,0,5016,458,14,5488
eclipse_californium.scandium,0,0,0,0,0
percolate_caffeine,0,1,0,0,1
tomitribe_crest,26,196,6,12,240
yahoo_xpath_proto_builder,6,94,0,1,101
alexholmes_hiped2,0,215,0,1,216
OpenClinica_OpenClinica,0,1594,317,0,1911
pmd_pmd-eclipse-plugin,0,548,32,1,581
TouK_sputnik,0,16,7,0,23
cloudfoundry_java-buildpack-auto-reconfiguration,0,0,0,0,0
metricminer-msr_metricminer2,18,1,4,92,115
mooso_azure-tables-hadoop,0,11,0,0,11
tesseract4java_jtesseract,0,28,0,0,28
HubSpot_Rosetta,0,5,3,0,8
Netflix_ocelli,0,21,1,0,22
GlenKPeterson_fp4java7,5,59,8,252,324
uwolfer_gerrit-rest-java-client,38,52,24,43,157
micyeung_Sunshine,0,74,0,0,74
imglib_imglib2,125,127,39,373,664
OpenTreeMap_OpenTreeMap-Android,0,39,6,1,46
ReactiveX_RxJavaMath,0,1,0,0,1
coheigea_testcases,0,19,0,0,19
ToastShaman_dropwizard-auth-jwt,1,1,0,0,2
mklemm_jaxb2-rich-contract-plugin,0,49,8,0,57
camunda_camunda-bpm-assert,0,0,0,0,0
CloudSlang_cloud-slang,0,149,44,0,193
mikeberger_borg_calendar,0,150,44,17,211
thekrakken_java-grok,0,9,0,0,9
strongloop_loopback-sdk-android,0,21,0,0,21
sindicetech_siren,127,227,20,138,512
enioka_jqm,1,34,30,1,66
evant_rxloader,0,1,0,0,1
GrammarViz2_grammarviz2_src,24,43,2,6,75
OutSystems_OutSystemsNow-Android,0,400,43,3,446
TwidereProject_Twidere-Android,0,413,6,0,419
hmsonline_storm-cassandra-cql,7,36,0,0,43
lumifyio_securegraph,38,140,31,507,716
OfficeDev_ews-java-api,0,1527,121,0,1648
PSDev_FormValidations,0,1,0,0,1
bulenkov_iconloader,0,585,1,1,587
dswarm_dswarm,0,107,61,0,168
apache_incubator-blur,4,1615,166,0,1785
spotify_helios,0,157,58,0,215
openscore_score-actions,30,10461,56,2,10549
cloud-software-foundation_c5-replicator,0,37,9,0,46
jphp-compiler_jphp,0,518,142,0,660
ngageoint_anti-piracy-android-app,0,76,1,0,77
apache_struts,666,846,166,1596,3274
triAGENS_elasticsearch-river-arangodb,0,0,0,0,0
google_guava,931,3246,576,8904,13657
wiztools_stagen,0,5,2,0,7
danmbox_briss2,8,25,1,14,48
wgybzbrobot_sentiment-search,0,47,4,0,51
eXparity_hamcrest-date,0,341,12,99,452
shilad_wikibrain,14,537,91,106,748
mimno_Mallet,0,202,42,0,244
continuuity_netty-http,0,0,0,0,0
takari_takari-smart-builder,0,1,0,0,1
jmeter-maven-plugin_jmeter-maven-plugin,34,2,0,107,143
sailorgeoffrey_ddp-client-java,0,4,1,0,5
structurizr_java,0,17,11,0,28
puniverse_capsule,0,16,1,0,17
tuenti_SmsRadar,0,1,0,0,1
vbauer_avconv4java,0,402,0,1,403
vinhkhuc_jcrfsuite,6,7,0,6,19
tech-advantage_sonar-gerrit-plugin,15,40,2,7,64
mapzen_open,0,136,7,0,143
apache_knox,557,792,152,904,2405
igniterealtime_Openfire,403,515,196,1957,3071
danieloeh_AntennaPodSP,0,294,10,0,304
sword-org_wechat4j,0,12,4,0,16
jdereg_n-cube,0,2,0,0,2
stickfigure_gwizard,0,29,0,0,29
ksoichiro_Android-ObservableScrollView,0,31,1,0,32
mapzen_on-the-road,0,18,0,0,18
consulo_consulo-dotnet,7,110,25,30,172
tomaswolf_gerrit-gitblit-plugin,9,17,1,2,29
SEL-columbia_dristhi,0,807,30,4,841
mcharmas_shoppinglist-clean-architecture-example,0,5,0,0,5
syncany_syncany,0,141,69,0,210
ReactiveCouchbase_ReactiveCouchbase-play,0,10,0,0,10
aparapi_aparapi,3,485,2,4,494
Kurento_kurento-java,0,326,29,1,356
couchbase_couchbase-lite-java,0,456,39,0,495
wuic_wuic,0,122,55,2,179
weefbellington_screenplay,0,18,1,0,19
owncloud_android-library,0,106,0,0,106
AzureAD_azure-activedirectory-library-for-java,19,44,7,4,74
seagate_kinetic-java,219,1050,36,340,1645
KleeGroup_vertigo,57,50,26,690,823
Flow_nbt,13,15,2,2,32
BjoernKW_ZenQuery,0,0,0,0,0
icode_ameba,0,158,3,6,167
iluwatar_java-design-patterns,392,78,13,92,575
apache_servicemix,1,9,0,0,10
libgdx_ashley,0,37,1,0,38
podcastpedia_podcastpedia-web,0,7,0,0,7
jaibeermalik_elasticsearch-tutorial,0,51,2,0,53
HubSpot_jinjava,0,147,35,4,186
zafarkhaja_jsemver,15,21,0,5,41
spring-projects_spring-sync,0,0,0,0,0
evrythng_evrythng-java-sdk,0,0,0,0,0
dschulten_hydra-java,8,44,4,1,57
WhisperSystems_PushServer,1,4,1,16,22
opendatasoft_elasticsearch-plugin-geoshape,0,14,0,0,14
google_firing-range,0,0,0,0,0
ic3fox_jawr-main-repo,219,293,67,268,847
red5_red5-websocket,4,24,2,1,31
vmware_thinapp_factory,0,228,51,0,279
tkurz_sesame-vocab-builder,5,0,0,0,5
opendaylight_controller,1,312,132,3,448
abwaters_cryptsy-api,0,699,0,0,699
google_google-api-java-client,26,125,0,11,162
audit4j_audit4j-core,45,78,4,19,146
red5_red5-client,0,5,0,0,5
OhmData_c5-replicator,0,37,9,0,46
fhussonnois_storm-trident-elasticsearch,0,41,0,0,41
OpenHFT_Chronicle-Bytes,18,39,6,126,189
matiwinnetou_spring-soy-view,44,13,4,0,61
jbossdemocentral_brms-coolstore-demo,0,0,1,0,1
blackberry_Krackle,0,16,1,0,17
jmockit_jmockit1,0,196,3,0,199
mendix_RestServices,0,74,5,17,96
TheLQ_PircBotX,0,192,6,0,198
tim-group_test-driven-detectors4findbugs,4,6,0,0,10
techdev-solutions_trackr-backend,0,6,1,0,7
tokuhirom_avans,0,99,0,0,99
Microsoft_AppInsights-Java,0,347,33,0,380
surech_halarious,0,2,0,0,2
sdeleuze_opensnap,0,0,0,0,0
snazy_ohc,18,86,11,63,178
ContinuumIO_nutchpy,0,1,0,0,1
blackberry_KaBoom,0,4,0,0,4
noskovd_spring-data-orient,0,2,0,0,2
MesquiteProject_MesquiteCore,2,3096,582,1,3681
giovibal_vertx-mqtt-broker-mod,0,35,2,0,37
opentripplanner_OpenTripPlanner,0,973,239,30,1242
orientechnologies_orientdb-etl,0,0,1,0,1
droidstealth_droid-stealth,0,58,8,0,66
bitcoin-solutions_multibit-hardware,0,2405,8,0,2413
highsource_jsonix-schema-compiler,0,187,8,0,195
jimmoores_quandl4j,4,7,15,20,46
krschultz_AndroidWeatherBuoyDemo,0,1,0,0,1
clarkparsia_stardog-examples,0,2,0,0,2
mozilla_j2me.js,401,1921,244,366,2932
edx_edx-app-android,0,503,57,3,563
w-shackleton_android-netspoof,0,54,2,0,56
TNG_jgiven,0,126,6,0,132
reinert_requestor,90,136,77,276,579
jenjinstudios_jenjin,0,27,7,0,34
Azure_azure-sdk-for-java,0,0,0,0,0
IKCAP_wings,0,147,28,0,175
eclipse_smarthome,0,2570,373,9,2952
yoojia_FireEye,0,0,0,0,0
sromku_android-simple-storage,0,19,1,0,20
Jimmy-Shi_bean-query,11,2,1,7,21
MyRobotLab_myrobotlab,332,1856,104,348,2640
googlesamples_android-Camera2Basic,0,2,0,0,2
darcy-framework_darcy-ui,18,14,4,3,39
googlesamples_android-PermissionRequest,0,9,0,0,9
bitcoin-solutions_multibit-website,0,4,0,0,4
hypereddie_HippyJava,1,5,0,7,13
optimaize_language-detector,31,2,3,52,88
zhangkaitao_shiro-example,0,22,2,0,24
andsel_moquette,77,76,14,29,196
jabrena_livingrobots,1,189,21,0,211
KengoTODA_what-is-maven,0,0,0,0,0
real-logic_Aeron,0,1113,114,2,1229
caskdata_tephra,3,295,22,0,320
apache_tajo,700,6178,352,1922,9152
otros-systems_otroslogviewer,0,383,30,0,413
locationtech_udig-platform,0,4241,384,79,4704
searchisko_elasticsearch-river-jira,39,34,5,14,92
serenity-bdd_serenity-jbehave,0,20,0,0,20
bodiam_markdown-to-asciidoc,0,1,0,0,1
uPhyca_GAlette,0,7,0,0,7
HubSpot_Singularity,0,143,111,0,254
thelinmichael_spotify-web-api-java,6,220,10,15,251
TestFX_TestFX,0,17,5,0,22
google_identity-toolkit-java-client,8,11,0,2,21
paukiatwee_budgetapp,30,14,4,11,59
SteveyO_Hue-Emulator,0,21,5,0,26
bruno-medeiros_DDT,1,1466,144,4,1615
arquillian_arquillian-cube,92,234,34,133,493
odiszapc_nginx-java-parser,11,82,1,3,97
adjust_android_sdk,0,79,27,0,106
ExactTarget_fuel-java,0,1,7,0,8
JakeWharton_Telecine,0,0,1,0,1
ceph_cephfs-hadoop,0,27,0,0,27
xtreemfs_babudb,0,158,20,0,178
apache_airavata,343,5599,114,178,6234
cathive_sass-java,0,15,0,0,15
ArtificerRepo_artificer,0,225,73,0,298
squarespace_jersey2-guice,0,20,0,0,20
arangodb_arangodb-java-driver,245,162,59,628,1094
mini2Dx_mini2Dx,0,171,102,0,273
juniversal_jsimple,0,89,5,2,96
carymrobbins_intellij-haskforce,0,108,17,0,125
eseifert_gral,0,58,27,0,85
numenta_htm.java,0,78,23,0,101
googlegenomics_dataflow-java,16,71,4,0,91
HubSpot_live-config,0,1,0,0,1
Netflix_Raigad,0,55,1,0,56
marklogic_java-client-api,0,323,185,0,508
eclipsesource_J2V8,66,39,11,70,186
chiehmin_MinMinGuard,0,36,2,0,38
JasonRuckman_sidney,12,193,10,23,238
alaisi_postgres-async-driver,0,14,2,7,23
squeek502_ASMHelper,0,0,0,0,0
google_gcm,0,106,0,0,106
vogellacompany_eclipse4book,4,6,0,2,12
TheMCPEGamer_Dragonet,0,426,7,1,434
stephanenicolas_injectview,0,69,0,0,69
bkimminich_kata-tcg,0,0,0,2,2
hcoles_QuickBuilder,8,5,1,22,36
roikku_swift-explorer,0,24,5,0,29
stuartgunter_dropwizard-cassandra,22,6,1,0,29
outbrain_gruffalo,2,0,0,0,2
fredsa_gwt-dnd,0,18,2,0,20
kennycason_kumo,54,18,3,0,75
tsiemens_pathfinder-toolkit,0,117,13,0,130
google_iosched,0,0,0,0,0
AndroidHooker_hooker,0,32,0,0,32
yahoo_artifactory_ssh_proxy,0,12,2,0,14
oxo42_stateless4j,10,8,3,8,29
RichardWarburton_honest-profiler,0,184,9,0,193
Plaid_plaid-java,127,3476,14,105,3722
BuiltBrokenModding_ICBM,0,322,11,0,333
highsource_jaxb2-basics,20,127,31,57,235
MilkBowl_VaultAPI,0,1,0,0,1
Cascading_fluid,0,22,0,0,22
casidiablo_multidex,0,11,0,0,11
tsagi_JekyllForAndroid,0,120,4,0,124
wiztools_rest-client,0,52,12,0,64
BoltsFramework_Bolts-Java,0,0,0,0,0
ReactiveX_RxJava,0,66,54,4,124
RestExpress_RestExpress-Examples,0,19,1,0,20
mapzen_mapzen-android-demo,0,136,7,0,143
naver_pinpoint,2,2192,529,0,2723
SpringOne2GX-2014_microservice-security,0,0,0,0,0
virgo47_javasimon,135,104,22,340,601
yfpeng_pengyifan-commons,12,12,0,10,34
cping_RipplePower,0,3663,395,47,4105
pwittchen_NetworkEvents,0,3,0,0,3
sulewicz_springlayout,0,17,0,0,17
LapisBlue_Commons,0,44,0,0,44
googlemaps_google-maps-services-java,0,62,12,0,74
seleniumQuery_seleniumQuery,42,270,14,1461,1787
chenlb_mmseg4j-solr,0,0,0,0,0
datacleaner_DataCleaner,836,566,333,1188,2923
raulhaag_MiMangaNu,0,164,11,1,176
Putnami_putnami-web-toolkit,0,149,37,0,186
Stratio_stratio-ingestion,0,120,0,0,120
c4fcm_CLIFF,23,64,1,22,110
Appendium_objectlabkit,51,67,13,152,283
teamed_qulice,21,10,1,2,34
google_acai,2,1,0,0,3
mdeverdelhan_ta4j,94,13,23,353,483
bydavy_android-number-morphing,0,4,0,0,4
takari_takari-lifecycle,22,37,1,8,68
sjamesr_jfreesane,0,4,5,0,9
GoogleCloudPlatform_appengine-pipelines,0,72,10,0,82
caelum_vraptor-panettone,28,18,4,10,60
Stratio_streaming-cep-engine,15,64,9,5,93
VHAINNOVATIONS_InfoButtons-182,0,285,16,0,301
bytedeco_javacpp,56,23,4,153,236
fiji_Trainable_Segmentation,34,78,0,45,157
apache_incubator-samoa,14,112,32,72,230
SudoPlayGames_Joise,0,15,3,0,18
OpenTOSCA_container,277,1182,92,189,1740
path_android-priority-jobqueue,0,55,1,0,56
onepf_OPFPush,0,101,4,0,105
ksfzhaohui_gameserver,4,18,0,6,28
vert-x3_vertx-metrics,12,8,0,66,86
yccheok_jstock,0,129,29,1,159
fge_grappa,0,9,3,0,12
IBM-Bluemix_todo-apps,0,0,1,0,1
guardianproject_ChatSecureAndroid,0,826,29,0,855
bakerframework_baker-android,0,199,4,0,203
wbaumann_SmartReceiptsLibrary,0,595,52,0,647
KittehOrg_KittehIRCClientLib,35,237,14,234,520
linkedin_gobblin,1,4417,350,3,4771
ZK-1931_javazab,0,7,8,0,15
astefanutti_camel-cdi,0,12,2,0,14
robert-bor_aho-corasick,10,3,0,3,16
RichardWarburton_java-8-lambdas-exercises,18,28,0,3,49
PhonyTive_astivetoolkit,23,52,10,23,108
ColdSauce_Captor,0,58,1,0,59
softlayer_softlayer-java,11,2038,110,14,2173
Esri_solutions-geoevent-java,1,61,5,0,67
tabulapdf_tabula-java,38,18,5,55,116
Netflix_s3mper,0,2,0,0,2
HotswapProjects_HotswapAgent,163,362,102,405,1032
TEAMMATES_repo,0,761,177,0,938
gid15_jpcsp,493,6903,198,1179,8773
tdunning_t-digest,22,12,0,1,35
vanita5_twittnuker,0,431,7,0,438
raphaeljolivet_java2typescript,27,27,4,10,68
sdbg_sdbg,0,199,12,1,212
FenixEdu_fenixedu-academic,419,3819,664,7510,12412
copper-engine_copper-engine,0,62,21,1,84
rocketscience-projects_javaslang,0,104,58,57,219
cymcsg_UltimateAndroid,12,1294,21,0,1327
simpligility_android-ndk-maven-plugin,6,27,1,5,39
square_javapoet,0,20,5,2,27
l3nz_ObjectiveSync,1,12,0,0,13
danieloeh_EinschlafenPodcastAndroidApp,0,294,10,0,304
migzai_irc-api,51,25,12,65,153
commons-rdf_commons-rdf,3,41,1,22,67
real-logic_Agrona,0,170,2,0,172
ksoichiro_SimpleAlertDialog-for-Android,0,12,0,0,12
EugeneKay_subsonic,0,0,0,0,0
getsentry_raven-java,0,688,55,0,743
rover12421_ShakaApktool,0,1466,0,1,1467
nutzam_nutzwx,12,16,2,31,61
Microsoft_AppInsights-Android,0,4,3,1,8
ebay_oink,6,5,2,57,70
graf-abolmasov_digitalocean-teamcity-plugin,0,4,0,0,4
martinpaljak_GlobalPlatformPro,0,32,2,0,34
kuenishi_presto-riak,0,20,1,0,21
Netflix-Skunkworks_WSPerfLab,0,3,0,0,3
johnmartel_javaccPlugin,0,33,1,0,34
smola_galimatias,12,9,0,129,150
Jaspersoft_jrs-rest-java-client,0,176,28,0,204
kuali_kc,45,3744,578,22,4389
google_guice,170,243,95,624,1132
ruediste1_btrbck,0,6,5,0,11
Qkyrie_Twitch,0,18,0,1,19
sk89q_Eduardo,0,0,0,0,0
nidi3_raml-tester,43,39,3,107,192
tracee_tracee,6,42,2,61,111
chanjarster_weixin-java-tools,89,111,13,60,273
exteso_alf.io,0,209,115,0,324
OpenHFT_hftc,0,98,2,2,102
SpongePowered_Sponge,0,2211,62,3,2276
barterli_barterli_android,0,970,33,0,1003
finn-no_cassandra-hadoop,0,24,0,0,24
FlexTradeUKLtd_jfixture,102,9,4,49,164
nosceon_titanite,0,52,2,1,55
naver_yobi,0,146,38,2,186
mulesoft-labs_rhinodo,11,4,0,1,16
release-engineering_pom-manipulation-ext,89,123,34,19,265
vert-x3_vertx-codegen,54,42,27,510,633
AdoptOpenJDK_mjprof,0,27,1,0,28
247687009_soa,0,8,0,0,8
nhnopensource_volley-extensions,0,37,3,0,40
Netflix_dyno,0,32,13,0,45
jOOQ_jOOL,0,4,92,8,104
super-csv_super-csv,0,121,2,0,123
dkharrat_NexusData,2,27,5,0,34
ReactiveX_RxAndroid,0,0,0,0,0
yinglovezhuzhu_bitmaploader,0,11,0,0,11
recommenders_rival,0,191,7,0,198
OfficeDev_Office-365-SDK-for-Android,0,44,4,0,48
twitter_cloudhopper-commons,21,162,8,2,193
searchisko_elasticsearch-river-sysinfo,20,9,4,11,44
orchestrate-io_orchestrate-java-client,0,0,0,0,0
ObeoNetwork_UML-Designer,0,181,5,21,207
PasaLab_Tachyon-Perf,0,7,0,0,7
PaNaVTEC_Clean-Contacts,0,8,2,0,10
bodar_totallylazy,0,252,34,23,309
addthis_hydra,12,180,34,4,230
aerospike_aerospike-loader,0,31,2,0,33
nutzam_ssdb4j,0,117,0,0,117
jenkinsci_acceptance-test-harness,0,127,20,0,147
sanity_quickml,125,130,28,133,416
swagger-api_swagger-parser,136,21,6,48,211
openMF_android-client,0,511,25,0,536
AzureAD_azure-activedirectory-library-for-android,0,309,24,19,352
Stratio_flume-ingestion,0,120,0,0,120
hyperic_hq,0,2873,486,8,3367
Genymobile_genymotion-binocle,0,10,0,0,10
s-u_rJava,0,90,0,0,90
dpreussler_jodamoblog,0,0,0,0,0
holyeye_spring-trace,0,18,0,0,18
OrbitzWorldwide_consul-client,8,107,16,70,201
orctom_was-maven-plugin,1,2,0,0,3
spring-io_sagan,0,31,13,0,44
sonyxperiadev_gerrit-events,35,110,4,25,174
mybatis_ibatis-2,55,29,19,272,375
DroidPlanner_DroneKit-Android,0,2340,37,0,2377
neo4j-contrib_cypher-dsl,0,98,37,0,135
nhl_link-rest,48,450,68,277,843
sequenceiq_periscope,0,19,7,0,26
bitcoin-solutions_multibit-hd,0,342,156,0,498
kenshoo_freemarker-online,0,0,0,0,0
SeanTater_uncc2014watsonsim,0,19,0,0,19
pusher_pusher-websocket-java,0,9,13,0,22
Raizlabs_Broker,0,0,0,0,0
OAuth-Apis_apis,50,17,5,13,85
google_closure-stylesheets,417,68,73,665,1223
paksv_teamcity-azure-plugin,0,1,0,0,1
ArcBees_gwtquery,0,228,7,7,242
unitsofmeasurement_unit-api,2,37,5,30,74
reactive-streams_reactive-streams-jvm,0,16,0,0,16
filoghost_HolographicDisplays,0,47,9,1,57
dvorka_keepass2-to-keepassx,0,0,0,0,0
relayr_android-sdk,0,0,0,0,0
real-logic_simple-binary-encoding,0,113,14,0,127
hal_circuit,22,44,5,12,83
Raizlabs_DBFlow,0,0,0,0,0
gwizard_gwizard,0,29,0,0,29
primecloud-controller-org_primecloud-controller,28,164,105,0,297
ymcao_fullplayer,0,328,0,0,328
hawkular_hawkular-metrics,0,147,15,0,162
silb_shiro-jersey,0,1,0,0,1
ampm_douban-fm-sdk,0,113,8,0,121
elastic_elasticsearch-analy,0,0,0,0,0
jelkosz_Kanbanik,0,30,20,2,52
nordicway_moji,0,1,0,0,1
marschall_threeten-jpa,2,69,8,0,79
ulyn_eos,0,88,13,0,101
oswetto_Loboevolution,480,1346,199,1835,3860
serso_android-checkout,0,32,12,0,44
Stratio_stratio-deep,0,109,10,0,119
bryanreinero_Firehose,0,13,0,1,14
outbrain_Aletheia,0,0,0,0,0
cglib_cglib,33,124,13,54,224
TDesjardins_GWT-OL3-Playground,118,9,37,30,194
MSOpenTech_azure-activedirectory-library-for-android,0,309,24,19,352
googlesamples_android-JobScheduler,0,13,0,0,13
fluo-io_fluo,158,224,36,367,785
ctron_package-drone,0,446,64,0,510
ReactiveX_RxNetty,0,87,12,0,99
sequenceiq_sequenceiq-samples,3,13,0,0,16
﻿﻿square_moshi,0,0,0,0,0
idok_eslint-plugin,0,32,1,0,33
telefonicaid_fiware-cygnus,0,143,14,0,157
libgdx_gdx-ai,0,84,16,1,101
graphaware_neo4j-timetree,0,0,0,0,0
googlesamples_android-ElevationDrag,0,10,0,0,10
groupon_odo,0,198,7,0,205
LucidWorks_spark-solr,0,14,0,0,14
Talend_tcommon-studio-se,0,3434,961,14,4409
serenity-bdd_serenity-core,388,396,134,2456,3374
wikimedia_search-highlighter,40,33,2,8,83
EgorKulikov_idea-chelper,0,28,6,0,34
vokalinteractive_VolleyBall,0,19,0,0,19
ptgoetz_storm-hdfs,0,18,0,0,18
bodar_utterlyidle,0,305,27,4,336
project-flink_flink-graph,0,0,0,0,0
OPENNETWORKINGLAB_onos,0,4247,1155,2,5404
riven8192_LibStruct,0,91,1,0,92
Label305_Stan-for-Android,0,0,0,0,0
Comcast_cats,0,0,0,0,0
pac4j_pac4j,286,492,95,134,1007
google_u2f-ref-code,0,26,7,0,33
michaelwittig_java-q,6,26,6,58,96
mariuswatz_modelbuilderMk2,13,660,4,24,701
SAP_cloud-dirigible,0,2070,47,0,2117
neokree_MaterialNavigationDrawer,0,16,1,0,17
Stratio_stratio-meta,0,0,0,0,0
Stratio_crossdata,0,0,0,0,0
andytill_erlyberly,0,11,3,0,14
spring-cloud_spring-cloud-cli,2,3,0,0,5
federicoiosue_Omni-Notes,0,76,13,1,90
naver_ngrinder,0,90,37,0,127
dsyer_spring-security-angular,0,0,0,0,0
SnippingToolPlusPlus_SnippingToolPlusPlus,0,82,7,2,91
rpau_walkmod-core,105,34,15,131,285
schema-repo_schema-repo,20,33,0,21,74
rundeck_rundeck,0,1137,91,0,1228
davityle_ngAndroid,0,88,9,0,97
Evolveum_midpoint,0,0,0,0,0
Kixeye_janus,0,14,0,0,14
headissue_cache2k,0,188,26,0,214
shouldit_android-proxy,0,0,0,0,0
seyhanp_seyhan,0,72,129,0,201
SurveyMan_SurveyMan,85,57,25,20,187
pivotalsoftware_pivotal-samples,0,4,0,0,4
peholmst_vaadin4spring,0,5,0,0,5
neo4j-contrib_graph-collections,34,77,10,65,186
digidotcom_XBeeJavaLibrary,266,58,67,60,451
jvirtanen_nassau,17,18,3,10,48
benjiman_expressions,0,11,0,0,11
Netflix_Prana,0,5,0,0,5
bitfireAT_cadroid,0,0,0,0,0
saulmm_Material-Movies,0,29,0,0,29
lesaint_damapping,15,50,18,122,205
hazelcast_hazelcast-simulator,0,65,21,0,86
manuzhang_storm-benchmark,25,206,0,0,231
apache_olingo-odata2telefonicaid_fiware-cygnus,0,0,0,0,0
rmagen_elastic-gremlin,5,11,0,0,16
lilicoding_soot-infoflow-android-iccta,0,55,3,1,59
openhab_openhab2,2231,19872,495,3512,26110
artem-zinnatullin_android-wail-app,0,54,4,0,58
GlowstoneMC_Glowstone,0,262,46,0,308
mayconbordin_streaminer,0,67,2,6,75
thechunknetwork_RedisBungee,0,11,1,0,12
xtext_seven-languages-xtext,0,3999,15,0,4014
cloudera_cm_ext,0,62,4,0,66
timolson_cointrader,63,453,47,1500,2063
SanderGielisse_Enderstone,0,50,17,2,69
DawnFire-Realms_CommunityBridge,0,10,5,0,15
Linfar_TeamCity.SonarQubePlugin,14,55,2,0,71
docopt_docopt.java,3,4,1,4,12
conveyal_gtfs-data-manager,0,16,1,0,17
codecentric_spring-boot-starter-batch-web,7,7,0,0,14
teamed_requs,26,119,2,7,154
tarql_tarql,16,10,0,57,83
TomasMikula_ReactFX,1,14,3,1,19
larsgrefer_android-library,0,10,0,1,11
sogyf_mybatis-pagination,0,14,0,0,14
googlesamples_android-FloatingActionButtonBasic,0,10,0,0,10
pac4j_vertx-pac4j,1,6,0,0,7
fge_throwing-lambdas,0,3,1,0,4
lenskit_lenskit,0,67,54,0,121
MALfunction84_psi-probe,0,56,3,0,59
payara_Payara,1668,8164,1170,2522,13524
OpenHFT_Chronicle-Map,15,113,20,552,700
SignalR_java-client,0,14,11,0,25
edgedalmacio_phisix,20,6,2,13,41
altamiracorp_honeycomb,0,0,0,0,0
Azure_azure-documentdb-java,0,8,0,0,8
xerial_sqlite-jdbc,15,72,2,54,143
hdweiss_mOrgAnd,0,30,1,0,31
totalvoidness_cryptomator,0,45,12,0,57
cbitstech_Purple-Robot,0,484,26,0,510
amten_NeuralNetwork,0,2,0,0,2
sonyxperiadev_MultimediaForAndroidLibrary,0,342,12,1,355
HotelsDotCom_plunger,0,5,0,0,5
windy1_google-places-api-java,5,5,2,16,28
spring-cloud_spring-cloud-consul,0,59,0,0,59
DICE-UNC_jargon,0,1100,200,0,1300
apache_incubator-tamaya,124,17,9,206,356
mifmif_Generex,0,0,0,0,0
PGWelch_com.opendoorlogistics,0,610,149,0,759
tynamo_tapestry-resteasy,0,4,0,0,4
SonarSource_sonar-findbugs,16,54,4,5,79
PhantomYdn_wicket-orientdb,10,149,5,67,231
mobiledeeplinking_mobiledeeplinking-android,0,15,0,0,15
OryxProject_oryx,87,27,21,25,160
InfinityRaider_AgriCraft,0,570,16,13,599
ontometrics_slack-youtrack,0,25,1,0,26
unchartedsoftware_aperture-tiles,0,160,16,1,177
Azure_azure-storage-java,0,0,0,0,0
Universal-Electricity_ICBM,0,322,11,0,333
datanucleus_datanucleus-core,214,681,135,3284,4314
Roanis_atg-tdd,0,50,0,1,51
snakerflow_snakerflow,0,61,10,0,71
nhatminhle_cofoja,0,22,9,2,33
stealthly_xml-avro,0,4,0,0,4
novoda_sqlite-provider,0,43,1,0,44
vladimirvivien_clamshell-cli,0,28,0,0,28
awslabs_aws-dynamodb-encryption-java,32,79,6,52,169
Stratio_deep-spark,0,109,10,0,119
NoChanceSD_PvPManager,0,19,7,0,26
lqd-io_liquid-sdk-android,0,22,1,2,25
wix_petri,0,146,9,4,159
Azure_azure-notificationhubs-samples,0,0,0,0,0
wgybzbrobot_sns-crm,0,29,0,0,29
caskdata_netty-http,0,0,0,0,0
DataDog_jmxfetch,0,23,2,0,25
geftimov_MapReduce,0,76,0,0,76
eclipse-jetty_eclipse-jetty-plugin,8,228,4,22,262
my2iu_Jinq,51,314,28,134,527
galenframework_galen,11,103,23,2,139
camunda_camunda-consulting,0,1805,10,0,1815
forcedotcom_SalesforceMobileSDK-CordovaPlugin,0,428,23,12,463
embulk_embulk-output-jdbc,0,7,1,0,8
kite-sdk_kite,0,393,80,0,473
Vektah_idea-rust,0,0,0,0,0
mvarnagiris_financius-public,0,259,44,0,303
appium_droiddriver,0,0,0,0,0
spring-projects_spring-session,0,47,2,0,49
netplex_json-smart-v1,0,73,1,0,74
jonnyzzz_TeamCity.Virtual,0,20,0,0,20
mahmoudparsian_data-algorithms-book,14,15,2,0,31
gravel-st_gravel,0,614,112,159,885
WhisperSystems_WebSocket-Resources,10,62,1,6,79
fiji_Stitching,25,189,5,27,246
ikarienator_pure-idea,0,0,0,0,0
apache_stratos,0,1102,104,9,1215
joshlong_boot-examples,0,6,0,0,6
googlesamples_android-testing,0,14,0,0,14
yandex-qatools_hamcrest-pojo-matcher-generator,0,6,0,0,6
JakeWharton_paraphrase,0,0,0,0,0
dgageot_simplelenium,6,1,1,11,19
yammer_breakerbox,0,13,4,0,17
zk1931_jzab,0,7,8,0,15
bedrin_jsonde,0,40,5,7,52
PayPal_PayPal-Java-SDK,0,251,16,0,267
dropwizard_dropwizard-protobuf,2,36,0,0,38
danielnorberg_auto-matter,0,0,0,0,0
shazam_fork,0,46,7,0,53
shamanland_floating-action-button,0,2,0,0,2
loldevs_riotapi,0,108,7,0,115
HearthStats_HearthStats.net-Uploader,1,321,0,0,322
spring-projects_spring-xd-modules,0,1,0,0,1
vibe-project_vibe-java-server,3,0,0,0,3
chocotan_lolibox,0,4,1,0,5
scriptella_scriptella-etl,0,126,18,0,144
codeine-cd_codeine,0,540,44,0,584
wildflyext_wildfly-camel,56,175,3,14,248
takari_takari-local-repository,7,1,0,0,8
spotify_crtauth-java,13,5,2,5,25
nusco_narjillos,0,50,15,2,67
intercom_intercom-java,0,75,13,9,97
dangdangdotcom_config-toolkit,0,7,0,0,7
murraycu_android-galaxyzoo,0,128,5,0,133
neo4j_neo4j-ogm,323,103,68,488,982
drapostolos_type-parser,0,6,3,0,9
zerograph_zerograph,0,0,0,0,0
SomMeri_matasano-cryptopals-solutions,0,76,8,0,84
kaazing_k3po,264,528,49,136,977
red5_red5-hls-plugin,0,1,1,0,2
flipkart-incubator_foxtrot,0,94,40,0,134
phishman3579_java-algorithms-implementation,0,62,1,0,63
Crate_crate,0,2630,1214,11,3855
KronicDeth_intellij-elixir,0,187,18,0,205
liftsecurity_burpbuddy,0,0,1,0,1
neuroph_master,0,224,73,0,297
googlesamples_android-BasicSyncAdapter,0,41,0,0,41
devnied_EMV-NFC-Paycard-Enrollment,35,237,5,238,515
jbruchanov_AnUitor,0,31,0,0,31
Kixeye_chassis,5,104,3,1,113
spring-projects_spring-integration-aws,0,41,0,0,41
orientechnologies_orientdb-lucene,0,11,0,0,11
nginx-clojure_nginx-clojure,0,780,30,1,811
jMetal_jMetal,0,142,172,2,316
sitewhere_sitewhere,0,188,6,0,194
eclipse_leshan,0,233,98,0,331
jboss-gpe_processFlowProvision,0,138,0,0,138
Apereo-Learning-Analytics-Initiative_OpenDashboard,0,42,4,0,46
lumongo_lumongo,0,1205,23,0,1228
GumTreeDiff_gumtree,0,103,5,3,111
SkymindIO_nd4j,0,0,0,0,0
hadooparchitecturebook_hadoop-arch-book,0,67,1,0,68
norecha_pokubot,0,24,1,0,25
sualeh_magnetictrackparser,0,0,0,14,14
xored_yang-ide,0,223,33,1,257
poetix_protonpack,0,0,1,4,5
freemarker_fmpp,0,143,4,0,147
Netflix_Surus,0,0,0,0,0
Graphity_graphity-client,0,74,0,0,74
mikvor_hashmapTest,2,19,0,0,21
gridkit_nanocloud,122,308,24,178,632
WalnutiQ_WalnutiQ,0,0,0,0,0
jackpf_ApkDownloader,24,1691,9,150,1874
jparkie_GivesMeHopeAndroidClient,0,106,2,0,108
openmhealth_omh-shims,0,0,0,0,0
outbrain_ob1k,0,87,22,0,109
Pyros2097_GdxStudio,0,827,20,12,859
xhanin_jarup,1,0,0,1,2
kristian-lange_MechArg,0,250,55,0,305
Cascading_cascading-hive,1,14,0,0,15
Cloudslab_CloudSimEx,0,45,17,0,62
ReactiveX_RxSwing,0,2,0,0,2
appium_java-client,0,81,3,0,84
spotify_cassandra-reaper,0,0,0,0,0
jvirtanen_parity,15,57,1,16,89
pusher_pusher-http-java,7,46,1,0,54
JorgeCastilloPrz_Corleone,0,3,0,0,3
spring-projects_spring-integration-kafka,0,13,1,0,14
welovecoding_editorconfig-netbeans,0,123,0,0,123
cegeka_batchers,0,91,3,0,94
ysc_word,42,3,2,33,80
ReactiveX_RxJavaJoins,0,0,0,0,0
larsga_Duke,82,11,7,11,111
pedrovgs_Algorithms,0,2,0,0,2
indexiatech_antiquity,8,27,4,47,86
marcosvidolin_doco,6,0,0,0,6
nenick_AndroidAppDevelopment,0,3,3,0,6
Viscent_JavaConcurrencyPattern,0,0,0,0,0
SimonVT_cathode,0,329,1,0,330
apache_incubator-wave,1,2372,429,2,2804
HiddenStage_divide,0,198,8,0,206
caskdata_coopr,0,449,62,0,511
WhisperSystems_libaxolotl-android,0,22,12,0,34
douglascraigschmidt_POSA-14,1,96,0,0,97
emory-courses_cs323,0,0,0,1,1
Ullink_simple-slack-api,0,7,9,0,16
klinker24_Talon-for-Twitter,0,580,20,0,600
bozaro_git-as-svn,0,0,0,0,0
fiji_TrackMate,219,579,55,598,1451
pardom_ollie,0,35,0,0,35
digitalfondue_lavagna,0,65,26,0,91
ddavison_conductor,0,9,0,0,9
valchkou_cassandra-driver-mapping,0,2,4,0,6
CIRDLES_Topsoil,0,96,10,0,106
ShifuML_guagua,18,205,6,54,283
rapidminer_rapidminer,0,3457,547,13,4017
apache_metamodel,413,342,152,1753,2660
kuujo_copycat,164,179,184,1860,2387
spring-projects_spring-integration-java-dsl,0,56,5,3,64
dobrynya_nomin,0,26,0,0,26
jmrozanec_cron-utils,121,6,22,331,480
basis-technology-corp_tcl-regex-java,0,2,3,0,5
GoogleCloudPlatform_bigdata-interop,96,274,34,170,574
lucaspouzac_contiperf,0,37,3,0,40
Stratio_stratio-cassandra,0,1543,299,4,1846
pulsarIO_realtime-analytics,40,38,4,44,126
rejasupotaro_octodroid,0,39,0,0,39
lemonlabs_u2020-mortar,0,31,1,0,32
codefollower_Tomcat-Research,1350,3854,478,3740,9422
h2oai_h2o,293,1001,105,613,2012
pavel4n_wowdoge.org,303,795,72,776,1946
SharedKnowledge_SharkFW,92,316,69,113,590
kishida_sqlparser,0,56,0,0,56
jcabi_jcabi-http,49,1,2,177,229
SkymindIO_deeplearning4j,0,0,0,0,0
simon-heinen_SimpleUi,0,131,6,2,139
nemerosa_ontrack,0,59,6,3,68
bonigarcia_dualsub,13,79,3,51,146
RuedigerMoeller_kontraktor,0,241,34,17,292
wildfly_wildfly-core,905,4582,1213,3527,10227
ElectronicChartCentre_java-vector-tile,5,89,0,0,94
google_domaintest,18,56,2,11,87
passy_scdl,0,109,3,1,113
jagornet_dhcp,0,213,36,0,249
iilab_PanicButton,0,59,6,0,65
hiteshsondhi88_ffmpeg-android-java,0,0,1,0,1
holodeck-b2b_Holodeck-B2B,7,195,98,147,447
Netflix_aegisthus,0,65,1,0,66
googlesamples_android-ElevationBasic,0,9,0,0,9
subchen_jetbrick-template-2x,23,412,14,56,505
deeplearning4j_nd4j,0,0,0,0,0
pilehvar_ADW,0,0,2,4,6
mozilla_MozStumbler,0,315,20,0,335
guardianproject_NetCipher,0,76,0,0,76
mcupak_beacon-of-beacons,0,30,3,0,33
oyachai_HearthSim,0,79,34,0,113
jlinn_quartz-redis-jobstore,3,8,1,1,13
damiencarol_jsr203-hadoop,1,1,0,23,25
LordH3lmchen_TwitchTools,0,10,1,0,11
RoyalDev_TheHumanity,0,0,0,0,0
nulab_backlog4j,0,9,3,0,12
TeamCohen_ProPPR,0,145,27,0,172
libgdx_box2dlights,7,24,0,0,31
google_truth,13,116,10,1024,1163
serenity-bdd_serenity-demos,0,9,0,0,9
JetBrains_youtrack.mylyn.connector,0,59,2,0,61
yangchenjava_com.yangc.utils,0,14,0,0,14
abel533_ECharts,0,13,7,0,20
Devexperts_aprof,0,16,2,1,19
greenmail-mail-test_greenmail,0,152,7,2,161
willowtreeapps_saguaro,0,0,0,0,0
dart-maven-plugin_dart-maven-plugin,1,0,0,0,1
denimgroup_threadfix,0,795,101,11,907
pastekit_twist,10,9,1,22,42
GoogleCloudPlatform_DataflowJavaSDK,0,0,0,0,0
buremba_rakam,0,77,8,0,85
Tillerino_Tillerinobot,0,75,12,0,87
emicklei_rendersnake,0,28,1,1,30
Dalanie_SimpleNews,0,14,2,0,16
twotoasters_multi-column-list-adapter,0,5,0,0,5
opensciencemap_vtm,0,676,41,0,717
elastic_elasticsearch-river-couchdb,0,3,0,0,3
dbfit_dbfit,0,59,0,1,60
idok_jscs-plugin,0,15,0,0,15
elastic_elasticsearch-river-wikipedia,0,2,0,0,2
jkazama_ddd-java,0,24,0,2,26
bywan_trello-java-wrapper,0,76,5,0,81
AmailP_robot-plugin,0,1,0,0,1
glazedlists_glazedlists,0,188,38,0,226
englishtown_vertx-cassandra,5,40,0,17,62
enonic_xp,0,1287,755,0,2042
Instagram_ig-json-parser,0,81,4,0,85
mbernste_machine-learning,0,14,6,0,20
vert-x3_codegen,54,42,27,510,633
Azure_azure-notificationhubs,0,17,2,0,19
google_closure-templates,352,2073,398,2301,5124
pantsbuild_intellij-pants-plugin,0,90,7,0,97
socketIo4Netty_socketIo4j,0,38,2,0,40
beothorn_webGrude,0,5,0,0,5
OpenMRS_openmrs-module-fhir,50,279,5,265,599
jitsi_jigasi,25,147,7,26,205
srikalyc_Sql4D,0,726,3,0,729
HubTurbo_HubTurbo,0,140,17,2,159
freenet_contrib,1,29,0,1,31
elibom_jogger,21,59,4,2,86
airbnb_airpal,0,25,6,0,31
fizzed_java-stork,8,7,1,6,22
extjwnl_extjwnl,55,45,25,228,353
xpqiu_fnlp,241,63,32,215,551
GoogleCloudPlatform_gcloud-java,0,0,0,0,0
moznion_java-mysql-diff,0,6,0,0,6
vert-x3_service-proxy,9,19,2,20,50
nhaarman_Triad,0,2,0,0,2
gwtbootstrap3_gwtbootstrap3,4,402,11,0,417
AlchemyAPI_alchemyapi_java,8,56,1,0,65
OneDrive_onedrive-picker-android,0,3,0,0,3
hankcs_HanLP,0,0,0,0,0
elastic_elasticsearch-transport-memcached,0,5,0,0,5
WASdev_standards.jsr352.jbatch,34,102,24,119,279
Kixeye_kixmpp,27,24,8,79,138
w3c_ldp-testsuite,5,100,2,0,107
EverythingMe_plaxien,0,4,0,0,4
kaklakariada_portmapper,0,14,0,0,14
spring-platform-samples_eureka,0,0,0,0,0
headwirecom_aem-solr-search,0,129,0,0,129
Rayman2200_PDFA3,109,21,16,252,398
bither_bitherj,0,682,27,14,723
OpenSilk_Orpheus,2,777,90,1,870
Wolfgang-Schuetzelhofer_jcypher,135,251,93,811,1290
pcingola_SnpEff,400,405,74,332,1211
mirkosertic_FXDesktopSearch,0,16,2,0,18
magarena_magarena,0,1164,212,5,1381
SmartBear_JCeleryWorker,0,2,0,0,2
blad_solid-android,0,9,0,0,9
etsy_Conjecture,0,7,1,1,9
mikvor_money-conversion,2,1,0,43,46
Innovattic_Android-Font-Integration,0,2,0,1,3
goodow_realtime-store,0,2,5,0,7
google_uribeacon,0,0,0,0,0
airbnb_AirMapView,0,3,5,0,8
Cardshifter_Cardshifter,0,25,26,0,51
manfenixhome_RightUtils,0,21,0,0,21
lessthanoptimal_ejml,0,93,83,0,176
semihsalihoglu_graft,0,43,0,0,43
nicklondhe_newsindexer,8,0,1,1,10
deeplearning4j_deeplearning4j,0,0,0,0,0
dkandalov_limited-wip,0,0,0,0,0
google_rich-test-results,0,1,0,0,1
ribot_easy-adapter,0,3,0,0,3
lightcouch_LightCouch,0,5,1,1,7
tuplejump_stargate-core,0,53,5,0,58
4pr0n_ripme,22,15,2,82,121
geopaparazzi_geopaparazzi,0,420,52,0,472
meyerjp3_psychometrics,240,11,17,151,419
levigo_jbig2-imageio,68,50,8,48,174
nightscout_android-uploader,0,135,5,0,140
reines_dropwizard-debpkg-maven-plugin,14,2,2,8,26
HdrHistogram_HdrHistogram,65,4,5,6,80
elastic_elasticsearch-cloud-azure,0,0,0,0,0
netizen539_civcraft,202,588,122,1359,2271
wso2_siddhi,73,287,152,973,1485
FasterXML_jackson-dataformat-cbor,4,41,0,0,45
cybergarage_cybergarage-upnp,105,630,22,185,942
nextopio_nextop-client,43,503,32,20,598
egymgmbh_log-queue,0,0,0,0,0
subchen_jetbrick-template-1x,39,344,6,48,437
Netflix_Nicobar,0,33,9,0,42
igniterealtime_Spark,288,974,136,1103,2501
mulesoft-labs_quartz-mongodb,0,2,0,0,2
smartparam_smartparam,0,23,31,3,57
HadoopGenomics_Hadoop-BAM,42,91,3,0,136
dropwizard_metrics,155,133,18,176,482
spring-guides_deprecate-tut-data,0,0,0,0,0
igniterealtime_jxmpp,0,50,4,0,54
igniterealtime_Smack,0,1778,163,3,1944
lmcgrath_scotch-lang,0,0,0,0,0
Talend_tdi-studio-se,2,8407,544,15,8968
google_google-http-java-client,116,225,15,212,568
sequenceiq_cloudbreak-shell,0,0,0,0,0
Mashape_Astronode-Broadcaster,1,0,0,3,4
mobile-event-processing_Asper,0,4535,618,1,5154
wso2_carbon-identity,482,7041,202,133,7858
rkday_jsipp,0,4,2,0,6
ks-no_eventstore2,8,145,7,5,165
SonarCommunity_sonar-csharp,47,147,5,0,199
ustwo_Clockwise,0,22,0,0,22
elastic_elasticsearch-river-rabbitmq,0,0,0,0,0
chenlb_mmseg4j-core,5,9,0,0,14
poetix_octarine,0,72,3,2,77
geckoboard-java-api_highchart-java-api,0,0,0,0,0
RNCryptor_JNCryptor,14,0,0,0,14
jlpoolen_libreveris,9,428,118,17,572
pedrovgs_Renderers,0,0,0,0,0
ic3fox_jawr,0,270,58,0,328
javaee-samples_javaee7-samples,26,118,5,2,151
Berico-Technologies_RabbidManagement,0,0,0,0,0
awslabs_aws-sdk-java-resources,4,46,22,6,78
whois-server-list_public-suffix-list,23,11,0,24,58
the-blue-alliance_the-blue-alliance-android,0,432,68,0,500
kohlschutter_junixsocket,4,113,33,1,151
elasticsearch_elasticsearch-cloud-azure,0,0,0,0,0
jindrapetrik_jpexs-decompiler,648,2346,515,856,4365
linux-china_plantuml-gist,0,1,0,0,1
vert-x3_vertx-reactive-streams,0,0,0,0,0
spearal_spearal-java,0,13,2,0,15
sneerteam_sneer,0,29,4,0,33
sarl_sarl,54,2328,77,487,2946
abel533_Mapper,61,53,5,79,198
AppliedEnergistics_Applied-Energistics-2,0,1191,158,8,1357
apache_incubator-brooklyn,0,2758,676,18,3452
nok_soundcloud-java-library,0,7,0,0,7
digitalbuddha_AndroidStarter,0,1184,0,0,1184
Ecwid_consul-api,0,31,3,0,34
ajohnston9_ciscorouter,0,12,1,0,13
TannerPerrien_picasso-transformations,0,68,0,0,68
OpenHFT_Chronicle-Queue,28,43,12,363,446
caskdata_cdap,0,5228,1011,2,6241
kiselev-dv_gazetteer,0,102,11,0,113
jansorg_BashSupport,0,97,12,0,109
googlesamples_android-Interpolator,0,0,0,0,0
kairosdb_kairosdb-client,22,1,4,83,110
nguyenq_tess4j,8,134,0,0,142
majikthys_log4j2-logstash-jsonevent-layout,0,2,0,0,2
kirimin_mitsumine,0,0,0,0,0
shalupov_idea-cloudformation,0,0,0,0,0
Netflix_ReactiveLab,0,22,0,0,22
krasa_StringManipulation,0,76,6,1,83
jamesagnew_hapi-fhir,1,1959,687,3,2650
ruby-concurrency_thread_safe,0,11,0,0,11
juniversal_juniversal,19,371,4,10,404
jprante_log4j2-elasticsearch,0,0,0,0,0
AChep_AcDisplay,0,327,17,0,344
HPI-Information-Systems_Metanome,258,179,51,229,717
basgren_railways,0,52,1,0,53
Stratio_stratio-streaming,15,64,9,5,93
gustavomondron_twik,0,34,5,0,39
swookiee_com.swookiee.runtime,0,15,1,0,16
codelibs_elasticsearch-dynarank,0,18,0,0,18
radcortez_wow-auctions,2,2,0,0,4
hansenji_pocketknife,0,90,0,0,90
palantir_stash-codesearch-plugin,0,40,1,0,41
irobertson_pojomatic,14,28,2,14,58
TomasMikula_EasyBind,0,0,0,0,0
RaiMan_SikuliX2,0,0,0,0,0
ESAPI_esapi-java-legacy,145,210,21,480,856
ben-manes_concurrentlinkedhashmap,0,11,0,0,11
psidnell_ofexport2,20,16,6,38,80
mraad_Shapefile,25,3,0,2,30
ruediste_btrbck,0,6,5,0,11
tectonicus_tectonicus,0,123,101,0,224
jherico_jovr,0,347,2,0,349
ushahidi_platform-android,0,0,0,0,0
janus-project_janusproject,0,0,0,0,0
englishtown_vertx-when,7,1,0,0,8
aol_simple-react,0,380,231,82,693
cloud-software-foundation_c5,0,4125,450,0,4575
OpenSOC_opensoc-streaming,2,92,1,0,95
JD-Software_JDeSurvey,0,2,10,0,12
dita4publishers_dita4publishers,0,213,22,0,235
project-ncl_pnc,283,734,174,511,1702
thheller_shadow-pgsql,0,54,6,0,60
cesquivias_mumbler,0,6,2,0,8
google_openrtb-doubleclick,0,21,0,0,21
InkApplications_android-preferences,0,0,0,0,0
stickfigure_objectify-insight,0,8,0,0,8
Cloudslab_cloudsim,100,291,37,341,769
OPENNETWORKINGLAB_OpenVirteX,0,92,19,0,111
edwardcapriolo_nibiru,141,45,28,226,440
vt-middleware_passay,0,55,2,0,57
btrplace_scheduler,0,97,109,0,206
Netflix_staash,0,196,12,0,208
sford_yet-another-commit-checker,0,0,0,0,0
google_thread-weaver,0,0,11,1,12
fbacchella_RRD4J,0,0,0,0,0
warmshowers_wsandroid,0,3,0,0,3
stagemonitor_stagemonitor,0,145,50,2,197
apache_incubator-calcite,0,2075,734,4,2813
peakgames_libgdx-stagebuilder,0,0,0,0,0
mscharhag_oleaster,4,10,1,2,17
openlvc_portico,0,279,139,0,418
h6ah4i_android-openslmediaplayer,0,651,15,0,666
maciejmiklas_cyclop,0,48,16,0,64
calrissian_flowmix,34,31,3,90,158
midonet_midonet,0,739,26,0,765
google_google-oauth-java-client,33,16,0,10,59
ReactiveX_RxJavaReactiveStreams,0,2,0,0,2
spotify_docker-maven-plugin,6,3,0,0,9
eseifert_vectorgraphics2d,0,30,3,0,33
divolte_divolte-collector,0,43,3,0,46
theupswell_appengine-counter,0,6,0,0,6
trulia_trulia-java-rets-client,1,698,15,0,714
roboconf_roboconf-platform,0,215,140,0,355
NetApp_NetApp-Hadoop-NFS-Connector,0,50,2,0,52
hk2-project_hk2,0,627,188,0,815
yfain_java24hourtrainer2ndedition,0,1,0,0,1
komamitsu_jackson-dataformat-msgpack,0,7,0,0,7
WhisperSystems_TextSecure-Server,0,164,43,0,207
cecom_pomutils,16,1,0,1,18
davidsowerby_krail,0,29,12,4,45
venmo_cursor-utils,0,0,0,0,0
fesh0r_fernflower,0,261,54,0,315
Robbert1_boot-stateless-auth,0,0,0,0,0
guardianproject_android-ffmpeg-java,0,44,0,0,44
HolmesNL_kafka-spout,7,12,0,0,19
jbachorik_btrace,0,252,13,0,265
HotswapProjects_HotswapAgentExamples,0,12,0,0,12
krisjey_redis.usecase,0,1,0,0,1
pushtorefresh_bamboo-storage,0,186,25,0,211
tpalsulich_NYU-BusTracker-Android,0,22,1,4,27
jprante_elasticsearch-xml,0,20,0,0,20
spring-guides_deprecate-tut-rest,0,0,0,0,0
aceleradora6-tw_RegistroLivre,0,2,1,0,3
codelibs_elasticsearch-cluster-runner,0,9,0,0,9
arun-gupta_wildfly-samples,28,59,7,41,135
whatscloud_whatscloud-android,0,135,14,2,151
GeeQuery_ef-orm,0,0,0,0,0
BranchMetrics_Branch-Android-SDK,0,78,8,1,87
googlesamples_android-NavigationDrawer,0,11,0,0,11
mpcjanssen_simpletask-android,0,25,0,0,25
eHarmony_vw-webservice,0,19,2,0,21
wso2_MDM-Android-Agent,0,111,5,0,116
flaxsearch_luwak,55,60,10,8,133
camunda_camunda-modeler-standalone,0,0,0,0,0
VRL-Studio_VRL,0,506,58,1,565
edwardcapriolo_farsandra,9,0,0,78,87
scratches_spring-boot-legacy,1,3,0,0,4
phasenraum2010_javaee7-petclinic,0,0,2,0,2
mrniko_redisson,457,387,210,1364,2418
lordi_tickmate,0,29,0,0,29
webdriverextensions_webdriverextensions,4,29,2,0,35
syncthing_syncthing-android,0,79,8,0,87
couchbase_couchbase-jvm-core,95,216,71,293,675
spring-cloud_spring-cloud-connectors,0,52,1,0,53
dcevm_dcevm,0,385,0,0,385
brettwooldridge_HikariJSON,1,22,0,0,23
Baqend_Orestes-Bloomfilter,0,15,2,2,19
quemb_QMBForm,0,67,4,0,71
sequenceiq_cloudbreak,0,1579,305,0,1884
JetBrains_teamcity-deployer-plugin,6,53,0,0,59
Netflix_zeno,0,39,12,0,51
viritin_viritin,27,71,4,23,125
vladmihalcea_flexy-pool,0,85,5,0,90
chanjarster_tomcat-mongo-access-log,0,31,0,0,31
Alexey1Gavrilov_expectit,40,11,3,24,78
Vincentyification_JavaBot,13,16,3,26,58
caelum_mamute,137,81,38,111,367
steventrigg_AlarmClock,0,0,0,0,0
Poweruser_MinetickMod,0,120,74,12,206
chanan_SignalJ,0,29,1,0,30
abel533_Mybatis-Spring,0,0,0,0,0
vinumeris_lighthouse,0,191,0,0,191
usc-isi-i2_Web-Karma,551,383,167,1718,2819
rancherio_cattle,2,2655,316,14,2987
Netflix_spectator,0,39,41,1,81
MicBrain_Graph-API,0,0,0,0,0
dibbhatt_kafka-spark-consumer,15,26,2,1,44
readydev_retrogram,0,2,0,0,2
red5_red5-io,0,166,9,0,175
google_jimfs,21,18,5,80,124
searchisko_elasticsearch-river-remote,53,48,8,24,133
Sotera_distributed-graph-analytics,0,45,1,0,46
apache_olingo-odata4,1009,724,422,5060,7215
allanbank_mongodb-async-driver,336,409,134,2117,2996
tlaukkan_zigbee4java,286,1196,63,168,1713
chiuki_gce2retrofit,0,1,0,0,1
Team254_TrajectoryLib,13,12,1,12,38
fcrepo3_gsearch,0,1,0,0,1
takezoe_xlsbeans,0,26,3,0,29
fcrepo3_fcrepo,0,750,94,2,846
techpanja_interviewproblems,0,0,0,0,0
jetty-project_jetty-alpn,0,1,0,0,1
prasanthj_hyperloglog,0,12,0,0,12
jurmous_etcd4j,0,55,1,0,56
41concepts_VALJOGen,0,91,5,0,96
JakeWharton_double-espresso,0,22,3,0,25
tkaczmarzyk_specification-arg-resolver,46,104,1,0,151
JetBrains_teamcity-azure-plugin,0,1,0,0,1
twitter_hpack,5,2,0,0,7
dhleong_intellivim,0,23,3,1,27
nekopanda_logbook,0,211,26,0,237
recruit-tech_redpen,216,13,21,931,1181
serenity-bdd_serenity-cucumber,0,13,0,0,13
XiaoMi_chronos,0,20,0,0,20
SpongePowered_SpongeAPI,0,6316,8,0,6324
reveal-technologies_sitewhere,0,188,6,0,194
junichi11_netbeans-github-issues-plugin,0,69,5,0,74
dropwizard_dropwizard-java8,10,19,0,0,29
rterp_GMapsFX,0,48,6,0,54
tox4j_tox4j,0,2,0,0,2
jtrfp_terminal-recall,180,699,59,632,1570
hsz_idea-gitignore,0,0,0,0,0
rapidftr_RapidFTR-Android,0,80,14,0,94
inductiveautomation_opc-ua-stack,0,6762,56,0,6818
mulesoft_raml-for-jax-rs,6,13,7,15,41
bramp_ffmpeg-cli-wrapper,27,50,4,55,136
simpligility_android-maven-plugin,0,224,3,0,227
google_cap-library,0,189,16,0,205
kwon37xi_hibernate4-memcached,0,45,0,0,45
spring-cloud_spring-cloud-config,0,91,2,0,93
pietermartin_sqlg,80,207,40,3895,4222
opener-project_ner-base,0,33,1,0,34
netceteragroup_valdr-bean-validation,0,2,0,0,2
stephanenicolas_mimic,0,1,0,0,1
elastic_elasticsearch-cloud-aws,0,0,0,0,0
elastic_elasticsearch-mapper-attachments,0,27,0,0,27
Realm_realm-java,1,809,94,0,904
oxygenxml_TEI-Facsimile-Plugin,0,2,0,0,2
google_google-authenticator-android,0,58,2,0,60
codelibs_elasticsearch-reindexing,0,0,0,0,0
jensjaeger_play4jpa,0,7,0,0,7
graphaware_neo4j-uuid,0,1,0,0,1
miho_JCSG,0,22,4,5,31
opentok_opentok-android-sdk-samples,0,58,0,0,58
yesnault_PlayStartApp,0,10,0,0,10
Flow_Caustic,9,76,5,1,91
IntuitDeveloper_SampleApp-TimeTracking_Invoicing-Java,0,5,1,0,6
socrata_soda-android-sdk,0,2,0,0,2
JDatePicker_JDatePicker,24,6,0,36,66
tchoulihan_bitmerchant,0,0,0,0,0
jenkinsci_junit-plugin,0,55,2,3,60
jparyani_wave,1,2063,436,2,2502
pschirmacher_webster,0,94,1,6,101
jayway_powermock,1,125,14,0,140
ToToTec_CmdOption,0,54,1,0,55
haifengl_smile,0,279,57,1,337
hogelog_line-chart-view,0,14,0,0,14
revapi_revapi,55,270,32,119,476
WebGoat_WebGoat,0,34,4,0,38
immutables_immutables,74,1404,102,790,2370
spring-projects_spring-data-examples,0,31,1,1,33
documents4j_documents4j,20,164,3,64,251
spring-projects_spring-restdocs,0,27,10,0,37
guardianproject_storymaker,2,1810,11,0,1823
vert-x3_vertx-rx,252,5291,485,92,6120
qcri-social_AIDR,0,285,54,0,339
nicolasjafelle_AndroidDemo,0,9,1,0,10
googlesamples_android-ActivitySceneTransitionBasic,0,0,0,0,0
abrensch_brouter,0,57,15,0,72
lightblue-platform_lightblue-core,65,278,99,90,532
apache_curator,351,51,122,2123,2647
OpenHFT_Chronicle-Core,34,59,10,66,169
davidmoten_rxjava-jdbc,6,20,4,70,100
methusalah_Draaxben,0,79,28,5,112
oasp_oasp4j,3,89,0,0,92
zsoltherpai_fluent-jdbc,3,3,4,3,13
salyh_elasticsearch-river-imap,12,6,1,4,23
mucommander_mucommander,0,2583,200,8,2791
resty-gwt_resty-gwt,3,117,9,0,129
statefulj_statefulj,3,29,8,9,49
joel-costigliola_assertj-swing,225,54,31,450,760
jmurty_java-xmlbuilder,1,4,0,33,38
wnbittle_dyn4jtelefonicaid_fiware-cygnus,0,0,0,0,0
octo-online_reactive-audit,0,30,0,0,30
confluentinc_kafka-rest,0,266,58,0,324
tootedom_related,0,224,16,0,240
apache_falcon,0,708,195,10,913
fabric8io_quickstarts,9,13,0,0,22
bnjmn_weka,30,1871,467,41,2409
tomsteele_burpbuddy,0,0,1,0,1
fernandodev_easy-rating-dialog,0,0,0,0,0
ehcache_ehcache-jcache,5,0,0,0,5
expercise_expercise,39,15,17,48,119
uPhyca_idobata4j,0,4,1,0,5
bitcoinj_bitcoinj,0,771,85,6,862
jubeio_jube,0,35,4,3,42
guikeller_jetty-runner,0,10,0,0,10
nativelibs4java_BridJ,2,622,17,1,642
Firebase_geofire-java,11,11,0,0,22
mstahv_maddon,27,71,4,23,125
etsy_statsd-jvm-profiler,6,25,1,0,32
cloudfoundry-community_spring-boot-cf-service-broker,0,5,0,0,5
torodb_torodb,0,0,0,0,0
xmlunit_xmlunit,111,73,23,688,895
crocs-muni_JCAlgTest,17,1022,4,0,1043
wso2_product-esb,6,70,1,0,77
Appendium_flatpack,52,14,3,63,132
apache_incubator-twill,43,127,27,62,259
holgerbrandl_themoviedbapi,0,55,7,0,62
branky_cascading.hive,0,15,0,0,15
rtreffer_minidns,0,75,16,0,91
elastic_elasticsearch-lang-javascript,0,0,0,0,0
vladmihalcea_hibernate-master-class,0,142,0,0,142
vbence_stream-m,0,44,4,0,48
orangesignal_orangesignal-android-camera,0,30,1,0,31
aboev_photobook-client,0,99,7,0,106
springer-opensource_omelet,30,20,2,48,100
venmo_android-pin,0,4,0,0,4
redraiment_jactiverecord,5,0,0,37,42
OpenHFT_Chronicle-Wire,106,192,14,771,1083
MER-C_wiki-java,23,53,0,27,103
jitsi_jicofo,9,38,2,14,63
tvbarthel_SimpleWeatherForecast,0,59,2,0,61
iipc_webarchive-commons,131,488,15,98,732
AltBeacon_android-beacon-library,0,51,5,0,56
WhisperSystems_Flock,0,175,21,0,196
flexiblepower_powermatcher,0,32,9,0,41
iheartradio_open-m3u8,0,102,12,0,114
puniverse_comsat-examples,0,27,0,0,27
apache_jackrabbit-filevault,0,367,58,1,426
tesis-dynaware_graph-editor,0,30,26,9,65
NirmataOSS_workflow,23,3,8,62,96
flipkart-incubator_Lois,0,0,0,0,0
udacity_ud859,0,73,1,0,74
linkedin_Spyglass,0,15,3,0,18
phax_ph-css,115,695,21,293,1124
w3blogfr_zebra-zpl,7,0,0,0,7
TeamBliss-LP_android_frameworks_base,2,25054,1378,16,26450
RobotiumTech_robotium,0,25,4,0,29
internet-research-network_breeze,7,5,0,0,12
hgoebl_DavidWebb,0,11,0,0,11
davidmoten_rtree,15,62,12,105,194
fookwood_Launcher3,1,505,74,2,582
thatJavaNerd_JRAW,0,66,1,0,67
siosio_DomaSupport,0,0,0,0,0
polyglot-compiler_polyglot,88,1450,344,2180,4062
naver_volley-extensions,0,37,3,0,40
pydio_pydio-sync-java,0,44,1,5,50
gregturn_spring-a-gram,0,8,0,0,8
GoogleCloudPlatform_endpoints-codelab-android,0,63,3,0,66
awslabs_aws-ant-tasks,14,33,1,0,48
Hive2Hive_PeerBox,0,29,31,0,60
giltene_PauselessHashMap,1,0,0,0,1
mapzen_lost,0,43,9,0,52
javaparser_javaparser,718,433,372,3515,5038
yegor256_netbout,0,33,2,0,35
tynamo_tapestry-security,3,23,4,2,32
knightliao_disconf,0,150,20,0,170
MCTCP_TerrainControl,1,501,45,0,547
jprante_elasticsearch-plugin-bundle,0,54,1,0,55
zhangkaitao_spring4-showcase,0,8,0,0,8
johnjohndoe_TypedPreferences,0,7,0,0,7
uwescience_myria,0,512,66,0,578
fs_android-base,0,0,0,0,0
christoffer_pycharm-pyxl,0,25,0,0,25
spotify_futures-extra,0,2,0,0,2
MinecraftForge_FernFlower,0,261,54,0,315
GluuFederation_oxAuth,908,245,254,3011,4418
theDazzler_droidicon,0,0,1,0,1
oodrive_eguan,0,249,124,0,373
avast_android-butterknife-zelezny,0,4,0,0,4
RentTheRunway2_alchemy,28,74,11,146,259
att_XACML,0,0,0,0,0
brendano_arkref,0,78,4,10,92
orhanobut_wasp,0,9,4,0,13
fabric8io_fabric8,0,0,0,0,0
Accla_d4m_api_java,134,175,9,13,331
esigate_esigate,107,120,25,215,467
ranjan-rk_restfiddle,0,0,10,0,10
creativa77_AndroidStreamingClient,0,18,2,0,20
javers_javers,0,53,40,1,94
codelibs_elasticsearch-taste,79,49,17,30,175
spirosoik_RapidAndroidApp,0,56,2,0,58
la-team_light-admin,19,50,18,159,246
apache_struts-examples,42,18,0,12,72
turbomanage_storm-gen,0,29,2,0,31
fadeyev_intellijcoder,0,45,1,0,46
wb14123_bard,0,52,3,0,55
scopely_fontain,0,7,2,0,9
timtiemens_secretshare,0,47,1,0,48
data,0,0,0,0,0
entando_entando-components,0,854,76,0,930
buschmais_extended-objects,25,14,16,635,690
novoda_sqlite-analyzer,0,494,0,0,494
kontalk_tigase-server,161,1098,85,266,1610
embulk_embulk,0,50,30,0,80
polydawn_mdm,0,12,0,0,12
JetBrains_kotlin-eclipse,0,75,0,0,75
WuXiaolong_WeWin,0,30,0,0,30
square_okio,0,7,0,0,7
cternes_openkeepass,166,13,10,222,411
ni3po42_traction.mvc,0,37,0,0,37
laco0416_SmileEssence,0,45,18,1,64
querydsl_querydsl,0,1291,143,3,1437
tuenti_ButtonMenu,0,0,1,0,1
appium_tutorial,0,2,0,0,2
indy256_codelibrary,0,49,0,8,57
FEMR_femr,0,7,16,0,23
castlabs_dashencrypt,14,6,3,17,40
nasa_OpenSPIFe,0,1148,392,19,1559
psaravan_JamsMusicPlayer,0,0,0,0,0
BurstProject_burstcoin,0,389,41,0,430
orangesignal_orangesignal-csv,0,32,9,0,41
apache_incubator-streams,0,0,0,0,0
ewolff_user-registration,2,0,0,0,2
esig_dss,892,358,1261,1948,4459
CorfuDB_CorfuDB,2,305,139,1,447
XiaoMi_themis,0,110,8,0,118
druid-io_druid,2527,2758,1388,4786,11459
h2oai_h2o-dev,0,1233,325,50,1608
ClickTravel_Cheddar,0,18,13,0,31
blandware_android-atleap,0,132,1,0,133
pumadong_cl-privilege,0,7,4,0,11
google_google-auth-library-java,30,59,19,58,166
Swrve_rate-limited-logger,0,3,0,0,3
andrewgaul_modernizer-maven-plugin,4,4,0,20,28
bjornharrtell_jdbc-http-server,0,2,0,0,2
dcm4che_dcm4chee-arc-cdi,0,172,41,0,213
tiagobento_watertemplate-engine,10,15,0,3,28
apache_drill,0,0,0,0,0
protostuff_protostuff,92,879,59,85,1115
spotify_docker-client,19,118,5,186,328
ui4j_ui4j,0,0,0,0,0
yammer_tenacity,0,30,1,0,31
servicosgovbr_guia-de-servicos,0,0,0,0,0
mjsax_aeolus,96,179,10,3,288
pac4j_play-pac4j,6,4,0,0,10
Eldelshell_jongo,49,28,9,213,299
RPTools_maptool,0,528,103,12,643
imagej_imagej-ops,15,606,14,23,658
netplex_json-smart-v2,0,111,2,0,113
elastic_elasticsearch-hadoop,0,313,55,0,368
SpringData_spring-data-cassandra,0,0,0,0,0
OpenNMS_newts,64,39,15,128,246
wendykierp_JTransforms,80,52,0,0,132
blockchain_api-v1-client-java,2,6,1,28,37
clinejj_foursquare-api-java,4,0,8,398,410
Yubico_java-u2flib-server,0,72,8,0,80
aol_micro-server,0,39,5,0,44
joeattardi_tailstreamer,0,6,0,0,6
sdstoehr_har-reader,10,1,0,0,11
alexanderdean_Unified-Log-Processing,0,6,0,0,6
sviperll_adt4j,0,2,2,0,4
pmarches_jStellarAPI,0,16,4,0,20
ehcache_sizeof,6,28,0,0,34
pprados_audit-reactive,0,30,0,0,30
benas_easy-batch,167,36,20,265,488
taichi_siden,0,11,6,0,17
stephenostermiller_qqwing,0,6,0,0,6
kaazing_gateway,293,497,256,912,1958
apache_uima-uimafit,0,298,5,0,303
shiyimin_androidtestdebug,0,65,0,0,65
sequenceiq_ambari-shell,0,0,0,0,0
spring-cloud_spring-cloud-cluster,0,5,0,0,5
Apereo-Learning-Analytics-Initiative_LearningAnalyticsProcessor,0,18,2,0,20
dsyer_spring-boot-ratpack,0,2,0,0,2
radkovo_jStyleParser,18,580,31,218,847
frankiesardo_auto-parcel,0,3,0,0,3
operasoftware_operaprestodriver,63,2359,14,230,2666
sriharshachilakapati_SilenceEngine,0,1220,27,13,1260
semanticvectors_semanticvectors,133,69,30,120,352
freenet_fred,0,1032,288,1,1321
TomasMikula_RichTextFX,0,23,2,3,28
senbox-org_s1tbx,320,632,33,58,1043
chaupal_jxse,538,733,244,490,2005
big-mouth-cn_ticket4j,0,40,4,0,44
acciente_oacc-core,0,54,36,0,90
open-eid_digidoc4j,213,359,64,818,1454
camelinaction_camelinaction,0,1,0,0,1
thiagolocatelli_parse4j,0,56,3,0,59
DICE-UNC_idrop,0,170,39,0,209
exxeleron_qJava,0,3,3,0,6
remibantos_jeeshop,38,37,11,17,103
USC-NSL_PUMA,0,4,1,1,6
urandom_gearshift,0,611,5,0,616
kairosdb_kairosdb,0,373,30,0,403
fireduck64_jelectrum,0,54,3,0,57
Netflix_iep,0,34,2,1,37
thm-projects_arsnova-backend,0,132,17,0,149
go-ive_steam-api,0,0,0,0,0
ypresto_android-transcoder,0,21,1,0,22
zutherb_AppStash,0,13,2,0,15
meltmedia_dropwizard-crypto,1,16,0,0,17
elastic_elasticsearch-analysis-kuromoji,0,0,0,0,0
policeman-tools_forbidden-apis,0,14,1,0,15
SpongePowered_Artemis,0,0,0,0,0
kohlschuetter_junixsocket,4,113,33,1,151
dpaukov_combinatoricslib,3,3,0,30,36
ReactiveX_RxJavaString,0,1,0,0,1
infiniteautomation_modbus4j,53,115,18,11,197
forge_roaster,24,7,11,595,637
unitsofmeasurement_unit-ri,25,91,0,9,125
kite-sdk_kite-examples,0,4,0,0,4
Haehnchen_idea-php-shopware-plugin,0,55,1,0,56
matrix-org_matrix-android-sdk,0,294,51,0,345
ConnectSDK_Connect-SDK-Android-Core,0,515,26,0,541
crosswalk-project_crosswalk-cordova-android,0,61,8,0,69
YasuOza_HBFav-Android,0,25,1,0,26
mongobee_mongobee,11,6,0,0,17
rahulkumar2048_Performance-Tweaker,0,1,0,0,1
PayPal_SeLion,5,257,22,34,318
Netflix_suro,0,469,7,0,476
takahi-i_likelike,7,26,2,0,35
spring-projects_spring-data-keyvalue,0,14,1,0,15
h3xstream_http-script-generator,0,18,1,0,19
jbox2d_jbox2d,0,442,77,0,519
matlux_jvm-breakglass,0,13,0,0,13
xvik_dropwizard-guicey,0,163,11,0,174
nitram509_jmacaroons,9,10,0,47,66
dashbuilder_dashbuilder,109,242,47,340,738
EdwardRaff_JSAT,0,142,82,2,226
3breadt_dd-plist,18,45,1,0,64
lsds_SEEP,0,40,24,0,64
liveoak-io_liveoak,239,233,114,475,1061
twotoasters_SectionCursorAdapter,0,6,0,0,6
coinbase_coinbase-java,0,54,2,0,56
DroidPlanner_3DRServices,0,2340,37,0,2377
nathantippy_jFASTStages,0,3233,104,0,3337
oldratlee_classloader-playground,1,18,0,0,19
arnohaase_a-base,0,20,7,0,27
NLPchina_ansj_seg,71,81,7,57,216
CompEvol_beast2,0,229,24,21,274
lyogavin_Pistachio,7,127,3,14,151
classmethod_cmtest,0,0,0,0,0
greenrobot_greenrobot-common,0,23,0,0,23
jodastephen_property-alliance,0,2,0,4,6
JeffreyFalgout_ThrowingStream,0,9,7,0,16
kzwang_elasticsearch-image,1,10,0,6,17
atinfo_at.info-knowledge-base,0,24,0,1,25
Clashsoft_Dyvil,0,689,214,1,904
LapisBlue_Pore,11,249,48,0,308
google_error-prone,46,782,76,903,1807
lemire_RoaringBitmap,0,97,14,0,111
kaazing_robot,264,528,49,136,977
ehcache_ehcache3,1,321,202,1,525
cognitect_transit-java,8,56,4,48,116
raydac_java-binary-block-parser,71,62,27,566,726
CalebFenton_simplify,0,108,25,1,134
freenet_plugin-WebOfTrust,0,865,59,16,940
sinkillerj_ProjectE,0,375,28,0,403
freenet_plugin-Freetalk,0,681,68,18,767
ATLauncher_ATLauncher,0,230,76,0,306
AChep_HeadsUp,0,155,7,0,162
shamanland_xdroid,0,9,0,0,9
xtreemfs_xtreemfs,0,455,181,2,638
sanjivsingh_stackoverflow-java-sdk,1,110,15,167,293
groupon_jesos,0,592,2,0,594
iainporter_oauth2-provider,0,0,4,0,4
lejon_T-SNE-Java,28,1,2,0,31
mrmans0n_smart-location-lib,0,26,0,0,26
lestard_advanced-bindings,0,2,0,0,2
